index,Month and Year,State,Civilian Population,Total Labor Force,Percent of Population,Employed - Total,Employed - Percent of Population,Unemployed - Total,Unemployed - Percent of Labor Force
0,January 1976,Alabama,2605000,1492409,57.3,1392154,53.4,100255,6.7
1,January 1976,Alaska,232000,159154,68.6,147809,63.7,11345,7.1
2,January 1976,Arizona,1621000,972413,60.0,872738,53.8,99675,10.3
3,January 1976,Arkansas,1536000,882835,57.5,817756,53.2,65079,7.4
4,January 1976,California,15621000,9781720,62.6,8892663,56.9,889057,9.1
5,January 1976,Colorado,1832000,1232334,67.3,1164563,63.6,67771,5.5
6,January 1976,Connecticut,2248000,1443606,64.2,1302422,57.9,141184,9.8
7,January 1976,Delaware,417000,262688,63.0,242382,58.1,20306,7.7
8,January 1976,District of Columbia,520000,339378,65.3,308820,59.4,30558,9.0
9,January 1976,Florida,6421000,3592149,55.9,3248523,50.6,343626,9.6
10,January 1976,Georgia,3522000,2250451,63.9,2061744,58.5,188707,8.4
11,January 1976,Hawaii,583000,408869,70.1,367414,63.0,41455,10.1
12,January 1976,Idaho,580000,366173,63.1,346216,59.7,19957,5.5
13,January 1976,Illinois,8127000,5133491,63.2,4788469,58.9,345022,6.7
14,January 1976,Indiana,3789000,2418961,63.8,2260951,59.7,158010,6.5
15,January 1976,Iowa,2066000,1324627,64.1,1269103,61.4,55524,4.2
16,January 1976,Kansas,1635000,1061055,64.9,1015585,62.1,45470,4.3
17,January 1976,Kentucky,2459000,1489641,60.6,1406646,57.2,82995,5.6
18,January 1976,Louisiana,2672000,1513827,56.7,1417816,53.1,96011,6.3
19,January 1976,Maine,764000,475639,62.3,433990,56.8,41649,8.8
20,January 1976,Maryland,2954000,1905561,64.5,1781850,60.3,123711,6.5
21,January 1976,Massachusetts,4194000,2715161,64.7,2435124,58.1,280037,10.3
22,January 1976,Michigan,6417000,3959251,61.7,3568988,55.6,390263,9.9
23,January 1976,Minnesota,2788000,1832797,65.7,1722777,61.8,110020,6.0
24,January 1976,Mississippi,1640000,961115,58.6,896774,54.7,64341,6.7
25,January 1976,Missouri,3464000,2088814,60.3,1963951,56.7,124863,6.0
26,January 1976,Montana,531000,327276,61.6,308066,58.0,19210,5.9
27,January 1976,Nebraska,1095000,715752,65.4,692137,63.2,23615,3.3
28,January 1976,Nevada,451000,322417,71.5,293574,65.1,28843,8.9
29,January 1976,New Hampshire,593000,391585,66.0,364963,61.5,26622,6.8
30,January 1976,New Jersey,5358000,3281099,61.2,2944762,55.0,336337,10.3
31,January 1976,New Mexico,792000,475004,60.0,432875,54.7,42129,8.9
32,January 1976,New York,13196000,7687165,58.3,6896554,52.3,790611,10.3
33,January 1976,North Carolina,3898000,2596329,66.6,2428430,62.3,167899,6.5
34,January 1976,North Dakota,442000,275609,62.4,266394,60.3,9215,3.3
35,January 1976,Ohio,7701000,4756109,61.8,4371860,56.8,384249,8.1
36,January 1976,Oklahoma,1999000,1180825,59.1,1110620,55.6,70205,5.9
37,January 1976,Oregon,1716000,1074151,62.6,969974,56.5,104177,9.7
38,January 1976,Pennsylvania,8774000,5105548,58.2,4693332,53.5,412216,8.1
39,January 1976,Rhode Island,691000,434960,62.9,399599,57.8,35361,8.1
40,January 1976,South Carolina,1984000,1292816,65.2,1195062,60.2,97754,7.6
41,January 1976,South Dakota,477000,308735,64.7,298900,62.7,9835,3.2
42,January 1976,Tennessee,3078000,1819844,59.1,1710143,55.6,109701,6.0
43,January 1976,Texas,8818000,5627987,63.8,5298778,60.1,329209,5.8
44,January 1976,Utah,824000,519498,63.0,489265,59.4,30233,5.8
45,January 1976,Vermont,339000,213667,63.0,195099,57.6,18568,8.7
46,January 1976,Virginia,3534000,2328545,65.9,2190847,62.0,137698,5.9
47,January 1976,Washington,2598000,1584688,61.0,1446319,55.7,138369,8.7
48,January 1976,West Virginia,1352000,702600,52.0,647491,47.9,55109,7.8
49,January 1976,Wisconsin,3245000,2125315,65.5,2003102,61.7,122213,5.8
50,January 1976,Wyoming,270000,175876,65.1,168592,62.4,7284,4.1
51,February 1976,Alabama,2610000,1491820,57.2,1391975,53.3,99845,6.7
52,February 1976,Alaska,234000,158961,67.9,147666,63.1,11295,7.1
53,February 1976,Arizona,1626000,971753,59.8,871997,53.6,99756,10.3
54,February 1976,Arkansas,1538000,882316,57.4,817132,53.1,65184,7.4
55,February 1976,California,15657000,9775948,62.4,8888464,56.8,887484,9.1
56,February 1976,Colorado,1837000,1232109,67.1,1164631,63.4,67478,5.5
57,February 1976,Connecticut,2251000,1442758,64.1,1301572,57.8,141186,9.8
58,February 1976,Delaware,418000,262592,62.8,242420,58.0,20172,7.7
59,February 1976,District of Columbia,519000,339539,65.4,308976,59.5,30563,9.0
60,February 1976,Florida,6437000,3591389,55.8,3247280,50.4,344109,9.6
61,February 1976,Georgia,3528000,2249410,63.8,2060612,58.4,188798,8.4
62,February 1976,Hawaii,585000,408905,69.9,367268,62.8,41637,10.2
63,February 1976,Idaho,582000,365886,62.9,345965,59.4,19921,5.4
64,February 1976,Illinois,8136000,5132066,63.1,4787725,58.8,344341,6.7
65,February 1976,Indiana,3793000,2418034,63.7,2259666,59.6,158368,6.5
66,February 1976,Iowa,2069000,1324134,64.0,1268472,61.3,55662,4.2
67,February 1976,Kansas,1637000,1060584,64.8,1015127,62.0,45457,4.3
68,February 1976,Kentucky,2465000,1489199,60.4,1406247,57.0,82952,5.6
69,February 1976,Louisiana,2678000,1513026,56.5,1417468,52.9,95558,6.3
70,February 1976,Maine,766000,475595,62.1,433930,56.6,41665,8.8
71,February 1976,Maryland,2958000,1904839,64.4,1781465,60.2,123374,6.5
72,February 1976,Massachusetts,4198000,2714974,64.7,2434220,58.0,280754,10.3
73,February 1976,Michigan,6424000,3957748,61.6,3566516,55.5,391232,9.9
74,February 1976,Minnesota,2793000,1832001,65.6,1722014,61.7,109987,6.0
75,February 1976,Mississippi,1644000,960686,58.4,896491,54.5,64195,6.7
76,February 1976,Missouri,3469000,2087305,60.2,1962686,56.6,124619,6.0
77,February 1976,Montana,532000,327202,61.5,308039,57.9,19163,5.9
78,February 1976,Nebraska,1096000,715577,65.3,691996,63.1,23581,3.3
79,February 1976,Nevada,454000,322146,71.0,293280,64.6,28866,9.0
80,February 1976,New Hampshire,595000,391323,65.8,364669,61.3,26654,6.8
81,February 1976,New Jersey,5363000,3280097,61.2,2944167,54.9,335930,10.2
82,February 1976,New Mexico,795000,474831,59.7,432640,54.4,42191,8.9
83,February 1976,New York,13202000,7684752,58.2,6895390,52.2,789362,10.3
84,February 1976,North Carolina,3905000,2595355,66.5,2427272,62.2,168083,6.5
85,February 1976,North Dakota,443000,275468,62.2,266304,60.1,9164,3.3
86,February 1976,Ohio,7706000,4756607,61.7,4371539,56.7,385068,8.1
87,February 1976,Oklahoma,2003000,1180479,58.9,1110306,55.4,70173,5.9
88,February 1976,Oregon,1720000,1073446,62.4,969351,56.4,104095,9.7
89,February 1976,Pennsylvania,8780000,5104850,58.1,4691940,53.4,412910,8.1
90,February 1976,Rhode Island,692000,434907,62.8,399553,57.7,35354,8.1
91,February 1976,South Carolina,1988000,1292440,65.0,1194788,60.1,97652,7.6
92,February 1976,South Dakota,478000,308727,64.6,298906,62.5,9821,3.2
93,February 1976,Tennessee,3084000,1818088,59.0,1708651,55.4,109437,6.0
94,February 1976,Texas,8844000,5624823,63.6,5295497,59.9,329326,5.9
95,February 1976,Utah,826000,519124,62.8,488892,59.2,30232,5.8
96,February 1976,Vermont,340000,213554,62.8,194960,57.3,18594,8.7
97,February 1976,Virginia,3543000,2327900,65.7,2190461,61.8,137439,5.9
98,February 1976,Washington,2604000,1583350,60.8,1445338,55.5,138012,8.7
99,February 1976,West Virginia,1355000,702802,51.9,647556,47.8,55246,7.9
100,February 1976,Wisconsin,3248000,2124456,65.4,2002200,61.6,122256,5.8
101,February 1976,Wyoming,271000,175705,64.8,168416,62.1,7289,4.1
102,March 1976,Alabama,2615000,1490600,57.0,1392137,53.2,98463,6.6
103,March 1976,Alaska,236000,159067,67.4,147858,62.7,11209,7.0
104,March 1976,Arizona,1631000,971967,59.6,872637,53.5,99330,10.2
105,March 1976,Arkansas,1539000,881865,57.3,816687,53.1,65178,7.4
106,March 1976,California,15694000,9775283,62.3,8892402,56.7,882881,9.0
107,March 1976,Colorado,1841000,1231539,66.9,1164628,63.3,66911,5.4
108,March 1976,Connecticut,2253000,1442821,64.0,1301890,57.8,140931,9.8
109,March 1976,Delaware,418000,262596,62.8,242340,58.0,20256,7.7
110,March 1976,District of Columbia,519000,339517,65.4,309128,59.6,30389,9.0
111,March 1976,Florida,6452000,3591633,55.7,3249159,50.4,342474,9.5
112,March 1976,Georgia,3534000,2249490,63.7,2061445,58.3,188045,8.4
113,March 1976,Hawaii,586000,409265,69.8,367467,62.7,41798,10.2
114,March 1976,Idaho,583000,366000,62.8,346021,59.4,19979,5.5
115,March 1976,Illinois,8146000,5131818,63.0,4789790,58.8,342028,6.7
116,March 1976,Indiana,3797000,2418009,63.7,2260937,59.5,157072,6.5
117,March 1976,Iowa,2072000,1324428,63.9,1268901,61.2,55527,4.2
118,March 1976,Kansas,1640000,1060837,64.7,1015396,61.9,45441,4.3
119,March 1976,Kentucky,2470000,1488878,60.3,1406193,56.9,82685,5.6
120,March 1976,Louisiana,2685000,1513093,56.4,1417499,52.8,95594,6.3
121,March 1976,Maine,767000,475697,62.0,434134,56.6,41563,8.7
122,March 1976,Maryland,2962000,1904177,64.3,1781135,60.1,123042,6.5
123,March 1976,Massachusetts,4201000,2715650,64.6,2435324,58.0,280326,10.3
124,March 1976,Michigan,6430000,3959594,61.6,3567979,55.5,391615,9.9
125,March 1976,Minnesota,2797000,1831869,65.5,1722985,61.6,108884,5.9
126,March 1976,Mississippi,1647000,960931,58.3,897614,54.5,63317,6.6
127,March 1976,Missouri,3473000,2087996,60.1,1963435,56.5,124561,6.0
128,March 1976,Montana,533000,327131,61.4,308017,57.8,19114,5.8
129,March 1976,Nebraska,1097000,715419,65.2,692073,63.1,23346,3.3
130,March 1976,Nevada,456000,322327,70.7,293456,64.4,28871,9.0
131,March 1976,New Hampshire,596000,391413,65.7,364765,61.2,26648,6.8
132,March 1976,New Jersey,5367000,3282199,61.2,2945972,54.9,336227,10.2
133,March 1976,New Mexico,798000,475109,59.5,432733,54.2,42376,8.9
134,March 1976,New York,13207000,7684481,58.2,6897998,52.2,786483,10.2
135,March 1976,North Carolina,3912000,2595712,66.4,2428876,62.1,166836,6.4
136,March 1976,North Dakota,444000,275531,62.1,266363,60.0,9168,3.3
137,March 1976,Ohio,7711000,4757822,61.7,4372663,56.7,385159,8.1
138,March 1976,Oklahoma,2007000,1180456,58.8,1110496,55.3,69960,5.9
139,March 1976,Oregon,1724000,1072689,62.2,969546,56.2,103143,9.6
140,March 1976,Pennsylvania,8786000,5106719,58.1,4691831,53.4,414888,8.1
141,March 1976,Rhode Island,693000,435032,62.8,399726,57.7,35306,8.1
142,March 1976,South Carolina,1992000,1291686,64.8,1195034,60.0,96652,7.5
143,March 1976,South Dakota,478000,308704,64.6,299010,62.6,9694,3.1
144,March 1976,Tennessee,3091000,1818191,58.8,1709613,55.3,108578,6.0
145,March 1976,Texas,8870000,5629458,63.5,5299209,59.7,330249,5.9
146,March 1976,Utah,828000,519114,62.7,489008,59.1,30106,5.8
147,March 1976,Vermont,341000,213610,62.6,194978,57.2,18632,8.7
148,March 1976,Virginia,3551000,2328207,65.6,2191511,61.7,136696,5.9
149,March 1976,Washington,2611000,1582676,60.6,1445169,55.3,137507,8.7
150,March 1976,West Virginia,1358000,702963,51.8,647481,47.7,55482,7.9
151,March 1976,Wisconsin,3252000,2124610,65.3,2002973,61.6,121637,5.7
152,March 1976,Wyoming,272000,175782,64.6,168487,61.9,7295,4.2
153,April 1976,Alabama,2620000,1489947,56.9,1393177,53.2,96770,6.5
154,April 1976,Alaska,237000,160192,67.6,148970,62.9,11222,7.0
155,April 1976,Arizona,1636000,974938,59.6,877217,53.6,97721,10.0
156,April 1976,Arkansas,1541000,882692,57.3,818130,53.1,64562,7.3
157,April 1976,California,15731000,9795836,62.3,8918330,56.7,877506,9.0
158,April 1976,Colorado,1846000,1231011,66.7,1164119,63.1,66892,5.4
159,April 1976,Connecticut,2255000,1446187,64.1,1306078,57.9,140109,9.7
160,April 1976,Delaware,419000,262989,62.8,241923,57.7,21066,8.0
161,April 1976,District of Columbia,518000,338609,65.4,308673,59.6,29936,8.8
162,April 1976,Florida,6468000,3594014,55.6,3258015,50.4,335999,9.3
163,April 1976,Georgia,3540000,2253611,63.7,2067967,58.4,185644,8.2
164,April 1976,Hawaii,588000,409939,69.7,368550,62.7,41389,10.1
165,April 1976,Idaho,585000,367439,62.8,347164,59.3,20275,5.5
166,April 1976,Illinois,8155000,5135150,63.0,4796640,58.8,338510,6.6
167,April 1976,Indiana,3801000,2421035,63.7,2269249,59.7,151786,6.3
168,April 1976,Iowa,2075000,1327210,64.0,1272547,61.3,54663,4.1
169,April 1976,Kansas,1642000,1063168,64.7,1017765,62.0,45403,4.3
170,April 1976,Kentucky,2475000,1489497,60.2,1407354,56.9,82143,5.5
171,April 1976,Louisiana,2692000,1516323,56.3,1418904,52.7,97419,6.4
172,April 1976,Maine,769000,476036,61.9,434823,56.5,41213,8.7
173,April 1976,Maryland,2966000,1905507,64.2,1781610,60.1,123897,6.5
174,April 1976,Massachusetts,4204000,2717527,64.6,2441683,58.1,275844,10.2
175,April 1976,Michigan,6436000,3969449,61.7,3580904,55.6,388545,9.8
176,April 1976,Minnesota,2802000,1834864,65.5,1728543,61.7,106321,5.8
177,April 1976,Mississippi,1650000,963165,58.4,901513,54.6,61652,6.4
178,April 1976,Missouri,3477000,2095946,60.3,1970155,56.7,125791,6.0
179,April 1976,Montana,534000,327166,61.3,308014,57.7,19152,5.9
180,April 1976,Nebraska,1098000,715705,65.2,692831,63.1,22874,3.2
181,April 1976,Nevada,458000,323929,70.7,295160,64.4,28769,8.9
182,April 1976,New Hampshire,598000,392657,65.7,366173,61.2,26484,6.7
183,April 1976,New Jersey,5372000,3290889,61.3,2952460,55.0,338429,10.3
184,April 1976,New Mexico,801000,476571,59.5,433984,54.2,42587,8.9
185,April 1976,New York,13213000,7689935,58.2,6906874,52.3,783061,10.2
186,April 1976,North Carolina,3919000,2599283,66.3,2436634,62.2,162649,6.3
187,April 1976,North Dakota,444000,276266,62.2,266864,60.1,9402,3.4
188,April 1976,Ohio,7716000,4757433,61.7,4376405,56.7,381028,8.0
189,April 1976,Oklahoma,2011000,1181507,58.8,1112144,55.3,69363,5.9
190,April 1976,Oregon,1728000,1073735,62.1,972719,56.3,101016,9.4
191,April 1976,Pennsylvania,8792000,5112956,58.2,4696196,53.4,416760,8.2
192,April 1976,Rhode Island,693000,435469,62.8,400273,57.8,35196,8.1
193,April 1976,South Carolina,1996000,1291005,64.7,1196768,60.0,94237,7.3
194,April 1976,South Dakota,479000,308718,64.5,299231,62.5,9487,3.1
195,April 1976,Tennessee,3097000,1825620,58.9,1718077,55.5,107543,5.9
196,April 1976,Texas,8896000,5653373,63.5,5321425,59.8,331948,5.9
197,April 1976,Utah,830000,520609,62.7,490860,59.1,29749,5.7
198,April 1976,Vermont,341000,214211,62.8,195593,57.4,18618,8.7
199,April 1976,Virginia,3559000,2330919,65.5,2195231,61.7,135688,5.8
200,April 1976,Washington,2617000,1586708,60.6,1448989,55.4,137719,8.7
201,April 1976,West Virginia,1360000,702202,51.6,646833,47.6,55369,7.9
202,April 1976,Wisconsin,3256000,2128063,65.4,2008413,61.7,119650,5.6
203,April 1976,Wyoming,273000,176667,64.7,169387,62.0,7280,4.1
204,May 1976,Alabama,2626000,1490609,56.8,1394591,53.1,96018,6.4
205,May 1976,Alaska,239000,161814,67.7,150449,62.9,11365,7.0
206,May 1976,Arizona,1642000,979281,59.6,883408,53.8,95873,9.8
207,May 1976,Arkansas,1542000,884656,57.4,821026,53.2,63630,7.2
208,May 1976,California,15768000,9828900,62.3,8953226,56.8,875674,8.9
209,May 1976,Colorado,1850000,1231050,66.5,1163412,62.9,67638,5.5
210,May 1976,Connecticut,2257000,1451468,64.3,1312227,58.1,139241,9.6
211,May 1976,Delaware,420000,263585,62.8,241399,57.5,22186,8.4
212,May 1976,District of Columbia,518000,337253,65.1,307776,59.4,29477,8.7
213,May 1976,Florida,6483000,3597871,55.5,3269479,50.4,328392,9.1
214,May 1976,Georgia,3547000,2259949,63.7,2077016,58.6,182933,8.1
215,May 1976,Hawaii,590000,410495,69.6,369908,62.7,40587,9.9
216,May 1976,Idaho,587000,369500,62.9,348876,59.4,20624,5.6
217,May 1976,Illinois,8164000,5141327,63.0,4804591,58.9,336736,6.5
218,May 1976,Indiana,3806000,2426290,63.7,2280665,59.9,145625,6.0
219,May 1976,Iowa,2078000,1331126,64.1,1277629,61.5,53497,4.0
220,May 1976,Kansas,1644000,1066459,64.9,1021136,62.1,45323,4.2
221,May 1976,Kentucky,2480000,1490936,60.1,1409389,56.8,81547,5.5
222,May 1976,Louisiana,2699000,1521492,56.4,1421200,52.7,100292,6.6
223,May 1976,Maine,771000,476408,61.8,435607,56.5,40801,8.6
224,May 1976,Maryland,2971000,1908475,64.2,1783003,60.0,125472,6.6
225,May 1976,Massachusetts,4207000,2719627,64.6,2450016,58.2,269611,9.9
226,May 1976,Michigan,6442000,3982406,61.8,3599367,55.9,383039,9.6
227,May 1976,Minnesota,2806000,1839691,65.6,1735701,61.9,103990,5.7
228,May 1976,Mississippi,1653000,966295,58.5,905971,54.8,60324,6.2
229,May 1976,Missouri,3481000,2107426,60.5,1979762,56.9,127664,6.1
230,May 1976,Montana,535000,327296,61.2,308035,57.6,19261,5.9
231,May 1976,Nebraska,1100000,716356,65.1,693887,63.1,22469,3.1
232,May 1976,Nevada,460000,326152,70.9,297525,64.7,28627,8.8
233,May 1976,New Hampshire,599000,394491,65.9,368258,61.5,26233,6.6
234,May 1976,New Jersey,5376000,3301261,61.4,2960089,55.1,341172,10.3
235,May 1976,New Mexico,804000,478400,59.5,435737,54.2,42663,8.9
236,May 1976,New York,13219000,7699911,58.2,6917563,52.3,782348,10.2
237,May 1976,North Carolina,3926000,2604867,66.3,2446767,62.3,158100,6.1
238,May 1976,North Dakota,445000,277312,62.3,267566,60.1,9746,3.5
239,May 1976,Ohio,7721000,4755323,61.6,4380800,56.7,374523,7.9
240,May 1976,Oklahoma,2015000,1183247,58.7,1114483,55.3,68764,5.8
241,May 1976,Oregon,1732000,1076382,62.1,977331,56.4,99051,9.2
242,May 1976,Pennsylvania,8798000,5120204,58.2,4703981,53.5,416223,8.1
243,May 1976,Rhode Island,694000,435966,62.8,400890,57.8,35076,8.0
244,May 1976,South Carolina,2001000,1291116,64.5,1199126,59.9,91990,7.1
245,May 1976,South Dakota,480000,308764,64.3,299427,62.4,9337,3.0
246,May 1976,Tennessee,3103000,1837093,59.2,1729974,55.8,107119,5.8
247,May 1976,Texas,8922000,5684052,63.7,5350734,60.0,333318,5.9
248,May 1976,Utah,833000,522952,62.8,493574,59.3,29378,5.6
249,May 1976,Vermont,342000,215053,62.9,196524,57.5,18529,8.6
250,May 1976,Virginia,3567000,2334945,65.5,2199661,61.7,135284,5.8
251,May 1976,Washington,2623000,1593891,60.8,1455187,55.5,138704,8.7
252,May 1976,West Virginia,1363000,700747,51.4,646032,47.4,54715,7.8
253,May 1976,Wisconsin,3260000,2133418,65.4,2015918,61.8,117500,5.5
254,May 1976,Wyoming,274000,177909,64.9,170664,62.3,7245,4.1
255,June 1976,Alabama,2631000,1493270,56.8,1396510,53.1,96760,6.5
256,June 1976,Alaska,240000,163686,68.2,152003,63.3,11683,7.1
257,June 1976,Arizona,1647000,984254,59.8,890022,54.0,94232,9.6
258,June 1976,Arkansas,1544000,887726,57.5,825275,53.5,62451,7.0
259,June 1976,California,15804000,9870502,62.5,8990510,56.9,879992,8.9
260,June 1976,Colorado,1855000,1232568,66.4,1163342,62.7,69226,5.6
261,June 1976,Connecticut,2259000,1457458,64.5,1319292,58.4,138166,9.5
262,June 1976,Delaware,420000,264322,62.9,240938,57.4,23384,8.8
263,June 1976,District of Columbia,517000,335657,64.9,306449,59.3,29208,8.7
264,June 1976,Florida,6499000,3602438,55.4,3280804,50.5,321634,8.9
265,June 1976,Georgia,3553000,2267990,63.8,2087124,58.7,180866,8.0
266,June 1976,Hawaii,591000,410779,69.5,371272,62.8,39507,9.6
267,June 1976,Idaho,588000,371921,63.3,350995,59.7,20926,5.6
268,June 1976,Illinois,8174000,5148731,63.0,4811721,58.9,337010,6.5
269,June 1976,Indiana,3810000,2433743,63.9,2292942,60.2,140801,5.8
270,June 1976,Iowa,2081000,1335660,64.2,1283290,61.7,52370,3.9
271,June 1976,Kansas,1647000,1070168,65.0,1025075,62.2,45093,4.2
272,June 1976,Kentucky,2485000,1492875,60.1,1411989,56.8,80886,5.4
273,June 1976,Louisiana,2705000,1527804,56.5,1424206,52.7,103598,6.8
274,June 1976,Maine,772000,476771,61.8,436293,56.5,40478,8.5
275,June 1976,Maryland,2975000,1912938,64.3,1785651,60.0,127287,6.7
276,June 1976,Massachusetts,4210000,2721925,64.7,2459155,58.4,262770,9.7
277,June 1976,Michigan,6448000,3996173,62.0,3620055,56.1,376118,9.4
278,June 1976,Minnesota,2811000,1846239,65.7,1743269,62.0,102970,5.6
279,June 1976,Mississippi,1656000,969806,58.6,909950,54.9,59856,6.2
280,June 1976,Missouri,3485000,2120593,60.8,1990642,57.1,129951,6.1
281,June 1976,Montana,536000,327764,61.2,308353,57.5,19411,5.9
282,June 1976,Nebraska,1101000,717505,65.2,695246,63.1,22259,3.1
283,June 1976,Nevada,462000,328597,71.1,300068,64.9,28529,8.7
284,June 1976,New Hampshire,601000,396701,66.0,370769,61.7,25932,6.5
285,June 1976,New Jersey,5381000,3311189,61.5,2967398,55.1,343791,10.4
286,June 1976,New Mexico,807000,480530,59.5,437826,54.3,42704,8.9
287,June 1976,New York,13224000,7710197,58.3,6926350,52.4,783847,10.2
288,June 1976,North Carolina,3933000,2611298,66.4,2456438,62.5,154860,5.9
289,June 1976,North Dakota,446000,278512,62.4,268372,60.2,10140,3.6
290,June 1976,Ohio,7726000,4752606,61.5,4385437,56.8,367169,7.7
291,June 1976,Oklahoma,2019000,1185470,58.7,1117372,55.3,68098,5.7
292,June 1976,Oregon,1736000,1081143,62.3,983132,56.6,98011,9.1
293,June 1976,Pennsylvania,8804000,5126930,58.2,4714719,53.6,412211,8.0
294,June 1976,Rhode Island,695000,436521,62.8,401452,57.8,35069,8.0
295,June 1976,South Carolina,2005000,1292328,64.5,1201890,59.9,90438,7.0
296,June 1976,South Dakota,480000,308993,64.4,299623,62.4,9370,3.0
297,June 1976,Tennessee,3110000,1851184,59.5,1743304,56.1,107880,5.8
298,June 1976,Texas,8948000,5714998,63.9,5381718,60.1,333280,5.8
299,June 1976,Utah,835000,525864,63.0,496755,59.5,29109,5.5
300,June 1976,Vermont,342000,216002,63.2,197661,57.8,18341,8.5
301,June 1976,Virginia,3575000,2339651,65.4,2204049,61.7,135602,5.8
302,June 1976,Washington,2630000,1604708,61.0,1464167,55.7,140541,8.8
303,June 1976,West Virginia,1366000,698539,51.1,645282,47.2,53257,7.6
304,June 1976,Wisconsin,3263000,2140193,65.6,2024313,62.0,115880,5.4
305,June 1976,Wyoming,275000,179296,65.2,172109,62.6,7187,4.0
306,July 1976,Alabama,2636000,1497488,56.8,1398508,53.1,98980,6.6
307,July 1976,Alaska,242000,165354,68.3,153206,63.3,12148,7.3
308,July 1976,Arizona,1652000,988887,59.9,895746,54.2,93141,9.4
309,July 1976,Arkansas,1545000,891219,57.7,830028,53.7,61191,6.9
310,July 1976,California,15841000,9912233,62.6,9021152,56.9,891081,9.0
311,July 1976,Colorado,1859000,1235853,66.5,1164288,62.6,71565,5.8
312,July 1976,Connecticut,2261000,1462313,64.7,1325601,58.6,136712,9.3
313,July 1976,Delaware,421000,265027,63.0,240614,57.2,24413,9.2
314,July 1976,District of Columbia,517000,334066,64.6,304814,59.0,29252,8.8
315,July 1976,Florida,6514000,3605780,55.4,3288271,50.5,317509,8.8
316,July 1976,Georgia,3559000,2276334,64.0,2095905,58.9,180429,7.9
317,July 1976,Hawaii,593000,410576,69.2,372349,62.8,38227,9.3
318,July 1976,Idaho,590000,374265,63.4,353139,59.9,21126,5.6
319,July 1976,Illinois,8183000,5154904,63.0,4815656,58.8,339248,6.6
320,July 1976,Indiana,3814000,2441098,64.0,2302543,60.4,138555,5.7
321,July 1976,Iowa,2084000,1339836,64.3,1288246,61.8,51590,3.9
322,July 1976,Kansas,1649000,1073420,65.1,1028649,62.4,44771,4.2
323,July 1976,Kentucky,2490000,1494595,60.0,1414170,56.8,80425,5.4
324,July 1976,Louisiana,2712000,1533265,56.5,1426892,52.6,106373,6.9
325,July 1976,Maine,774000,477028,61.6,436637,56.4,40391,8.5
326,July 1976,Maryland,2979000,1917430,64.4,1788622,60.0,128808,6.7
327,July 1976,Massachusetts,4213000,2723542,64.6,2467055,58.6,256487,9.4
328,July 1976,Michigan,6454000,4007046,62.1,3637730,56.4,369316,9.2
329,July 1976,Minnesota,2815000,1853353,65.8,1749692,62.2,103661,5.6
330,July 1976,Mississippi,1659000,972883,58.6,912384,55.0,60499,6.2
331,July 1976,Missouri,3489000,2132641,61.1,2000098,57.3,132543,6.2
332,July 1976,Montana,537000,328695,61.2,309084,57.6,19611,6.0
333,July 1976,Nebraska,1102000,718924,65.2,696607,63.2,22317,3.1
334,July 1976,Nevada,464000,330705,71.3,302176,65.1,28529,8.6
335,July 1976,New Hampshire,602000,398797,66.2,373163,62.0,25634,6.4
336,July 1976,New Jersey,5385000,3318401,61.6,2972413,55.2,345988,10.4
337,July 1976,New Mexico,810000,482648,59.6,439924,54.3,42724,8.9
338,July 1976,New York,13230000,7714711,58.3,6928065,52.4,786646,10.2
339,July 1976,North Carolina,3940000,2616425,66.4,2462323,62.5,154102,5.9
340,July 1976,North Dakota,447000,279594,62.5,269074,60.2,10520,3.8
341,July 1976,Ohio,7731000,4749372,61.4,4388313,56.8,361059,7.6
342,July 1976,Oklahoma,2023000,1187467,58.7,1120145,55.4,67322,5.7
343,July 1976,Oregon,1740000,1087537,62.5,989212,56.9,98325,9.0
344,July 1976,Pennsylvania,8810000,5130996,58.2,4724714,53.6,406282,7.9
345,July 1976,Rhode Island,696000,437006,62.8,401730,57.7,35276,8.1
346,July 1976,South Carolina,2009000,1294202,64.4,1204370,59.9,89832,6.9
347,July 1976,South Dakota,481000,309365,64.3,299746,62.3,9619,3.1
348,July 1976,Tennessee,3116000,1865156,59.9,1755158,56.3,109998,5.9
349,July 1976,Texas,8974000,5739119,64.0,5407584,60.3,331535,5.8
350,July 1976,Utah,837000,528720,63.2,499743,59.7,28977,5.5
351,July 1976,Vermont,343000,216844,63.2,198770,58.0,18074,8.3
352,July 1976,Virginia,3583000,2343598,65.4,2207139,61.6,136459,5.8
353,July 1976,Washington,2636000,1618080,61.4,1474961,56.0,143119,8.8
354,July 1976,West Virginia,1369000,695860,50.8,644584,47.1,51276,7.4
355,July 1976,Wisconsin,3267000,2146728,65.7,2031358,62.2,115370,5.4
356,July 1976,Wyoming,276000,180577,65.4,173470,62.9,7107,3.9
357,August 1976,Alabama,2641000,1502397,56.9,1400824,53.0,101573,6.8
358,August 1976,Alaska,243000,166528,68.5,153864,63.3,12664,7.6
359,August 1976,Arizona,1658000,993223,59.9,900283,54.3,92940,9.4
360,August 1976,Arkansas,1548000,894719,57.8,834576,53.9,60143,6.7
361,August 1976,California,15879000,9950583,62.7,9044297,57.0,906286,9.1
362,August 1976,Colorado,1865000,1240888,66.5,1166968,62.6,73920,6.0
363,August 1976,Connecticut,2263000,1465194,64.7,1330591,58.8,134603,9.2
364,August 1976,Delaware,422000,265641,62.9,240547,57.0,25094,9.4
365,August 1976,District of Columbia,517000,332802,64.4,303227,58.7,29575,8.9
366,August 1976,Florida,6532000,3608167,55.2,3291137,50.4,317030,8.8
367,August 1976,Georgia,3567000,2284323,64.0,2102593,58.9,181730,8.0
368,August 1976,Hawaii,594000,410176,69.1,373163,62.8,37013,9.0
369,August 1976,Idaho,592000,376375,63.6,355153,60.0,21222,5.6
370,August 1976,Illinois,8192000,5159514,63.0,4817462,58.8,342052,6.6
371,August 1976,Indiana,3819000,2446534,64.1,2308102,60.4,138432,5.7
372,August 1976,Iowa,2086000,1343674,64.4,1292323,62.0,51351,3.8
373,August 1976,Kansas,1651000,1076173,65.2,1031626,62.5,44547,4.1
374,August 1976,Kentucky,2494000,1495794,60.0,1416017,56.8,79777,5.3
375,August 1976,Louisiana,2718000,1536888,56.5,1428989,52.6,107899,7.0
376,August 1976,Maine,775000,477300,61.6,436719,56.4,40581,8.5
377,August 1976,Maryland,2984000,1921043,64.4,1791765,60.0,129278,6.7
378,August 1976,Massachusetts,4217000,2724895,64.6,2473326,58.7,251569,9.2
379,August 1976,Michigan,6462000,4014317,62.1,3650144,56.5,364173,9.1
380,August 1976,Minnesota,2819000,1860375,66.0,1754797,62.2,105578,5.7
381,August 1976,Mississippi,1662000,975202,58.7,913230,54.9,61972,6.4
382,August 1976,Missouri,3493000,2142316,61.3,2006941,57.5,135375,6.3
383,August 1976,Montana,538000,330148,61.4,310336,57.7,19812,6.0
384,August 1976,Nebraska,1103000,720621,65.3,698032,63.3,22589,3.1
385,August 1976,Nevada,466000,332310,71.3,303615,65.2,28695,8.6
386,August 1976,New Hampshire,604000,400582,66.3,375185,62.1,25397,6.3
387,August 1976,New Jersey,5389000,3323094,61.7,2975450,55.2,347644,10.5
388,August 1976,New Mexico,813000,484771,59.6,441951,54.4,42820,8.8
389,August 1976,New York,13231000,7711955,58.3,6922698,52.3,789257,10.2
390,August 1976,North Carolina,3948000,2619902,66.4,2463670,62.4,156232,6.0
391,August 1976,North Dakota,448000,280450,62.6,269615,60.2,10835,3.9
392,August 1976,Ohio,7738000,4747542,61.4,4390667,56.7,356875,7.5
393,August 1976,Oklahoma,2027000,1189336,58.7,1122770,55.4,66566,5.6
394,August 1976,Oregon,1745000,1094762,62.7,995155,57.0,99607,9.1
395,August 1976,Pennsylvania,8816000,5133739,58.2,4733149,53.7,400590,7.8
396,August 1976,Rhode Island,697000,437500,62.8,401806,57.6,35694,8.2
397,August 1976,South Carolina,2014000,1296450,64.4,1206523,59.9,89927,6.9
398,August 1976,South Dakota,482000,309901,64.3,299915,62.2,9986,3.2
399,August 1976,Tennessee,3122000,1876977,60.1,1764092,56.5,112885,6.0
400,August 1976,Texas,8997000,5755786,64.0,5426895,60.3,328891,5.7
401,August 1976,Utah,840000,531187,63.2,502237,59.8,28950,5.5
402,August 1976,Vermont,344000,217539,63.2,199763,58.1,17776,8.2
403,August 1976,Virginia,3590000,2346485,65.4,2209333,61.5,137152,5.8
404,August 1976,Washington,2643000,1632326,61.8,1486462,56.2,145864,8.9
405,August 1976,West Virginia,1371000,693315,50.6,644460,47.0,48855,7.0
406,August 1976,Wisconsin,3272000,2152299,65.8,2036363,62.2,115936,5.4
407,August 1976,Wyoming,277000,181678,65.6,174649,63.1,7029,3.9
408,September 1976,Alabama,2645000,1507195,57.0,1403488,53.1,103707,6.9
409,September 1976,Alaska,243000,167315,68.9,154146,63.4,13169,7.9
410,September 1976,Arizona,1665000,997610,59.9,904382,54.3,93228,9.3
411,September 1976,Arkansas,1552000,898178,57.9,838703,54.0,59475,6.6
412,September 1976,California,15916000,9986516,62.7,9065302,57.0,921214,9.2
413,September 1976,Colorado,1870000,1247308,66.7,1171424,62.6,75884,6.1
414,September 1976,Connecticut,2265000,1466342,64.7,1334686,58.9,131656,9.0
415,September 1976,Delaware,422000,266225,63.1,240675,57.0,25550,9.6
416,September 1976,District of Columbia,516000,331749,64.3,301823,58.5,29926,9.0
417,September 1976,Florida,6549000,3609567,55.1,3291006,50.3,318561,8.8
418,September 1976,Georgia,3574000,2291968,64.1,2107937,59.0,184031,8.0
419,September 1976,Hawaii,596000,410045,68.8,373983,62.7,36062,8.8
420,September 1976,Idaho,594000,378402,63.7,357094,60.1,21308,5.6
421,September 1976,Illinois,8200000,5161664,62.9,4819299,58.8,342365,6.6
422,September 1976,Indiana,3823000,2449803,64.1,2310374,60.4,139429,5.7
423,September 1976,Iowa,2089000,1347685,64.5,1296091,62.0,51594,3.8
424,September 1976,Kansas,1653000,1078836,65.3,1034308,62.6,44528,4.1
425,September 1976,Kentucky,2499000,1496632,59.9,1417964,56.7,78668,5.3
426,September 1976,Louisiana,2723000,1538809,56.5,1430467,52.5,108342,7.0
427,September 1976,Maine,777000,477675,61.5,436709,56.2,40966,8.6
428,September 1976,Maryland,2988000,1924391,64.4,1795002,60.1,129389,6.7
429,September 1976,Massachusetts,4220000,2726270,64.6,2478825,58.7,247445,9.1
430,September 1976,Michigan,6470000,4019823,62.1,3658709,56.5,361114,9.0
431,September 1976,Minnesota,2823000,1867208,66.1,1759571,62.3,107637,5.8
432,September 1976,Mississippi,1665000,976927,58.7,913422,54.9,63505,6.5
433,September 1976,Missouri,3497000,2150007,61.5,2011687,57.5,138320,6.4
434,September 1976,Montana,539000,332042,61.6,312065,57.9,19977,6.0
435,September 1976,Nebraska,1104000,722566,65.4,699705,63.4,22861,3.2
436,September 1976,Nevada,469000,333660,71.1,304702,65.0,28958,8.7
437,September 1976,New Hampshire,606000,402257,66.4,376996,62.2,25261,6.3
438,September 1976,New Jersey,5394000,3327480,61.7,2978004,55.2,349476,10.5
439,September 1976,New Mexico,815000,487267,59.8,444136,54.5,43131,8.9
440,September 1976,New York,13233000,7702135,58.2,6912814,52.2,789321,10.2
441,September 1976,North Carolina,3955000,2621444,66.3,2461795,62.2,159649,6.1
442,September 1976,North Dakota,448000,281118,62.7,270024,60.3,11094,3.9
443,September 1976,Ohio,7745000,4749246,61.3,4393809,56.7,355437,7.5
444,September 1976,Oklahoma,2030000,1191335,58.7,1125548,55.4,65787,5.5
445,September 1976,Oregon,1751000,1102269,63.0,1001249,57.2,101020,9.2
446,September 1976,Pennsylvania,8822000,5137094,58.2,4739425,53.7,397669,7.7
447,September 1976,Rhode Island,698000,438160,62.8,401912,57.6,36248,8.3
448,September 1976,South Carolina,2018000,1298645,64.4,1208467,59.9,90178,6.9
449,September 1976,South Dakota,482000,310607,64.4,300260,62.3,10347,3.3
450,September 1976,Tennessee,3129000,1886495,60.3,1770818,56.6,115677,6.1
451,September 1976,Texas,9021000,5770305,64.0,5443387,60.3,326918,5.7
452,September 1976,Utah,842000,533344,63.3,504388,59.9,28956,5.4
453,September 1976,Vermont,345000,218206,63.2,200706,58.2,17500,8.0
454,September 1976,Virginia,3598000,2348914,65.3,2211644,61.5,137270,5.8
455,September 1976,Washington,2650000,1646384,62.1,1497953,56.5,148431,9.0
456,September 1976,West Virginia,1374000,691711,50.3,645060,46.9,46651,6.7
457,September 1976,Wisconsin,3276000,2156519,65.8,2040019,62.3,116500,5.4
458,September 1976,Wyoming,278000,182760,65.7,175766,63.2,6994,3.8
459,October 1976,Alabama,2650000,1512273,57.1,1406391,53.1,105882,7.0
460,October 1976,Alaska,244000,167786,68.8,154152,63.2,13634,8.1
461,October 1976,Arizona,1671000,1001958,60.0,908289,54.4,93669,9.3
462,October 1976,Arkansas,1555000,901736,58.0,842429,54.2,59307,6.6
463,October 1976,California,15954000,10021070,62.8,9087546,57.0,933524,9.3
464,October 1976,Colorado,1876000,1254476,66.9,1176908,62.7,77568,6.2
465,October 1976,Connecticut,2267000,1466512,64.7,1338099,59.0,128413,8.8
466,October 1976,Delaware,423000,266885,63.1,240999,57.0,25886,9.7
467,October 1976,District of Columbia,516000,330917,64.1,300722,58.3,30195,9.1
468,October 1976,Florida,6567000,3610341,55.0,3289260,50.1,321081,8.9
469,October 1976,Georgia,3582000,2299129,64.2,2112216,59.0,186913,8.1
470,October 1976,Hawaii,597000,410397,68.7,374963,62.8,35434,8.6
471,October 1976,Idaho,595000,380331,63.9,358882,60.3,21449,5.6
472,October 1976,Illinois,8209000,5162302,62.9,4822883,58.8,339419,6.6
473,October 1976,Indiana,3828000,2451113,64.0,2309792,60.3,141321,5.8
474,October 1976,Iowa,2091000,1351904,64.7,1299667,62.2,52237,3.9
475,October 1976,Kansas,1655000,1081610,65.4,1036798,62.6,44812,4.1
476,October 1976,Kentucky,2503000,1498091,59.9,1420505,56.8,77586,5.2
477,October 1976,Louisiana,2729000,1539587,56.4,1431362,52.5,108225,7.0
478,October 1976,Maine,778000,478254,61.5,436721,56.1,41533,8.7
479,October 1976,Maryland,2993000,1928737,64.4,1798409,60.1,130328,6.8
480,October 1976,Massachusetts,4224000,2727715,64.6,2483762,58.8,243953,8.9
481,October 1976,Michigan,6477000,4025048,62.1,3664565,56.6,360483,9.0
482,October 1976,Minnesota,2827000,1873748,66.3,1764368,62.4,109380,5.8
483,October 1976,Mississippi,1667000,978191,58.7,913363,54.8,64828,6.6
484,October 1976,Missouri,3501000,2155677,61.6,2014721,57.5,140956,6.5
485,October 1976,Montana,540000,334208,61.9,314062,58.2,20146,6.0
486,October 1976,Nebraska,1105000,724723,65.6,701674,63.5,23049,3.2
487,October 1976,Nevada,471000,334967,71.1,305782,64.9,29185,8.7
488,October 1976,New Hampshire,608000,403897,66.4,378609,62.3,25288,6.3
489,October 1976,New Jersey,5398000,3333000,61.7,2980622,55.2,352378,10.6
490,October 1976,New Mexico,818000,490190,59.9,446616,54.6,43574,8.9
491,October 1976,New York,13234000,7688549,58.1,6901865,52.2,786684,10.2
492,October 1976,North Carolina,3963000,2621194,66.1,2458088,62.0,163106,6.2
493,October 1976,North Dakota,449000,281650,62.7,270311,60.2,11339,4.0
494,October 1976,Ohio,7752000,4756134,61.4,4398147,56.7,357987,7.5
495,October 1976,Oklahoma,2034000,1193855,58.7,1128675,55.5,65180,5.5
496,October 1976,Oregon,1756000,1109712,63.2,1007315,57.4,102397,9.2
497,October 1976,Pennsylvania,8828000,5142875,58.3,4743412,53.7,399463,7.8
498,October 1976,Rhode Island,699000,439074,62.8,402211,57.5,36863,8.4
499,October 1976,South Carolina,2023000,1300986,64.3,1210147,59.8,90839,7.0
500,October 1976,South Dakota,483000,311465,64.5,300795,62.3,10670,3.4
501,October 1976,Tennessee,3135000,1893764,60.4,1775429,56.6,118335,6.2
502,October 1976,Texas,9044000,5785215,64.0,5458404,60.4,326811,5.6
503,October 1976,Utah,845000,535313,63.4,506233,59.9,29080,5.4
504,October 1976,Vermont,345000,218913,63.5,201608,58.4,17305,7.9
505,October 1976,Virginia,3605000,2351902,65.2,2214527,61.4,137375,5.8
506,October 1976,Washington,2657000,1658773,62.4,1507876,56.8,150897,9.1
507,October 1976,West Virginia,1376000,692129,50.3,646500,47.0,45629,6.6
508,October 1976,Wisconsin,3281000,2159523,65.8,2042602,62.3,116921,5.4
509,October 1976,Wyoming,279000,183877,65.9,176869,63.4,7008,3.8
510,November 1976,Alabama,2654000,1518265,57.2,1409707,53.1,108558,7.2
511,November 1976,Alaska,244000,168112,68.9,154038,63.1,14074,8.4
512,November 1976,Arizona,1678000,1006303,60.0,912353,54.4,93950,9.3
513,November 1976,Arkansas,1558000,905458,58.1,845924,54.3,59534,6.6
514,November 1976,California,15991000,10056309,62.9,9115173,57.0,941136,9.4
515,November 1976,Colorado,1881000,1261663,67.1,1182382,62.9,79281,6.3
516,November 1976,Connecticut,2270000,1466636,64.6,1341376,59.1,125260,8.5
517,November 1976,Delaware,424000,267699,63.1,241581,57.0,26118,9.8
518,November 1976,District of Columbia,515000,330384,64.2,300006,58.3,30378,9.2
519,November 1976,Florida,6584000,3611946,54.9,3288007,49.9,323939,9.0
520,November 1976,Georgia,3590000,2305572,64.2,2116165,58.9,189407,8.2
521,November 1976,Hawaii,599000,411212,68.6,376165,62.8,35047,8.5
522,November 1976,Idaho,597000,382213,64.0,360540,60.4,21673,5.7
523,November 1976,Illinois,8218000,5163967,62.8,4830097,58.8,333870,6.5
524,November 1976,Indiana,3833000,2450735,63.9,2307827,60.2,142908,5.8
525,November 1976,Iowa,2093000,1356197,64.8,1303223,62.3,52974,3.9
526,November 1976,Kansas,1658000,1084558,65.4,1039285,62.7,45273,4.2
527,November 1976,Kentucky,2507000,1501132,59.9,1424211,56.8,76921,5.1
528,November 1976,Louisiana,2734000,1540432,56.3,1432371,52.4,108061,7.0
529,November 1976,Maine,780000,479045,61.4,436837,56.0,42208,8.8
530,November 1976,Maryland,2997000,1934119,64.5,1802323,60.1,131796,6.8
531,November 1976,Massachusetts,4227000,2729521,64.6,2488634,58.9,240887,8.8
532,November 1976,Michigan,6485000,4030981,62.2,3669679,56.6,361302,9.0
533,November 1976,Minnesota,2831000,1879929,66.4,1769422,62.5,110507,5.9
534,November 1976,Mississippi,1670000,979334,58.6,913286,54.7,66048,6.7
535,November 1976,Missouri,3505000,2159828,61.6,2017377,57.6,142451,6.6
536,November 1976,Montana,542000,336362,62.1,316059,58.3,20303,6.0
537,November 1976,Nebraska,1106000,727025,65.7,703839,63.6,23186,3.2
538,November 1976,Nevada,474000,336500,71.0,307230,64.8,29270,8.7
539,November 1976,New Hampshire,610000,405574,66.5,380131,62.3,25443,6.3
540,November 1976,New Jersey,5403000,3340512,61.8,2984304,55.2,356208,10.7
541,November 1976,New Mexico,820000,493404,60.2,449423,54.8,43981,8.9
542,November 1976,New York,13235000,7675643,58.0,6894001,52.1,781642,10.2
543,November 1976,North Carolina,3971000,2620587,66.0,2454684,61.8,165903,6.3
544,November 1976,North Dakota,449000,282162,62.8,270530,60.3,11632,4.1
545,November 1976,Ohio,7759000,4766906,61.4,4404513,56.8,362393,7.6
546,November 1976,Oklahoma,2038000,1197127,58.7,1132416,55.6,64711,5.4
547,November 1976,Oregon,1761000,1116657,63.4,1013272,57.5,103385,9.3
548,November 1976,Pennsylvania,8835000,5151900,58.3,4746421,53.7,405479,7.9
549,November 1976,Rhode Island,700000,440216,62.9,402792,57.5,37424,8.5
550,November 1976,South Carolina,2027000,1303828,64.3,1211696,59.8,92132,7.1
551,November 1976,South Dakota,483000,312408,64.7,301469,62.4,10939,3.5
552,November 1976,Tennessee,3142000,1899808,60.5,1778618,56.6,121190,6.4
553,November 1976,Texas,9067000,5802339,64.0,5473608,60.4,328731,5.7
554,November 1976,Utah,847000,537110,63.4,507863,60.0,29247,5.4
555,November 1976,Vermont,346000,219711,63.5,202505,58.5,17206,7.8
556,November 1976,Virginia,3612000,2356042,65.2,2218468,61.4,137574,5.8
557,November 1976,Washington,2664000,1668192,62.6,1515113,56.9,153079,9.2
558,November 1976,West Virginia,1378000,694617,50.4,648788,47.1,45829,6.6
559,November 1976,Wisconsin,3286000,2162094,65.8,2044548,62.2,117546,5.4
560,November 1976,Wyoming,280000,185035,66.1,177991,63.6,7044,3.8
561,December 1976,Alabama,2659000,1525568,57.4,1413734,53.2,111834,7.3
562,December 1976,Alaska,245000,168532,68.8,153983,62.9,14549,8.6
563,December 1976,Arizona,1684000,1010700,60.0,916965,54.5,93735,9.3
564,December 1976,Arkansas,1561000,909232,58.2,849277,54.4,59955,6.6
565,December 1976,California,16029000,10093699,63.0,9151973,57.1,941726,9.3
566,December 1976,Colorado,1887000,1268361,67.2,1187185,62.9,81176,6.4
567,December 1976,Connecticut,2272000,1467455,64.6,1345228,59.2,122227,8.3
568,December 1976,Delaware,424000,268702,63.4,242498,57.2,26204,9.8
569,December 1976,District of Columbia,515000,330202,64.1,299736,58.2,30466,9.2
570,December 1976,Florida,6602000,3616376,54.8,3289929,49.8,326447,9.0
571,December 1976,Georgia,3597000,2310617,64.2,2120759,59.0,189858,8.2
572,December 1976,Hawaii,600000,412337,68.7,377575,62.9,34762,8.4
573,December 1976,Idaho,599000,384086,64.1,362126,60.5,21960,5.7
574,December 1976,Illinois,8226000,5169396,62.8,4842649,58.9,326747,6.3
575,December 1976,Indiana,3837000,2449848,63.8,2306491,60.1,143357,5.9
576,December 1976,Iowa,2095000,1360512,64.9,1306982,62.4,53530,3.9
577,December 1976,Kansas,1660000,1087670,65.5,1042019,62.8,45651,4.2
578,December 1976,Kentucky,2511000,1506093,60.0,1429442,56.9,76651,5.1
579,December 1976,Louisiana,2740000,1542754,56.3,1434769,52.4,107985,7.0
580,December 1976,Maine,781000,479906,61.4,437133,56.0,42773,8.9
581,December 1976,Maryland,3002000,1940048,64.6,1807161,60.2,132887,6.8
582,December 1976,Massachusetts,4231000,2732178,64.6,2494193,59.0,237985,8.7
583,December 1976,Michigan,6493000,4037844,62.2,3676377,56.6,361467,9.0
584,December 1976,Minnesota,2835000,1885780,66.5,1774870,62.6,110910,5.9
585,December 1976,Mississippi,1673000,980687,58.6,913359,54.6,67328,6.9
586,December 1976,Missouri,3509000,2163567,61.7,2021522,57.6,142045,6.6
587,December 1976,Montana,543000,338284,62.3,317850,58.5,20434,6.0
588,December 1976,Nebraska,1107000,729311,65.9,706015,63.8,23296,3.2
589,December 1976,Nevada,476000,338319,71.1,309221,65.0,29098,8.6
590,December 1976,New Hampshire,612000,407358,66.6,381741,62.4,25617,6.3
591,December 1976,New Jersey,5407000,3349255,61.9,2990493,55.3,358762,10.7
592,December 1976,New Mexico,823000,496647,60.3,452508,55.0,44139,8.9
593,December 1976,New York,13237000,7669179,57.9,6893647,52.1,775532,10.1
594,December 1976,North Carolina,3978000,2621032,65.9,2454099,61.7,166933,6.4
595,December 1976,North Dakota,450000,282737,62.8,270773,60.2,11964,4.2
596,December 1976,Ohio,7766000,4778882,61.5,4414046,56.8,364836,7.6
597,December 1976,Oklahoma,2041000,1201436,58.9,1136974,55.7,64462,5.4
598,December 1976,Oregon,1766000,1122897,63.6,1019266,57.7,103631,9.2
599,December 1976,Pennsylvania,8841000,5162158,58.4,4750182,53.7,411976,8.0
600,December 1976,Rhode Island,701000,441431,63.0,403615,57.6,37816,8.6
601,December 1976,South Carolina,2032000,1307111,64.3,1213389,59.7,93722,7.2
602,December 1976,South Dakota,484000,313261,64.7,302143,62.4,11118,3.5
603,December 1976,Tennessee,3148000,1905599,60.5,1781712,56.6,123887,6.5
604,December 1976,Texas,9091000,5821892,64.0,5490841,60.4,331051,5.7
605,December 1976,Utah,850000,538754,63.4,509397,59.9,29357,5.4
606,December 1976,Vermont,347000,220626,63.6,203448,58.6,17178,7.8
607,December 1976,Virginia,3620000,2361415,65.2,2223892,61.4,137523,5.8
608,December 1976,Washington,2671000,1674146,62.7,1519467,56.9,154679,9.2
609,December 1976,West Virginia,1381000,698445,50.6,651700,47.2,46745,6.7
610,December 1976,Wisconsin,3290000,2164612,65.8,2046702,62.2,117910,5.4
611,December 1976,Wyoming,281000,186250,66.3,179158,63.8,7092,3.8
612,January 1977,Alabama,2663000,1534383,57.6,1418860,53.3,115523,7.5
613,January 1977,Alaska,245000,169181,69.1,154120,62.9,15061,8.9
614,January 1977,Arizona,1690000,1015516,60.1,922428,54.6,93088,9.2
615,January 1977,Arkansas,1565000,912948,58.3,852573,54.5,60375,6.6
616,January 1977,California,16066000,10135878,63.1,9199971,57.3,935907,9.2
617,January 1977,Colorado,1892000,1274428,67.4,1191307,63.0,83121,6.5
618,January 1977,Connecticut,2274000,1469625,64.6,1350365,59.4,119260,8.1
619,January 1977,Delaware,425000,269870,63.5,243757,57.4,26113,9.7
620,January 1977,District of Columbia,515000,330333,64.1,299853,58.2,30480,9.2
621,January 1977,Florida,6619000,3626043,54.8,3297602,49.8,328441,9.1
622,January 1977,Georgia,3605000,2314596,64.2,2126893,59.0,187703,8.1
623,January 1977,Hawaii,601000,413616,68.8,379133,63.1,34483,8.3
624,January 1977,Idaho,601000,385903,64.2,363669,60.5,22234,5.8
625,January 1977,Illinois,8235000,5181856,62.9,4861433,59.0,320423,6.2
626,January 1977,Indiana,3842000,2450849,63.8,2307840,60.1,143009,5.8
627,January 1977,Iowa,2098000,1364841,65.1,1311092,62.5,53749,3.9
628,January 1977,Kansas,1662000,1090992,65.6,1045175,62.9,45817,4.2
629,January 1977,Kentucky,2516000,1512702,60.1,1436071,57.1,76631,5.1
630,January 1977,Louisiana,2745000,1547949,56.4,1439858,52.5,108091,7.0
631,January 1977,Maine,782000,480715,61.5,437681,56.0,43034,9.0
632,January 1977,Maryland,3006000,1946311,64.7,1813119,60.3,133192,6.8
633,January 1977,Massachusetts,4234000,2736372,64.6,2501143,59.1,235229,8.6
634,January 1977,Michigan,6501000,4046562,62.2,3686679,56.7,359883,8.9
635,January 1977,Minnesota,2839000,1891668,66.6,1780883,62.7,110785,5.9
636,January 1977,Mississippi,1676000,982645,58.6,913814,54.5,68831,7.0
637,January 1977,Missouri,3513000,2169076,61.7,2028693,57.7,140383,6.5
638,January 1977,Montana,544000,340045,62.5,319466,58.7,20579,6.1
639,January 1977,Nebraska,1108000,731511,66.0,708070,63.9,23441,3.2
640,January 1977,Nevada,478000,340412,71.2,311743,65.2,28669,8.4
641,January 1977,New Hampshire,614000,409306,66.7,383572,62.5,25734,6.3
642,January 1977,New Jersey,5411000,3358839,62.1,3000405,55.5,358434,10.7
643,January 1977,New Mexico,825000,499717,60.6,455837,55.3,43880,8.8
644,January 1977,New York,13238000,7673859,58.0,6903917,52.2,769942,10.0
645,January 1977,North Carolina,3986000,2624989,65.9,2458498,61.7,166491,6.3
646,January 1977,North Dakota,450000,283410,63.0,271131,60.3,12279,4.3
647,January 1977,Ohio,7773000,4790642,61.6,4427206,57.0,363436,7.6
648,January 1977,Oklahoma,2045000,1207089,59.0,1142411,55.9,64678,5.4
649,January 1977,Oregon,1772000,1128671,63.7,1025657,57.9,103014,9.1
650,January 1977,Pennsylvania,8847000,5172352,58.5,4756572,53.8,415780,8.0
651,January 1977,Rhode Island,701000,442452,63.1,404540,57.7,37912,8.6
652,January 1977,South Carolina,2036000,1310962,64.4,1215633,59.7,95329,7.3
653,January 1977,South Dakota,484000,313955,64.9,302761,62.6,11194,3.6
654,January 1977,Tennessee,3154000,1912142,60.6,1786066,56.6,126076,6.6
655,January 1977,Texas,9114000,5843715,64.1,5511563,60.5,332152,5.7
656,January 1977,Utah,852000,540348,63.4,510947,60.0,29401,5.4
657,January 1977,Vermont,348000,221659,63.7,204503,58.8,17156,7.7
658,January 1977,Virginia,3627000,2368365,65.3,2231138,61.5,137227,5.8
659,January 1977,Washington,2678000,1677365,62.6,1521761,56.8,155604,9.3
660,January 1977,West Virginia,1383000,702587,50.8,654711,47.3,47876,6.8
661,January 1977,Wisconsin,3295000,2167953,65.8,2050089,62.2,117864,5.4
662,January 1977,Wyoming,282000,187531,66.5,180397,64.0,7134,3.8
663,February 1977,Alabama,2668000,1544075,57.9,1425097,53.4,118978,7.7
664,February 1977,Alaska,246000,170041,69.1,154450,62.8,15591,9.2
665,February 1977,Arizona,1697000,1020831,60.2,928840,54.7,91991,9.0
666,February 1977,Arkansas,1568000,916485,58.4,855865,54.6,60620,6.6
667,February 1977,California,16104000,10181728,63.2,9257211,57.5,924517,9.1
668,February 1977,Colorado,1898000,1279809,67.4,1195055,63.0,84754,6.6
669,February 1977,Connecticut,2276000,1472815,64.7,1356636,59.6,116179,7.9
670,February 1977,Delaware,426000,271090,63.6,245257,57.6,25833,9.5
671,February 1977,District of Columbia,514000,330583,64.3,300117,58.4,30466,9.2
672,February 1977,Florida,6637000,3640399,54.9,3311630,49.9,328769,9.0
673,February 1977,Georgia,3613000,2317645,64.1,2134643,59.1,183002,7.9
674,February 1977,Hawaii,603000,414902,68.8,380730,63.1,34172,8.2
675,February 1977,Idaho,603000,387656,64.3,365219,60.6,22437,5.8
676,February 1977,Illinois,8244000,5201026,63.1,4884765,59.3,316261,6.1
677,February 1977,Indiana,3847000,2455042,63.8,2312544,60.1,142498,5.8
678,February 1977,Iowa,2100000,1368874,65.2,1315260,62.6,53614,3.9
679,February 1977,Kansas,1664000,1094388,65.8,1048656,63.0,45732,4.2
680,February 1977,Kentucky,2520000,1519806,60.3,1443414,57.3,76392,5.0
681,February 1977,Louisiana,2751000,1556163,56.6,1447930,52.6,108233,7.0
682,February 1977,Maine,784000,481378,61.4,438409,55.9,42969,8.9
683,February 1977,Maryland,3011000,1952130,64.8,1819863,60.4,132267,6.8
684,February 1977,Massachusetts,4238000,2741918,64.7,2509691,59.2,232227,8.5
685,February 1977,Michigan,6508000,4056627,62.3,3700838,56.9,355789,8.8
686,February 1977,Minnesota,2844000,1897597,66.7,1787467,62.9,110130,5.8
687,February 1977,Mississippi,1678000,985112,58.7,914769,54.5,70343,7.1
688,February 1977,Missouri,3517000,2177301,61.9,2038976,58.0,138325,6.4
689,February 1977,Montana,545000,341605,62.7,320845,58.9,20760,6.1
690,February 1977,Nebraska,1110000,733589,66.1,709927,64.0,23662,3.2
691,February 1977,Nevada,481000,342653,71.2,314641,65.4,28012,8.2
692,February 1977,New Hampshire,617000,411302,66.7,385621,62.5,25681,6.2
693,February 1977,New Jersey,5416000,3368520,62.2,3013869,55.6,354651,10.5
694,February 1977,New Mexico,828000,502636,60.7,459365,55.5,43271,8.6
695,February 1977,New York,13239000,7685946,58.1,6923761,52.3,762185,9.9
696,February 1977,North Carolina,3994000,2633368,65.9,2468219,61.8,165149,6.3
697,February 1977,North Dakota,451000,284158,63.0,271612,60.2,12546,4.4
698,February 1977,Ohio,7781000,4800915,61.7,4443426,57.1,357489,7.4
699,February 1977,Oklahoma,2049000,1213608,59.2,1148434,56.0,65174,5.4
700,February 1977,Oregon,1777000,1134110,63.8,1032891,58.1,101219,8.9
701,February 1977,Pennsylvania,8853000,5181538,58.5,4766059,53.8,415479,8.0
702,February 1977,Rhode Island,702000,443229,63.1,405469,57.8,37760,8.5
703,February 1977,South Carolina,2041000,1315111,64.4,1218664,59.7,96447,7.3
704,February 1977,South Dakota,485000,314611,64.9,303420,62.6,11191,3.6
705,February 1977,Tennessee,3161000,1919175,60.7,1791995,56.7,127180,6.6
706,February 1977,Texas,9137000,5865786,64.2,5535189,60.6,330597,5.6
707,February 1977,Utah,855000,541806,63.4,512411,59.9,29395,5.4
708,February 1977,Vermont,348000,222749,64.0,205682,59.1,17067,7.7
709,February 1977,Virginia,3634000,2376572,65.4,2239812,61.6,136760,5.8
710,February 1977,Washington,2685000,1678881,62.5,1523269,56.7,155612,9.3
711,February 1977,West Virginia,1385000,706061,51.0,657281,47.5,48780,6.9
712,February 1977,Wisconsin,3300000,2172078,65.8,2054967,62.3,117111,5.4
713,February 1977,Wyoming,284000,188846,66.5,181712,64.0,7134,3.8
714,March 1977,Alabama,2673000,1553665,58.1,1432080,53.6,121585,7.8
715,March 1977,Alaska,246000,170926,69.5,154815,62.9,16111,9.4
716,March 1977,Arizona,1703000,1026273,60.3,935794,54.9,90479,8.8
717,March 1977,Arkansas,1571000,919681,58.5,859108,54.7,60573,6.6
718,March 1977,California,16142000,10227514,63.4,9318337,57.7,909177,8.9
719,March 1977,Colorado,1904000,1284126,67.4,1198433,62.9,85693,6.7
720,March 1977,Connecticut,2278000,1475910,64.8,1363044,59.8,112866,7.6
721,March 1977,Delaware,426000,272185,63.9,246836,57.9,25349,9.3
722,March 1977,District of Columbia,514000,330687,64.3,300193,58.4,30494,9.2
723,March 1977,Florida,6655000,3656840,54.9,3330199,50.0,326641,8.9
724,March 1977,Georgia,3620000,2319462,64.1,2143106,59.2,176356,7.6
725,March 1977,Hawaii,604000,415929,68.9,382233,63.3,33696,8.1
726,March 1977,Idaho,605000,389446,64.4,366823,60.6,22623,5.8
727,March 1977,Illinois,8252000,5223076,63.3,4908178,59.5,314898,6.0
728,March 1977,Indiana,3851000,2461636,63.9,2319534,60.2,142102,5.8
729,March 1977,Iowa,2102000,1372340,65.3,1318874,62.7,53466,3.9
730,March 1977,Kansas,1666000,1097568,65.9,1052164,63.2,45404,4.1
731,March 1977,Kentucky,2524000,1525804,60.5,1450053,57.5,75751,5.0
732,March 1977,Louisiana,2757000,1566229,56.8,1458109,52.9,108120,6.9
733,March 1977,Maine,785000,481778,61.4,439138,55.9,42640,8.9
734,March 1977,Maryland,3015000,1956482,64.9,1826574,60.6,129908,6.6
735,March 1977,Massachusetts,4242000,2748044,64.8,2519277,59.4,228767,8.3
736,March 1977,Michigan,6516000,4066758,62.4,3716881,57.0,349877,8.6
737,March 1977,Minnesota,2848000,1903458,66.8,1794378,63.0,109080,5.7
738,March 1977,Mississippi,1681000,987695,58.8,916058,54.5,71637,7.3
739,March 1977,Missouri,3521000,2187601,62.1,2050903,58.2,136698,6.2
740,March 1977,Montana,546000,342989,62.8,322026,59.0,20963,6.1
741,March 1977,Nebraska,1111000,735463,66.2,711533,64.0,23930,3.3
742,March 1977,Nevada,483000,344802,71.4,317643,65.8,27159,7.9
743,March 1977,New Hampshire,619000,413113,66.7,387748,62.6,25365,6.1
744,March 1977,New Jersey,5420000,3376107,62.3,3028935,55.9,347172,10.3
745,March 1977,New Mexico,830000,505526,60.9,463015,55.8,42511,8.4
746,March 1977,New York,13241000,7699013,58.1,6948749,52.5,750264,9.7
747,March 1977,North Carolina,4001000,2644931,66.1,2481595,62.0,163336,6.2
748,March 1977,North Dakota,452000,284891,63.0,272131,60.2,12760,4.5
749,March 1977,Ohio,7788000,4808369,61.7,4461344,57.3,347025,7.2
750,March 1977,Oklahoma,2052000,1219925,59.5,1154455,56.3,65470,5.4
751,March 1977,Oregon,1782000,1139258,63.9,1041049,58.4,98209,8.6
752,March 1977,Pennsylvania,8859000,5187821,58.6,4776267,53.9,411554,7.9
753,March 1977,Rhode Island,703000,443847,63.1,406380,57.8,37467,8.4
754,March 1977,South Carolina,2045000,1318733,64.5,1222378,59.8,96355,7.3
755,March 1977,South Dakota,485000,315279,65.0,304174,62.7,11105,3.5
756,March 1977,Tennessee,3167000,1925963,60.8,1798864,56.8,127099,6.6
757,March 1977,Texas,9161000,5885057,64.2,5559030,60.7,326027,5.5
758,March 1977,Utah,857000,542953,63.4,513602,59.9,29351,5.4
759,March 1977,Vermont,349000,223807,64.1,206944,59.3,16863,7.5
760,March 1977,Virginia,3642000,2384337,65.5,2248658,61.7,135679,5.7
761,March 1977,Washington,2692000,1679640,62.4,1524989,56.6,154651,9.2
762,March 1977,West Virginia,1388000,708184,51.0,658956,47.5,49228,7.0
763,March 1977,Wisconsin,3304000,2176031,65.9,2060631,62.4,115400,5.3
764,March 1977,Wyoming,285000,190150,66.7,183087,64.2,7063,3.7
765,April 1977,Alabama,2677000,1562297,58.4,1439468,53.8,122829,7.9
766,April 1977,Alaska,247000,171568,69.5,155026,62.8,16542,9.6
767,April 1977,Arizona,1710000,1031901,60.3,942915,55.1,88986,8.6
768,April 1977,Arkansas,1574000,922639,58.6,862374,54.8,60265,6.5
769,April 1977,California,16179000,10272205,63.5,9379392,58.0,892813,8.7
770,April 1977,Colorado,1909000,1287111,67.4,1201482,62.9,85629,6.7
771,April 1977,Connecticut,2280000,1478384,64.8,1368978,60.0,109406,7.4
772,April 1977,Delaware,427000,273009,63.9,248330,58.2,24679,9.0
773,April 1977,District of Columbia,513000,330531,64.4,299929,58.5,30602,9.3
774,April 1977,Florida,6672000,3673735,55.1,3351765,50.2,321970,8.8
775,April 1977,Georgia,3628000,2320611,64.0,2151523,59.3,169088,7.3
776,April 1977,Hawaii,606000,416462,68.7,383521,63.3,32941,7.9
777,April 1977,Idaho,606000,391428,64.6,368592,60.8,22836,5.8
778,April 1977,Illinois,8261000,5245102,63.5,4928603,59.7,316499,6.0
779,April 1977,Indiana,3856000,2469608,64.0,2327568,60.4,142040,5.8
780,April 1977,Iowa,2104000,1375242,65.4,1321713,62.8,53529,3.9
781,April 1977,Kansas,1668000,1100425,66.0,1055533,63.3,44892,4.1
782,April 1977,Kentucky,2528000,1529936,60.5,1455042,57.6,74894,4.9
783,April 1977,Louisiana,2762000,1576996,57.1,1469214,53.2,107782,6.8
784,April 1977,Maine,787000,481844,61.2,439764,55.9,42080,8.7
785,April 1977,Maryland,3020000,1959080,64.9,1832788,60.7,126292,6.4
786,April 1977,Massachusetts,4245000,2754308,64.9,2529103,59.6,225205,8.2
787,April 1977,Michigan,6524000,4077260,62.5,3733183,57.2,344077,8.4
788,April 1977,Minnesota,2852000,1908978,66.9,1801328,63.2,107650,5.6
789,April 1977,Mississippi,1684000,990279,58.8,917544,54.5,72735,7.3
790,April 1977,Missouri,3525000,2199105,62.4,2063173,58.5,135932,6.2
791,April 1977,Montana,547000,344561,63.0,323360,59.1,21201,6.2
792,April 1977,Nebraska,1112000,737153,66.3,712920,64.1,24233,3.3
793,April 1977,Nevada,486000,346682,71.3,320508,65.9,26174,7.5
794,April 1977,New Hampshire,621000,414699,66.8,389935,62.8,24764,6.0
795,April 1977,New Jersey,5425000,3380846,62.3,3043611,56.1,337235,10.0
796,April 1977,New Mexico,833000,508341,61.0,466650,56.0,41691,8.2
797,April 1977,New York,13242000,7710663,58.2,6975580,52.7,735083,9.5
798,April 1977,North Carolina,4009000,2658598,66.3,2496789,62.3,161809,6.1
799,April 1977,North Dakota,452000,285557,63.2,272636,60.3,12921,4.5
800,April 1977,Ohio,7795000,4813381,61.7,4479849,57.5,333532,6.9
801,April 1977,Oklahoma,2056000,1225529,59.6,1160211,56.4,65318,5.3
802,April 1977,Oregon,1787000,1144263,64.0,1049879,58.8,94384,8.2
803,April 1977,Pennsylvania,8865000,5191317,58.6,4785229,54.0,406088,7.8
804,April 1977,Rhode Island,704000,444402,63.1,407307,57.9,37095,8.3
805,April 1977,South Carolina,2050000,1321586,64.5,1226576,59.8,95010,7.2
806,April 1977,South Dakota,486000,315964,65.0,305034,62.8,10930,3.5
807,April 1977,Tennessee,3174000,1932067,60.9,1806112,56.9,125955,6.5
808,April 1977,Texas,9184000,5900976,64.3,5581449,60.8,319527,5.4
809,April 1977,Utah,860000,543772,63.2,514549,59.8,29223,5.4
810,April 1977,Vermont,350000,224834,64.2,208294,59.5,16540,7.4
811,April 1977,Virginia,3649000,2390572,65.5,2256965,61.9,133607,5.6
812,April 1977,Washington,2699000,1680812,62.3,1527999,56.6,152813,9.1
813,April 1977,West Virginia,1390000,709020,51.0,659772,47.5,49248,6.9
814,April 1977,Wisconsin,3309000,2179647,65.9,2066416,62.4,113231,5.2
815,April 1977,Wyoming,286000,191462,66.9,184548,64.5,6914,3.6
816,May 1977,Alabama,2682000,1568937,58.5,1446727,53.9,122210,7.8
817,May 1977,Alaska,247000,171912,69.6,155066,62.8,16846,9.8
818,May 1977,Arizona,1716000,1037677,60.5,949864,55.4,87813,8.5
819,May 1977,Arkansas,1578000,925500,58.7,865597,54.9,59903,6.5
820,May 1977,California,16217000,10315498,63.6,9438033,58.2,877465,8.5
821,May 1977,Colorado,1915000,1288954,67.3,1204375,62.9,84579,6.6
822,May 1977,Connecticut,2283000,1480361,64.8,1374228,60.2,106133,7.2
823,May 1977,Delaware,428000,273473,63.9,249589,58.3,23884,8.7
824,May 1977,District of Columbia,513000,330148,64.4,299404,58.4,30744,9.3
825,May 1977,Florida,6690000,3690261,55.2,3374951,50.4,315310,8.5
826,May 1977,Georgia,3636000,2321832,63.9,2159450,59.4,162382,7.0
827,May 1977,Hawaii,607000,416569,68.6,384494,63.3,32075,7.7
828,May 1977,Idaho,608000,393705,64.8,370629,61.0,23076,5.9
829,May 1977,Illinois,8270000,5265352,63.7,4944440,59.8,320912,6.1
830,May 1977,Indiana,3861000,2477586,64.2,2335266,60.5,142320,5.7
831,May 1977,Iowa,2107000,1377965,65.4,1324156,62.8,53809,3.9
832,May 1977,Kansas,1671000,1102966,66.0,1058626,63.4,44340,4.0
833,May 1977,Kentucky,2533000,1532361,60.5,1458427,57.6,73934,4.8
834,May 1977,Louisiana,2768000,1587365,57.3,1479770,53.5,107595,6.8
835,May 1977,Maine,788000,481532,61.1,440217,55.9,41315,8.6
836,May 1977,Maryland,3024000,1960743,64.8,1838453,60.8,122290,6.2
837,May 1977,Massachusetts,4249000,2759927,65.0,2538267,59.7,221660,8.0
838,May 1977,Michigan,6532000,4088355,62.6,3749088,57.4,339267,8.3
839,May 1977,Minnesota,2856000,1913748,67.0,1807886,63.3,105862,5.5
840,May 1977,Mississippi,1687000,992640,58.8,919055,54.5,73585,7.4
841,May 1977,Missouri,3529000,2210554,62.6,2074618,58.8,135936,6.1
842,May 1977,Montana,549000,346442,63.1,324941,59.2,21501,6.2
843,May 1977,Nebraska,1113000,738769,66.4,714145,64.2,24624,3.3
844,May 1977,Nevada,488000,348213,71.4,323094,66.2,25119,7.2
845,May 1977,New Hampshire,623000,416139,66.8,392175,62.9,23964,5.8
846,May 1977,New Jersey,5429000,3382905,62.3,3056295,56.3,326610,9.7
847,May 1977,New Mexico,835000,510945,61.2,470135,56.3,40810,8.0
848,May 1977,New York,13243000,7719926,58.3,7001075,52.9,718851,9.3
849,May 1977,North Carolina,4017000,2673066,66.5,2512115,62.5,160951,6.0
850,May 1977,North Dakota,453000,286183,63.2,273125,60.3,13058,4.6
851,May 1977,Ohio,7802000,4817529,61.7,4497884,57.7,319645,6.6
852,May 1977,Oklahoma,2060000,1230292,59.7,1165583,56.6,64709,5.3
853,May 1977,Oregon,1793000,1149169,64.1,1058915,59.1,90254,7.9
854,May 1977,Pennsylvania,8872000,5193541,58.5,4792473,54.0,401068,7.7
855,May 1977,Rhode Island,705000,445012,63.1,408327,57.9,36685,8.2
856,May 1977,South Carolina,2054000,1323803,64.5,1230885,59.9,92918,7.0
857,May 1977,South Dakota,486000,316653,65.2,305974,63.0,10679,3.4
858,May 1977,Tennessee,3180000,1936817,60.9,1812978,57.0,123839,6.4
859,May 1977,Texas,9207000,5915306,64.2,5602054,60.8,313252,5.3
860,May 1977,Utah,862000,544359,63.2,515376,59.8,28983,5.3
861,May 1977,Vermont,351000,225923,64.4,209763,59.8,16160,7.2
862,May 1977,Virginia,3656000,2395358,65.5,2264422,61.9,130936,5.5
863,May 1977,Washington,2706000,1683073,62.2,1532870,56.6,150203,8.9
864,May 1977,West Virginia,1392000,709157,50.9,660138,47.4,49019,6.9
865,May 1977,Wisconsin,3314000,2182854,65.9,2071492,62.5,111362,5.1
866,May 1977,Wyoming,287000,192822,67.2,186101,64.8,6721,3.5
867,June 1977,Alabama,2686000,1573270,58.6,1453467,54.1,119803,7.6
868,June 1977,Alaska,248000,172108,69.4,155071,62.5,17037,9.9
869,June 1977,Arizona,1723000,1043243,60.5,956280,55.5,86963,8.3
870,June 1977,Arkansas,1581000,928520,58.7,868832,55.0,59688,6.4
871,June 1977,California,16254000,10358157,63.7,9493732,58.4,864425,8.3
872,June 1977,Colorado,1920000,1290346,67.2,1207360,62.9,82986,6.4
873,June 1977,Connecticut,2285000,1482432,64.9,1379006,60.4,103426,7.0
874,June 1977,Delaware,428000,273603,63.9,250531,58.5,23072,8.4
875,June 1977,District of Columbia,512000,329634,64.4,298809,58.4,30825,9.4
876,June 1977,Florida,6707000,3706641,55.3,3398744,50.7,307897,8.3
877,June 1977,Georgia,3643000,2324189,63.8,2166689,59.5,157500,6.8
878,June 1977,Hawaii,609000,416515,68.4,385092,63.2,31423,7.5
879,June 1977,Idaho,610000,396257,65.0,372942,61.1,23315,5.9
880,June 1977,Illinois,8278000,5283181,63.8,4955641,59.9,327540,6.2
881,June 1977,Indiana,3865000,2484971,64.3,2342099,60.6,142872,5.7
882,June 1977,Iowa,2109000,1381129,65.5,1326867,62.9,54262,3.9
883,June 1977,Kansas,1673000,1105209,66.1,1061335,63.4,43874,4.0
884,June 1977,Kentucky,2537000,1533975,60.5,1461025,57.6,72950,4.8
885,June 1977,Louisiana,2773000,1596665,57.6,1488694,53.7,107971,6.8
886,June 1977,Maine,790000,480887,60.9,440468,55.8,40419,8.4
887,June 1977,Maryland,3029000,1963111,64.8,1843863,60.9,119248,6.1
888,June 1977,Massachusetts,4252000,2764312,65.0,2546166,59.9,218146,7.9
889,June 1977,Michigan,6539000,4100553,62.7,3764049,57.6,336504,8.2
890,June 1977,Minnesota,2860000,1917528,67.0,1813744,63.4,103784,5.4
891,June 1977,Mississippi,1689000,994652,58.9,920508,54.5,74144,7.5
892,June 1977,Missouri,3533000,2220906,62.9,2084446,59.0,136460,6.1
893,June 1977,Montana,550000,348399,63.3,326582,59.4,21817,6.3
894,June 1977,Nebraska,1114000,740481,66.5,715300,64.2,25181,3.4
895,June 1977,Nevada,491000,349482,71.2,325440,66.3,24042,6.9
896,June 1977,New Hampshire,625000,417506,66.8,394423,63.1,23083,5.5
897,June 1977,New Jersey,5434000,3383078,62.3,3066068,56.4,317010,9.4
898,June 1977,New Mexico,838000,513297,61.3,473442,56.5,39855,7.8
899,June 1977,New York,13245000,7726901,58.3,7022585,53.0,704316,9.1
900,June 1977,North Carolina,4024000,2687046,66.8,2526055,62.8,160991,6.0
901,June 1977,North Dakota,453000,286814,63.3,273629,60.4,13185,4.6
902,June 1977,Ohio,7809000,4822966,61.8,4515022,57.8,307944,6.4
903,June 1977,Oklahoma,2063000,1234329,59.8,1170695,56.7,63634,5.2
904,June 1977,Oregon,1798000,1153957,64.2,1067749,59.4,86208,7.5
905,June 1977,Pennsylvania,8878000,5196703,58.5,4799142,54.1,397561,7.7
906,June 1977,Rhode Island,706000,445732,63.1,409501,58.0,36231,8.1
907,June 1977,South Carolina,2059000,1325795,64.4,1234941,60.0,90854,6.9
908,June 1977,South Dakota,487000,317357,65.2,306952,63.0,10405,3.3
909,June 1977,Tennessee,3187000,1939872,60.9,1818643,57.1,121229,6.2
910,June 1977,Texas,9231000,5930627,64.2,5621018,60.9,309609,5.2
911,June 1977,Utah,865000,544934,63.0,516273,59.7,28661,5.3
912,June 1977,Vermont,351000,227153,64.7,211356,60.2,15797,7.0
913,June 1977,Virginia,3664000,2399722,65.5,2271131,62.0,128591,5.4
914,June 1977,Washington,2713000,1686771,62.2,1539477,56.7,147294,8.7
915,June 1977,West Virginia,1395000,709628,50.9,660915,47.4,48713,6.9
916,June 1977,Wisconsin,3318000,2185493,65.9,2075391,62.5,110102,5.0
917,June 1977,Wyoming,288000,194210,67.4,187678,65.2,6532,3.4
918,July 1977,Alabama,2691000,1575689,58.6,1459495,54.2,116194,7.4
919,July 1977,Alaska,248000,172362,69.5,155209,62.6,17153,10.0
920,July 1977,Arizona,1729000,1048322,60.6,962096,55.6,86226,8.2
921,July 1977,Arkansas,1584000,932019,58.8,872217,55.1,59802,6.4
922,July 1977,California,16292000,10401572,63.8,9548241,58.6,853331,8.2
923,July 1977,Colorado,1926000,1291967,67.1,1210767,62.9,81200,6.3
924,July 1977,Connecticut,2287000,1485113,64.9,1383722,60.5,101391,6.8
925,July 1977,Delaware,429000,273524,63.8,251174,58.5,22350,8.2
926,July 1977,District of Columbia,512000,329182,64.3,298416,58.3,30766,9.3
927,July 1977,Florida,6725000,3724185,55.4,3423652,50.9,300533,8.1
928,July 1977,Georgia,3651000,2328381,63.8,2173729,59.5,154652,6.6
929,July 1977,Hawaii,610000,416627,68.3,385371,63.2,31256,7.5
930,July 1977,Idaho,612000,399010,65.2,375497,61.4,23513,5.9
931,July 1977,Illinois,8287000,5298086,63.9,4964523,59.9,333563,6.3
932,July 1977,Indiana,3870000,2492340,64.4,2348443,60.7,143897,5.8
933,July 1977,Iowa,2111000,1384987,65.6,1330321,63.0,54666,3.9
934,July 1977,Kansas,1675000,1107313,66.1,1063878,63.5,43435,3.9
935,July 1977,Kentucky,2541000,1535854,60.4,1463770,57.6,72084,4.7
936,July 1977,Louisiana,2779000,1605103,57.8,1495586,53.8,109517,6.8
937,July 1977,Maine,791000,480034,60.7,440555,55.7,39479,8.2
938,July 1977,Maryland,3033000,1967973,64.9,1849700,61.0,118273,6.0
939,July 1977,Massachusetts,4256000,2767582,65.0,2553077,60.0,214505,7.8
940,July 1977,Michigan,6547000,4114470,62.8,3778745,57.7,335725,8.2
941,July 1977,Minnesota,2864000,1920289,67.0,1818921,63.5,101368,5.3
942,July 1977,Mississippi,1692000,996558,58.9,922193,54.5,74365,7.5
943,July 1977,Missouri,3537000,2229405,63.0,2092990,59.2,136415,6.1
944,July 1977,Montana,551000,350246,63.6,328108,59.5,22138,6.3
945,July 1977,Nebraska,1115000,742304,66.6,716496,64.3,25808,3.5
946,July 1977,Nevada,493000,350702,71.1,327739,66.5,22963,6.5
947,July 1977,New Hampshire,627000,418983,66.8,396750,63.3,22233,5.3
948,July 1977,New Jersey,5438000,3383198,62.2,3073829,56.5,309369,9.1
949,July 1977,New Mexico,840000,515468,61.4,476570,56.7,38898,7.5
950,July 1977,New York,13246000,7733588,58.4,7040877,53.2,692711,9.0
951,July 1977,North Carolina,4032000,2699832,67.0,2538695,63.0,161137,6.0
952,July 1977,North Dakota,454000,287469,63.3,274182,60.4,13287,4.6
953,July 1977,Ohio,7816000,4831709,61.8,4531306,58.0,300403,6.2
954,July 1977,Oklahoma,2067000,1237977,59.9,1175955,56.9,62022,5.0
955,July 1977,Oregon,1803000,1158832,64.3,1076153,59.7,82679,7.1
956,July 1977,Pennsylvania,8884000,5202216,58.6,4806759,54.1,395457,7.6
957,July 1977,Rhode Island,707000,446635,63.2,410878,58.1,35757,8.0
958,July 1977,South Carolina,2063000,1327937,64.4,1238518,60.0,89419,6.7
959,July 1977,South Dakota,487000,318064,65.3,307894,63.2,10170,3.2
960,July 1977,Tennessee,3193000,1942119,60.8,1823188,57.1,118931,6.1
961,July 1977,Texas,9254000,5948949,64.3,5639897,60.9,309052,5.2
962,July 1977,Utah,867000,545716,62.9,517420,59.7,28296,5.2
963,July 1977,Vermont,352000,228564,64.9,213046,60.5,15518,6.8
964,July 1977,Virginia,3671000,2405066,65.5,2277813,62.0,127253,5.3
965,July 1977,Washington,2720000,1691931,62.2,1547808,56.9,144123,8.5
966,July 1977,West Virginia,1397000,711007,50.9,662456,47.4,48551,6.8
967,July 1977,Wisconsin,3323000,2187886,65.8,2078542,62.6,109344,5.0
968,July 1977,Wyoming,289000,195591,67.7,189199,65.5,6392,3.3
969,August 1977,Alabama,2696000,1577504,58.5,1464868,54.3,112636,7.1
970,August 1977,Alaska,249000,172970,69.5,155636,62.5,17334,10.0
971,August 1977,Arizona,1736000,1052303,60.6,967390,55.7,84913,8.1
972,August 1977,Arkansas,1587000,935753,59.0,875682,55.2,60071,6.4
973,August 1977,California,16333000,10446699,64.0,9603442,58.8,843257,8.1
974,August 1977,Colorado,1932000,1294796,67.0,1214718,62.9,80078,6.2
975,August 1977,Connecticut,2289000,1488588,65.0,1388697,60.7,99891,6.7
976,August 1977,Delaware,430000,273383,63.6,251614,58.5,21769,8.0
977,August 1977,District of Columbia,512000,329043,64.3,298485,58.3,30558,9.3
978,August 1977,Florida,6746000,3744507,55.5,3450730,51.2,293777,7.8
979,August 1977,Georgia,3658000,2334559,63.8,2181393,59.6,153166,6.6
980,August 1977,Hawaii,611000,417000,68.2,385449,63.1,31551,7.6
981,August 1977,Idaho,614000,401765,65.4,378170,61.6,23595,5.9
982,August 1977,Illinois,8294000,5311995,64.0,4974415,60.0,337580,6.4
983,August 1977,Indiana,3875000,2500562,64.5,2355133,60.8,145429,5.8
984,August 1977,Iowa,2113000,1389455,65.8,1334685,63.2,54770,3.9
985,August 1977,Kansas,1677000,1109347,66.2,1066542,63.6,42805,3.9
986,August 1977,Kentucky,2545000,1539136,60.5,1467138,57.6,71998,4.7
987,August 1977,Louisiana,2784000,1613426,58.0,1500984,53.9,112442,7.0
988,August 1977,Maine,792000,479154,60.5,440596,55.6,38558,8.0
989,August 1977,Maryland,3037000,1975793,65.1,1856446,61.1,119347,6.0
990,August 1977,Massachusetts,4260000,2770477,65.0,2560004,60.1,210473,7.6
991,August 1977,Michigan,6555000,4129718,63.0,3794421,57.9,335297,8.1
992,August 1977,Minnesota,2868000,1922544,67.0,1823778,63.6,98766,5.1
993,August 1977,Mississippi,1695000,998810,58.9,924425,54.5,74385,7.4
994,August 1977,Missouri,3541000,2236129,63.1,2101127,59.3,135002,6.0
995,August 1977,Montana,552000,351912,63.8,329454,59.7,22458,6.4
996,August 1977,Nebraska,1116000,744138,66.7,717740,64.3,26398,3.5
997,August 1977,Nevada,496000,352106,71.0,330216,66.6,21890,6.2
998,August 1977,New Hampshire,629000,420626,66.9,399127,63.5,21499,5.1
999,August 1977,New Jersey,5443000,3385038,62.2,3081806,56.6,303232,9.0
1000,August 1977,New Mexico,842000,517479,61.5,479575,57.0,37904,7.3
1001,August 1977,New York,13246000,7742645,58.5,7058488,53.3,684157,8.8
1002,August 1977,North Carolina,4039000,2711584,67.1,2550986,63.2,160598,5.9
1003,August 1977,North Dakota,454000,288183,63.5,274814,60.5,13369,4.6
1004,August 1977,Ohio,7823000,4843433,61.9,4546423,58.1,297010,6.1
1005,August 1977,Oklahoma,2071000,1241404,59.9,1181698,57.1,59706,4.8
1006,August 1977,Oregon,1808000,1163933,64.4,1084133,60.0,79800,6.9
1007,August 1977,Pennsylvania,8889000,5210187,58.6,4815946,54.2,394241,7.6
1008,August 1977,Rhode Island,708000,447670,63.2,412396,58.2,35274,7.9
1009,August 1977,South Carolina,2068000,1330448,64.3,1241696,60.0,88752,6.7
1010,August 1977,South Dakota,487000,318739,65.4,308712,63.4,10027,3.1
1011,August 1977,Tennessee,3198000,1945081,60.8,1827427,57.1,117654,6.0
1012,August 1977,Texas,9278000,5971461,64.4,5660471,61.0,310990,5.2
1013,August 1977,Utah,870000,546742,62.8,518892,59.6,27850,5.1
1014,August 1977,Vermont,353000,230105,65.2,214752,60.8,15353,6.7
1015,August 1977,Virginia,3679000,2412419,65.6,2285198,62.1,127221,5.3
1016,August 1977,Washington,2729000,1698876,62.3,1558192,57.1,140684,8.3
1017,August 1977,West Virginia,1398000,713151,51.0,664365,47.5,48786,6.8
1018,August 1977,Wisconsin,3327000,2190973,65.9,2081708,62.6,109265,5.0
1019,August 1977,Wyoming,290000,196919,67.9,190620,65.7,6299,3.2
1020,September 1977,Alabama,2701000,1579545,58.5,1469855,54.4,109690,6.9
1021,September 1977,Alaska,249000,174035,69.9,156389,62.8,17646,10.1
1022,September 1977,Arizona,1743000,1055055,60.5,972195,55.8,82860,7.9
1023,September 1977,Arkansas,1590000,938989,59.1,878807,55.3,60182,6.4
1024,September 1977,California,16375000,10492875,64.1,9659732,59.0,833143,7.9
1025,September 1977,Colorado,1938000,1298913,67.0,1219060,62.9,79853,6.1
1026,September 1977,Connecticut,2292000,1492327,65.1,1394022,60.8,98305,6.6
1027,September 1977,Delaware,430000,273280,63.6,251956,58.6,21324,7.8
1028,September 1977,District of Columbia,512000,329430,64.3,299157,58.4,30273,9.2
1029,September 1977,Florida,6767000,3768320,55.7,3480190,51.4,288130,7.6
1030,September 1977,Georgia,3665000,2341803,63.9,2190136,59.8,151667,6.5
1031,September 1977,Hawaii,612000,417476,68.2,385445,63.0,32031,7.7
1032,September 1977,Idaho,616000,404265,65.6,380804,61.8,23461,5.8
1033,September 1977,Illinois,8301000,5327223,64.2,4987142,60.1,340081,6.4
1034,September 1977,Indiana,3881000,2509449,64.7,2362916,60.9,146533,5.8
1035,September 1977,Iowa,2114000,1394183,66.0,1339690,63.4,54493,3.9
1036,September 1977,Kansas,1679000,1111360,66.2,1069423,63.7,41937,3.8
1037,September 1977,Kentucky,2548000,1543953,60.6,1471034,57.7,72919,4.7
1038,September 1977,Louisiana,2789000,1622028,58.2,1505819,54.0,116209,7.2
1039,September 1977,Maine,794000,478420,60.3,440789,55.5,37631,7.9
1040,September 1977,Maryland,3041000,1984662,65.3,1863976,61.3,120686,6.1
1041,September 1977,Massachusetts,4263000,2773738,65.1,2567798,60.2,205940,7.4
1042,September 1977,Michigan,6562000,4144399,63.2,3811069,58.1,333330,8.0
1043,September 1977,Minnesota,2872000,1924827,67.0,1828891,63.7,95936,5.0
1044,September 1977,Mississippi,1697000,1001357,59.0,927140,54.6,74217,7.4
1045,September 1977,Missouri,3545000,2241727,63.2,2109220,59.5,132507,5.9
1046,September 1977,Montana,554000,353367,63.8,330630,59.7,22737,6.4
1047,September 1977,Nebraska,1117000,745815,66.8,718906,64.4,26909,3.6
1048,September 1977,Nevada,499000,353852,70.9,332987,66.7,20865,5.9
1049,September 1977,New Hampshire,631000,422231,66.9,401355,63.6,20876,4.9
1050,September 1977,New Jersey,5449000,3388938,62.2,3091686,56.7,297252,8.8
1051,September 1977,New Mexico,845000,519278,61.5,482503,57.1,36775,7.1
1052,September 1977,New York,13247000,7754068,58.5,7076707,53.4,677361,8.7
1053,September 1977,North Carolina,4046000,2722700,67.3,2563719,63.4,158981,5.8
1054,September 1977,North Dakota,455000,288953,63.5,275525,60.6,13428,4.6
1055,September 1977,Ohio,7830000,4854501,62.0,4559945,58.2,294556,6.1
1056,September 1977,Oklahoma,2075000,1244868,60.0,1187690,57.2,57178,4.6
1057,September 1977,Oregon,1813000,1169060,64.5,1091817,60.2,77243,6.6
1058,September 1977,Pennsylvania,8893000,5219316,58.7,4826594,54.3,392722,7.5
1059,September 1977,Rhode Island,708000,448522,63.4,413738,58.4,34784,7.8
1060,September 1977,South Carolina,2073000,1332985,64.3,1244768,60.0,88217,6.6
1061,September 1977,South Dakota,488000,319316,65.4,309357,63.4,9959,3.1
1062,September 1977,Tennessee,3203000,1949005,60.8,1831937,57.2,117068,6.0
1063,September 1977,Texas,9302000,5997396,64.5,5683524,61.1,313872,5.2
1064,September 1977,Utah,872000,547901,62.8,520646,59.7,27255,5.0
1065,September 1977,Vermont,353000,231631,65.6,216366,61.3,15265,6.6
1066,September 1977,Virginia,3686000,2421483,65.7,2293372,62.2,128111,5.3
1067,September 1977,Washington,2738000,1707577,62.4,1570731,57.4,136846,8.0
1068,September 1977,West Virginia,1400000,715105,51.1,666054,47.6,49051,6.9
1069,September 1977,Wisconsin,3330000,2195282,65.9,2085514,62.6,109768,5.0
1070,September 1977,Wyoming,292000,198168,67.9,191935,65.7,6233,3.1
1071,October 1977,Alabama,2705000,1581808,58.5,1474532,54.5,107276,6.8
1072,October 1977,Alaska,250000,175463,70.2,157392,63.0,18071,10.3
1073,October 1977,Arizona,1749000,1056648,60.4,976316,55.8,80332,7.6
1074,October 1977,Arkansas,1592000,941048,59.1,880979,55.3,60069,6.4
1075,October 1977,California,16416000,10538290,64.2,9715329,59.2,822961,7.8
1076,October 1977,Colorado,1944000,1303489,67.1,1223548,62.9,79941,6.1
1077,October 1977,Connecticut,2294000,1495216,65.2,1399225,61.0,95991,6.4
1078,October 1977,Delaware,431000,273253,63.4,252250,58.5,21003,7.7
1079,October 1977,District of Columbia,511000,330318,64.6,300394,58.8,29924,9.1
1080,October 1977,Florida,6787000,3794285,55.9,3510739,51.7,283546,7.5
1081,October 1977,Georgia,3672000,2348607,64.0,2199685,59.9,148922,6.3
1082,October 1977,Hawaii,613000,417914,68.2,385453,62.9,32461,7.8
1083,October 1977,Idaho,617000,406300,65.9,383195,62.1,23105,5.7
1084,October 1977,Illinois,8308000,5342744,64.3,5001735,60.2,341009,6.4
1085,October 1977,Indiana,3886000,2518128,64.8,2371529,61.0,146599,5.8
1086,October 1977,Iowa,2116000,1398688,66.1,1344650,63.5,54038,3.9
1087,October 1977,Kansas,1681000,1113460,66.2,1072433,63.8,41027,3.7
1088,October 1977,Kentucky,2552000,1549235,60.7,1474816,57.8,74419,4.8
1089,October 1977,Louisiana,2794000,1630797,58.4,1510705,54.1,120092,7.4
1090,October 1977,Maine,795000,477895,60.1,441269,55.5,36626,7.7
1091,October 1977,Maryland,3045000,1992736,65.4,1871736,61.5,121000,6.1
1092,October 1977,Massachusetts,4267000,2777470,65.1,2576525,60.4,200945,7.2
1093,October 1977,Michigan,6570000,4155637,63.3,3827163,58.3,328474,7.9
1094,October 1977,Minnesota,2875000,1927399,67.0,1834724,63.8,92675,4.8
1095,October 1977,Mississippi,1700000,1003796,59.0,930006,54.7,73790,7.4
1096,October 1977,Missouri,3549000,2246311,63.3,2116560,59.6,129751,5.8
1097,October 1977,Montana,555000,354692,63.9,331708,59.8,22984,6.5
1098,October 1977,Nebraska,1118000,747329,66.8,719893,64.4,27436,3.7
1099,October 1977,Nevada,502000,355912,70.9,335996,66.9,19916,5.6
1100,October 1977,New Hampshire,632000,423613,67.0,403292,63.8,20321,4.8
1101,October 1977,New Jersey,5454000,3393355,62.2,3103291,56.9,290064,8.5
1102,October 1977,New Mexico,847000,520860,61.5,485353,57.3,35507,6.8
1103,October 1977,New York,13247000,7765621,58.6,7095195,53.6,670426,8.6
1104,October 1977,North Carolina,4053000,2732306,67.4,2576642,63.6,155664,5.7
1105,October 1977,North Dakota,455000,289681,63.7,276263,60.7,13418,4.6
1106,October 1977,Ohio,7836000,4861673,62.0,4571153,58.3,290520,6.0
1107,October 1977,Oklahoma,2079000,1248301,60.0,1193105,57.4,55196,4.4
1108,October 1977,Oregon,1818000,1173870,64.6,1099242,60.5,74628,6.4
1109,October 1977,Pennsylvania,8898000,5226762,58.7,4836794,54.4,389968,7.5
1110,October 1977,Rhode Island,709000,448872,63.3,414592,58.5,34280,7.6
1111,October 1977,South Carolina,2077000,1335057,64.3,1248001,60.1,87056,6.5
1112,October 1977,South Dakota,488000,319776,65.5,309887,63.5,9889,3.1
1113,October 1977,Tennessee,3208000,1953081,60.9,1836577,57.2,116504,6.0
1114,October 1977,Texas,9326000,6024246,64.6,5708323,61.2,315923,5.2
1115,October 1977,Utah,875000,549012,62.7,522505,59.7,26507,4.8
1116,October 1977,Vermont,354000,233004,65.8,217819,61.5,15185,6.5
1117,October 1977,Virginia,3694000,2430715,65.8,2301538,62.3,129177,5.3
1118,October 1977,Washington,2747000,1717441,62.5,1584844,57.7,132597,7.7
1119,October 1977,West Virginia,1401000,715586,51.1,666463,47.6,49123,6.9
1120,October 1977,Wisconsin,3334000,2200533,66.0,2090325,62.7,110208,5.0
1121,October 1977,Wyoming,293000,199389,68.1,193189,65.9,6200,3.1
1122,November 1977,Alabama,2710000,1584502,58.5,1478914,54.6,105588,6.7
1123,November 1977,Alaska,251000,177024,70.5,158467,63.1,18557,10.5
1124,November 1977,Arizona,1756000,1057172,60.2,979701,55.8,77471,7.3
1125,November 1977,Arkansas,1595000,941896,59.1,882194,55.3,59702,6.3
1126,November 1977,California,16458000,10583084,64.3,9768620,59.4,814464,7.7
1127,November 1977,Colorado,1950000,1308177,67.1,1228044,63.0,80133,6.1
1128,November 1977,Connecticut,2296000,1496758,65.2,1403810,61.1,92948,6.2
1129,November 1977,Delaware,431000,273331,63.4,252509,58.6,20822,7.6
1130,November 1977,District of Columbia,511000,331474,64.9,301952,59.1,29522,8.9
1131,November 1977,Florida,6808000,3820042,56.1,3540489,52.0,279553,7.3
1132,November 1977,Georgia,3679000,2354406,64.0,2209512,60.1,144894,6.2
1133,November 1977,Hawaii,615000,418156,68.0,385517,62.7,32639,7.8
1134,November 1977,Idaho,619000,407826,65.9,385228,62.2,22598,5.5
1135,November 1977,Illinois,8316000,5357147,64.4,5016340,60.3,340807,6.4
1136,November 1977,Indiana,3891000,2526710,64.9,2380288,61.2,146422,5.8
1137,November 1977,Iowa,2118000,1402641,66.2,1348827,63.7,53814,3.8
1138,November 1977,Kansas,1683000,1115766,66.3,1075529,63.9,40237,3.6
1139,November 1977,Kentucky,2555000,1554290,60.8,1478198,57.9,76092,4.9
1140,November 1977,Louisiana,2799000,1639295,58.6,1515864,54.2,123431,7.5
1141,November 1977,Maine,796000,477591,60.0,442074,55.5,35517,7.4
1142,November 1977,Maryland,3049000,1999582,65.6,1879255,61.6,120327,6.0
1143,November 1977,Massachusetts,4270000,2781371,65.1,2585669,60.6,195702,7.0
1144,November 1977,Michigan,6578000,4162597,63.3,3841830,58.4,320767,7.7
1145,November 1977,Minnesota,2879000,1930534,67.1,1841465,64.0,89069,4.6
1146,November 1977,Mississippi,1703000,1005785,59.1,932558,54.8,73227,7.3
1147,November 1977,Missouri,3553000,2250156,63.3,2122347,59.7,127809,5.7
1148,November 1977,Montana,556000,356040,64.0,332836,59.9,23204,6.5
1149,November 1977,Nebraska,1119000,748742,66.9,720739,64.4,28003,3.7
1150,November 1977,Nevada,505000,358119,70.9,339089,67.1,19030,5.3
1151,November 1977,New Hampshire,634000,424720,67.0,404925,63.9,19795,4.7
1152,November 1977,New Jersey,5459000,3396976,62.2,3115597,57.1,281379,8.3
1153,November 1977,New Mexico,849000,522370,61.5,488196,57.5,34174,6.5
1154,November 1977,New York,13247000,7775641,58.7,7113136,53.7,662505,8.5
1155,November 1977,North Carolina,4060000,2739273,67.5,2588972,63.8,150301,5.5
1156,November 1977,North Dakota,456000,290272,63.7,276955,60.7,13317,4.6
1157,November 1977,Ohio,7843000,4865487,62.0,4579684,58.4,285803,5.9
1158,November 1977,Oklahoma,2083000,1251496,60.1,1197443,57.5,54053,4.3
1159,November 1977,Oregon,1824000,1178391,64.6,1106421,60.7,71970,6.1
1160,November 1977,Pennsylvania,8903000,5231939,58.8,4845281,54.4,386658,7.4
1161,November 1977,Rhode Island,710000,448708,63.2,414973,58.4,33735,7.5
1162,November 1977,South Carolina,2082000,1336592,64.2,1251458,60.1,85134,6.4
1163,November 1977,South Dakota,488000,320196,65.6,310404,63.6,9792,3.1
1164,November 1977,Tennessee,3214000,1956691,60.9,1840866,57.3,115825,5.9
1165,November 1977,Texas,9350000,6049565,64.7,5733214,61.3,316351,5.2
1166,November 1977,Utah,877000,550082,62.7,524376,59.8,25706,4.7
1167,November 1977,Vermont,355000,234147,66.0,219097,61.7,15050,6.4
1168,November 1977,Virginia,3701000,2439240,65.9,2309004,62.4,130236,5.3
1169,November 1977,Washington,2756000,1727944,62.7,1599649,58.0,128295,7.4
1170,November 1977,West Virginia,1402000,714873,51.0,665663,47.5,49210,6.9
1171,November 1977,Wisconsin,3338000,2206291,66.1,2096149,62.8,110142,5.0
1172,November 1977,Wyoming,294000,200623,68.2,194454,66.1,6169,3.1
1173,December 1977,Alabama,2715000,1587522,58.5,1483160,54.6,104362,6.6
1174,December 1977,Alaska,251000,178444,71.1,159413,63.5,19031,10.7
1175,December 1977,Arizona,1763000,1057127,60.0,982527,55.7,74600,7.1
1176,December 1977,Arkansas,1598000,941918,58.9,882812,55.2,59106,6.3
1177,December 1977,California,16499000,10628014,64.4,9818542,59.5,809472,7.6
1178,December 1977,Colorado,1956000,1312573,67.1,1232406,63.0,80167,6.1
1179,December 1977,Connecticut,2298000,1497015,65.1,1407483,61.2,89532,6.0
1180,December 1977,Delaware,432000,273516,63.3,252763,58.5,20753,7.6
1181,December 1977,District of Columbia,511000,332612,65.1,303460,59.4,29152,8.8
1182,December 1977,Florida,6829000,3843092,56.3,3567090,52.2,276002,7.2
1183,December 1977,Georgia,3686000,2359447,64.0,2218965,60.2,140482,6.0
1184,December 1977,Hawaii,616000,418076,67.9,385623,62.6,32453,7.8
1185,December 1977,Idaho,621000,408987,65.9,386938,62.3,22049,5.4
1186,December 1977,Illinois,8323000,5369423,64.5,5028504,60.4,340919,6.3
1187,December 1977,Indiana,3896000,2535021,65.1,2388471,61.3,146550,5.8
1188,December 1977,Iowa,2119000,1405810,66.3,1351786,63.8,54024,3.8
1189,December 1977,Kansas,1685000,1118355,66.4,1078759,64.0,39596,3.5
1190,December 1977,Kentucky,2559000,1558938,60.9,1481279,57.9,77659,5.0
1191,December 1977,Louisiana,2804000,1646915,58.7,1521158,54.2,125757,7.6
1192,December 1977,Maine,797000,477461,59.9,443078,55.6,34383,7.2
1193,December 1977,Maryland,3053000,2005149,65.7,1886348,61.8,118801,5.9
1194,December 1977,Massachusetts,4274000,2785021,65.2,2594434,60.7,190587,6.8
1195,December 1977,Michigan,6585000,4166367,63.3,3854673,58.5,311694,7.5
1196,December 1977,Minnesota,2883000,1934423,67.1,1848898,64.1,85525,4.4
1197,December 1977,Mississippi,1705000,1006946,59.1,934220,54.8,72726,7.2
1198,December 1977,Missouri,3557000,2253009,63.3,2126018,59.8,126991,5.6
1199,December 1977,Montana,557000,357504,64.2,334176,60.0,23328,6.5
1200,December 1977,Nebraska,1120000,749986,67.0,721571,64.4,28415,3.8
1201,December 1977,Nevada,508000,360339,70.9,342115,67.3,18224,5.1
1202,December 1977,New Hampshire,636000,425610,66.9,406345,63.9,19265,4.5
1203,December 1977,New Jersey,5464000,3399539,62.2,3127266,57.2,272273,8.0
1204,December 1977,New Mexico,851000,524007,61.6,491018,57.7,32989,6.3
1205,December 1977,New York,13248000,7782581,58.7,7128771,53.8,653810,8.4
1206,December 1977,North Carolina,4067000,2743373,67.5,2599533,63.9,143840,5.2
1207,December 1977,North Dakota,456000,290685,63.7,277547,60.9,13138,4.5
1208,December 1977,Ohio,7850000,4868084,62.0,4586443,58.4,281641,5.8
1209,December 1977,Oklahoma,2087000,1254366,60.1,1200763,57.5,53603,4.3
1210,December 1977,Oregon,1829000,1182769,64.7,1113201,60.9,69568,5.9
1211,December 1977,Pennsylvania,8907000,5236268,58.8,4852437,54.5,383831,7.3
1212,December 1977,Rhode Island,710000,448294,63.1,415159,58.5,33135,7.4
1213,December 1977,South Carolina,2087000,1337785,64.1,1255000,60.1,82785,6.2
1214,December 1977,South Dakota,488000,320661,65.7,311005,63.7,9656,3.0
1215,December 1977,Tennessee,3219000,1959373,60.9,1844131,57.3,115242,5.9
1216,December 1977,Texas,9374000,6071388,64.8,5756351,61.4,315037,5.2
1217,December 1977,Utah,880000,551280,62.6,526306,59.8,24974,4.5
1218,December 1977,Vermont,355000,235042,66.2,220224,62.0,14818,6.3
1219,December 1977,Virginia,3709000,2446652,66.0,2315403,62.4,131249,5.4
1220,December 1977,Washington,2765000,1738785,62.9,1614224,58.4,124561,7.2
1221,December 1977,West Virginia,1404000,714042,50.9,664976,47.4,49066,6.9
1222,December 1977,Wisconsin,3341000,2212366,66.2,2102438,62.9,109928,5.0
1223,December 1977,Wyoming,296000,201868,68.2,195768,66.1,6100,3.0
1224,January 1978,Alabama,2720000,1590947,58.5,1487808,54.7,103139,6.5
1225,January 1978,Alaska,252000,179578,71.3,160129,63.5,19449,10.8
1226,January 1978,Arizona,1770000,1057365,59.7,985501,55.7,71864,6.8
1227,January 1978,Arkansas,1601000,941811,58.8,883454,55.2,58357,6.2
1228,January 1978,California,16540000,10674473,64.5,9867392,59.7,807081,7.6
1229,January 1978,Colorado,1961000,1316933,67.2,1237025,63.1,79908,6.1
1230,January 1978,Connecticut,2301000,1496835,65.1,1410761,61.3,86074,5.8
1231,January 1978,Delaware,432000,273820,63.4,253086,58.6,20734,7.6
1232,January 1978,District of Columbia,511000,333505,65.3,304642,59.6,28863,8.7
1233,January 1978,Florida,6850000,3863066,56.4,3590894,52.4,272172,7.0
1234,January 1978,Georgia,3692000,2364538,64.0,2228194,60.4,136344,5.8
1235,January 1978,Hawaii,617000,417633,67.7,385743,62.5,31890,7.6
1236,January 1978,Idaho,623000,410091,65.8,388522,62.4,21569,5.3
1237,January 1978,Illinois,8330000,5379483,64.6,5038595,60.5,340888,6.3
1238,January 1978,Indiana,3902000,2542724,65.2,2396136,61.4,146588,5.8
1239,January 1978,Iowa,2121000,1408457,66.4,1353965,63.8,54492,3.9
1240,January 1978,Kansas,1687000,1121333,66.5,1082411,64.2,38922,3.5
1241,January 1978,Kentucky,2562000,1563156,61.0,1484469,57.9,78687,5.0
1242,January 1978,Louisiana,2808000,1653280,58.9,1526600,54.4,126680,7.7
1243,January 1978,Maine,799000,477478,59.8,444224,55.6,33254,7.0
1244,January 1978,Maryland,3056000,2009684,65.8,1893274,62.0,116410,5.8
1245,January 1978,Massachusetts,4277000,2788534,65.2,2602710,60.9,185824,6.7
1246,January 1978,Michigan,6593000,4169021,63.2,3866844,58.7,302177,7.2
1247,January 1978,Minnesota,2887000,1938776,67.2,1856608,64.3,82168,4.2
1248,January 1978,Mississippi,1708000,1007243,59.0,934969,54.7,72274,7.2
1249,January 1978,Missouri,3561000,2254557,63.3,2128489,59.8,126068,5.6
1250,January 1978,Montana,559000,359023,64.2,335744,60.1,23279,6.5
1251,January 1978,Nebraska,1121000,750931,67.0,722516,64.5,28415,3.8
1252,January 1978,Nevada,511000,362466,70.9,345000,67.5,17466,4.8
1253,January 1978,New Hampshire,638000,426472,66.8,407775,63.9,18697,4.4
1254,January 1978,New Jersey,5470000,3402187,62.2,3138336,57.4,263851,7.8
1255,January 1978,New Mexico,854000,525877,61.6,493756,57.8,32121,6.1
1256,January 1978,New York,13248000,7787320,58.8,7143545,53.9,643775,8.3
1257,January 1978,North Carolina,4074000,2745260,67.4,2608349,64.0,136911,5.0
1258,January 1978,North Dakota,456000,290982,63.8,278083,61.0,12899,4.4
1259,January 1978,Ohio,7857000,4872244,62.0,4594565,58.5,277679,5.7
1260,January 1978,Oklahoma,2090000,1257135,60.2,1203949,57.6,53186,4.2
1261,January 1978,Oregon,1834000,1187112,64.7,1119458,61.0,67654,5.7
1262,January 1978,Pennsylvania,8912000,5241875,58.8,4860708,54.5,381167,7.3
1263,January 1978,Rhode Island,711000,448026,63.0,415491,58.4,32535,7.3
1264,January 1978,South Carolina,2092000,1338891,64.0,1258518,60.2,80373,6.0
1265,January 1978,South Dakota,489000,321235,65.7,311739,63.8,9496,3.0
1266,January 1978,Tennessee,3224000,1961297,60.8,1846818,57.3,114479,5.8
1267,January 1978,Texas,9398000,6090069,64.8,5778355,61.5,311714,5.1
1268,January 1978,Utah,882000,552766,62.7,528496,59.9,24270,4.4
1269,January 1978,Vermont,356000,235759,66.2,221265,62.2,14494,6.1
1270,January 1978,Virginia,3716000,2453621,66.0,2321822,62.5,131799,5.4
1271,January 1978,Washington,2773000,1749856,63.1,1628160,58.7,121696,7.0
1272,January 1978,West Virginia,1405000,714218,50.8,665842,47.4,48376,6.8
1273,January 1978,Wisconsin,3345000,2218507,66.3,2109032,63.1,109475,4.9
1274,January 1978,Wyoming,297000,203117,68.4,197111,66.4,6006,3.0
1275,February 1978,Alabama,2725000,1595067,58.5,1493428,54.8,101639,6.4
1276,February 1978,Alaska,253000,180374,71.3,160622,63.5,19752,11.0
1277,February 1978,Arizona,1776000,1058731,59.6,989151,55.7,69580,6.6
1278,February 1978,Arkansas,1604000,942076,58.7,884470,55.1,57606,6.1
1279,February 1978,California,16582000,10723892,64.7,9917174,59.8,806718,7.5
1280,February 1978,Colorado,1967000,1321494,67.2,1242209,63.2,79285,6.0
1281,February 1978,Connecticut,2303000,1497192,65.0,1414299,61.4,82893,5.5
1282,February 1978,Delaware,433000,274287,63.3,253556,58.6,20731,7.6
1283,February 1978,District of Columbia,510000,334109,65.5,305435,59.9,28674,8.6
1284,February 1978,Florida,6870000,3881476,56.5,3612889,52.6,268587,6.9
1285,February 1978,Georgia,3699000,2370815,64.1,2237483,60.5,133332,5.6
1286,February 1978,Hawaii,618000,417004,67.5,385889,62.4,31115,7.5
1287,February 1978,Idaho,624000,411338,65.9,390114,62.5,21224,5.2
1288,February 1978,Illinois,8337000,5388092,64.6,5048100,60.6,339992,6.3
1289,February 1978,Indiana,3907000,2550283,65.3,2403936,61.5,146347,5.7
1290,February 1978,Iowa,2123000,1411123,66.5,1356132,63.9,54991,3.9
1291,February 1978,Kansas,1689000,1124660,66.6,1086600,64.3,38060,3.4
1292,February 1978,Kentucky,2566000,1567269,61.1,1488114,58.0,79155,5.1
1293,February 1978,Louisiana,2813000,1658304,59.0,1532120,54.5,126184,7.6
1294,February 1978,Maine,800000,477685,59.7,445567,55.7,32118,6.7
1295,February 1978,Maryland,3060000,2014163,65.8,1900364,62.1,113799,5.6
1296,February 1978,Massachusetts,4281000,2792371,65.2,2610452,61.0,181919,6.5
1297,February 1978,Michigan,6601000,4172557,63.2,3878842,58.8,293715,7.0
1298,February 1978,Minnesota,2890000,1943417,67.2,1864157,64.5,79260,4.1
1299,February 1978,Mississippi,1711000,1007029,58.9,935051,54.6,71978,7.1
1300,February 1978,Missouri,3565000,2255062,63.3,2130805,59.8,124257,5.5
1301,February 1978,Montana,560000,360665,64.4,337629,60.3,23036,6.4
1302,February 1978,Nebraska,1123000,751583,66.9,723694,64.4,27889,3.7
1303,February 1978,Nevada,515000,364501,70.8,347724,67.5,16777,4.6
1304,February 1978,New Hampshire,640000,427551,66.8,409400,64.0,18151,4.2
1305,February 1978,New Jersey,5475000,3406882,62.2,3149507,57.5,257375,7.6
1306,February 1978,New Mexico,856000,527948,61.7,496405,58.0,31543,6.0
1307,February 1978,New York,13248000,7792592,58.8,7158808,54.0,633784,8.1
1308,February 1978,North Carolina,4082000,2746283,67.3,2615780,64.1,130503,4.8
1309,February 1978,North Dakota,457000,291302,63.7,278660,61.0,12642,4.3
1310,February 1978,Ohio,7863000,4880654,62.1,4606576,58.6,274078,5.6
1311,February 1978,Oklahoma,2094000,1260126,60.2,1207768,57.7,52358,4.2
1312,February 1978,Oregon,1839000,1191685,64.8,1125101,61.2,66584,5.6
1313,February 1978,Pennsylvania,8917000,5250607,58.9,4872529,54.6,378078,7.2
1314,February 1978,Rhode Island,712000,448111,62.9,416217,58.5,31894,7.1
1315,February 1978,South Carolina,2097000,1340562,63.9,1261946,60.2,78616,5.9
1316,February 1978,South Dakota,489000,321957,65.8,312572,63.9,9385,2.9
1317,February 1978,Tennessee,3229000,1962968,60.8,1849379,57.3,113589,5.8
1318,February 1978,Texas,9422000,6107801,64.8,5800680,61.6,307121,5.0
1319,February 1978,Utah,885000,554691,62.7,531154,60.0,23537,4.2
1320,February 1978,Vermont,357000,236439,66.2,222299,62.3,14140,6.0
1321,February 1978,Virginia,3724000,2461035,66.1,2329311,62.5,131724,5.4
1322,February 1978,Washington,2782000,1761323,63.3,1641513,59.0,119810,6.8
1323,February 1978,West Virginia,1406000,716197,50.9,669191,47.6,47006,6.6
1324,February 1978,Wisconsin,3349000,2224854,66.4,2115963,63.2,108891,4.9
1325,February 1978,Wyoming,298000,204360,68.6,198430,66.6,5930,2.9
1326,March 1978,Alabama,2730000,1600048,58.6,1500232,55.0,99816,6.2
1327,March 1978,Alaska,253000,180898,71.5,161004,63.6,19894,11.0
1328,March 1978,Arizona,1783000,1061661,59.5,993785,55.7,67876,6.4
1329,March 1978,Arkansas,1607000,942987,58.7,885955,55.1,57032,6.0
1330,March 1978,California,16623000,10775522,64.8,9967957,60.0,807565,7.5
1331,March 1978,Colorado,1973000,1326486,67.2,1248085,63.3,78401,5.9
1332,March 1978,Connecticut,2305000,1498791,65.0,1418461,61.5,80330,5.4
1333,March 1978,Delaware,433000,274961,63.5,254207,58.7,20754,7.5
1334,March 1978,District of Columbia,510000,334534,65.6,305968,60.0,28566,8.5
1335,March 1978,Florida,6891000,3899834,56.6,3633608,52.7,266226,6.8
1336,March 1978,Georgia,3706000,2379319,64.2,2246911,60.6,132408,5.6
1337,March 1978,Hawaii,619000,416525,67.3,386105,62.4,30420,7.3
1338,March 1978,Idaho,626000,412777,65.9,391706,62.6,21071,5.1
1339,March 1978,Illinois,8344000,5396456,64.7,5058245,60.6,338211,6.3
1340,March 1978,Indiana,3912000,2558808,65.4,2413013,61.7,145795,5.7
1341,March 1978,Iowa,2124000,1414044,66.6,1358924,64.0,55120,3.9
1342,March 1978,Kansas,1691000,1128169,66.7,1091121,64.5,37048,3.3
1343,March 1978,Kentucky,2570000,1571756,61.2,1492471,58.1,79285,5.0
1344,March 1978,Louisiana,2818000,1662127,59.0,1537683,54.6,124444,7.5
1345,March 1978,Maine,801000,478247,59.7,447139,55.8,31108,6.5
1346,March 1978,Maryland,3064000,2019750,65.9,1907834,62.3,111916,5.5
1347,March 1978,Massachusetts,4285000,2796729,65.3,2617592,61.1,179137,6.4
1348,March 1978,Michigan,6608000,4178021,63.2,3889834,58.9,288187,6.9
1349,March 1978,Minnesota,2894000,1948388,67.3,1871366,64.7,77022,4.0
1350,March 1978,Mississippi,1713000,1006864,58.8,934899,54.6,71965,7.1
1351,March 1978,Missouri,3569000,2254714,63.2,2133235,59.8,121479,5.4
1352,March 1978,Montana,561000,362440,64.6,339795,60.6,22645,6.2
1353,March 1978,Nebraska,1124000,752126,66.9,725193,64.5,26933,3.6
1354,March 1978,Nevada,518000,366570,70.8,350362,67.6,16208,4.4
1355,March 1978,New Hampshire,642000,428989,66.8,411296,64.1,17693,4.1
1356,March 1978,New Jersey,5480000,3415348,62.3,3161677,57.7,253671,7.4
1357,March 1978,New Mexico,858000,530197,61.8,499017,58.2,31180,5.9
1358,March 1978,New York,13249000,7799865,58.9,7174491,54.2,625374,8.0
1359,March 1978,North Carolina,4089000,2747853,67.2,2622037,64.1,125816,4.6
1360,March 1978,North Dakota,457000,291766,63.8,279353,61.1,12413,4.3
1361,March 1978,Ohio,7870000,4894484,62.2,4623072,58.7,271412,5.5
1362,March 1978,Oklahoma,2098000,1263211,60.2,1212331,57.8,50880,4.0
1363,March 1978,Oregon,1844000,1196702,64.9,1130219,61.3,66483,5.6
1364,March 1978,Pennsylvania,8921000,5263325,59.0,4888960,54.8,374365,7.1
1365,March 1978,Rhode Island,712000,448542,63.0,417384,58.6,31158,6.9
1366,March 1978,South Carolina,2102000,1343444,63.9,1265318,60.2,78126,5.8
1367,March 1978,South Dakota,489000,322955,66.0,313520,64.1,9435,2.9
1368,March 1978,Tennessee,3234000,1964415,60.7,1851604,57.3,112811,5.7
1369,March 1978,Texas,9446000,6126483,64.9,5824121,61.7,302362,4.9
1370,March 1978,Utah,888000,557046,62.7,534303,60.2,22743,4.1
1371,March 1978,Vermont,357000,237206,66.4,223373,62.6,13833,5.8
1372,March 1978,Virginia,3732000,2469578,66.2,2338188,62.7,131390,5.3
1373,March 1978,Washington,2791000,1773519,63.5,1654481,59.3,119038,6.7
1374,March 1978,West Virginia,1408000,720253,51.2,675086,47.9,45167,6.3
1375,March 1978,Wisconsin,3352000,2231843,66.6,2123210,63.3,108633,4.9
1376,March 1978,Wyoming,300000,205588,68.5,199677,66.6,5911,2.9
1377,April 1978,Alabama,2734000,1606042,58.7,1507853,55.2,98189,6.1
1378,April 1978,Alaska,254000,181299,71.4,161397,63.5,19902,11.0
1379,April 1978,Arizona,1790000,1065846,59.5,999458,55.8,66388,6.2
1380,April 1978,Arkansas,1609000,944733,58.7,887947,55.2,56786,6.0
1381,April 1978,California,16665000,10825872,65.0,10018792,60.1,807080,7.5
1382,April 1978,Colorado,1979000,1332018,67.3,1254611,63.4,77407,5.8
1383,April 1978,Connecticut,2307000,1501744,65.1,1423185,61.7,78559,5.2
1384,April 1978,Delaware,434000,275831,63.6,255033,58.8,20798,7.5
1385,April 1978,District of Columbia,510000,334814,65.6,306343,60.1,28471,8.5
1386,April 1978,Florida,6912000,3918418,56.7,3653217,52.9,265201,6.8
1387,April 1978,Georgia,3713000,2390084,64.4,2256267,60.8,133817,5.6
1388,April 1978,Hawaii,620000,416500,67.2,386454,62.3,30046,7.2
1389,April 1978,Idaho,628000,414430,66.0,393255,62.6,21175,5.1
1390,April 1978,Illinois,8351000,5404670,64.7,5069425,60.7,335245,6.2
1391,April 1978,Indiana,3917000,2568670,65.6,2423748,61.9,144922,5.6
1392,April 1978,Iowa,2126000,1417052,66.7,1362382,64.1,54670,3.9
1393,April 1978,Kansas,1693000,1131693,66.8,1095713,64.7,35980,3.2
1394,April 1978,Kentucky,2573000,1576598,61.3,1497301,58.2,79297,5.0
1395,April 1978,Louisiana,2823000,1665075,59.0,1543303,54.7,121772,7.3
1396,April 1978,Maine,802000,479238,59.8,448830,56.0,30408,6.3
1397,April 1978,Maryland,3068000,2026691,66.1,1915585,62.4,111106,5.5
1398,April 1978,Massachusetts,4288000,2801362,65.3,2624190,61.2,177172,6.3
1399,April 1978,Michigan,6616000,4185118,63.3,3899214,58.9,285904,6.8
1400,April 1978,Minnesota,2898000,1953791,67.4,1878366,64.8,75425,3.9
1401,April 1978,Mississippi,1716000,1007265,58.7,935147,54.5,72118,7.2
1402,April 1978,Missouri,3573000,2253329,63.1,2135548,59.8,117781,5.2
1403,April 1978,Montana,562000,364136,64.8,341975,60.8,22161,6.1
1404,April 1978,Nebraska,1125000,752700,66.9,727025,64.6,25675,3.4
1405,April 1978,Nevada,521000,368767,70.8,352956,67.7,15811,4.3
1406,April 1978,New Hampshire,643000,430748,67.0,413429,64.3,17319,4.0
1407,April 1978,New Jersey,5485000,3427629,62.5,3175428,57.9,252201,7.4
1408,April 1978,New Mexico,860000,532726,61.9,501662,58.3,31064,5.8
1409,April 1978,New York,13249000,7808695,58.9,7189887,54.3,618808,7.9
1410,April 1978,North Carolina,4096000,2750671,67.2,2627794,64.2,122877,4.5
1411,April 1978,North Dakota,458000,292396,63.8,280150,61.2,12246,4.2
1412,April 1978,Ohio,7877000,4912445,62.4,4642786,58.9,269659,5.5
1413,April 1978,Oklahoma,2102000,1265777,60.2,1217206,57.9,48571,3.8
1414,April 1978,Oregon,1849000,1202265,65.0,1135030,61.4,67235,5.6
1415,April 1978,Pennsylvania,8926000,5279101,59.1,4909201,55.0,369900,7.0
1416,April 1978,Rhode Island,713000,449337,63.0,418916,58.8,30421,6.8
1417,April 1978,South Carolina,2106000,1347196,64.0,1268527,60.2,78669,5.8
1418,April 1978,South Dakota,489000,324220,66.3,314567,64.3,9653,3.0
1419,April 1978,Tennessee,3239000,1965731,60.7,1853193,57.2,112538,5.7
1420,April 1978,Texas,9470000,6146584,64.9,5848514,61.8,298070,4.8
1421,April 1978,Utah,890000,559635,62.9,537711,60.4,21924,3.9
1422,April 1978,Vermont,358000,238059,66.5,224462,62.7,13597,5.7
1423,April 1978,Virginia,3739000,2479234,66.3,2347895,62.8,131339,5.3
1424,April 1978,Washington,2800000,1786073,63.8,1666651,59.5,119422,6.7
1425,April 1978,West Virginia,1409000,726028,51.5,682574,48.4,43454,6.0
1426,April 1978,Wisconsin,3356000,2239487,66.7,2130679,63.5,108808,4.9
1427,April 1978,Wyoming,301000,206804,68.7,200829,66.7,5975,2.9
1428,May 1978,Alabama,2739000,1613055,58.9,1515549,55.3,97506,6.0
1429,May 1978,Alaska,255000,181631,71.2,161811,63.5,19820,10.9
1430,May 1978,Arizona,1797000,1070968,59.6,1005984,56.0,64984,6.1
1431,May 1978,Arkansas,1612000,947258,58.8,890315,55.2,56943,6.0
1432,May 1978,California,16706000,10871987,65.1,10068727,60.3,803260,7.4
1433,May 1978,Colorado,1985000,1337972,67.4,1261586,63.6,76386,5.7
1434,May 1978,Connecticut,2310000,1505691,65.2,1428200,61.8,77491,5.1
1435,May 1978,Delaware,434000,276817,63.8,255989,59.0,20828,7.5
1436,May 1978,District of Columbia,510000,334969,65.7,306651,60.1,28318,8.5
1437,May 1978,Florida,6933000,3937372,56.8,3672073,53.0,265299,6.7
1438,May 1978,Georgia,3720000,2401928,64.6,2265234,60.9,136694,5.7
1439,May 1978,Hawaii,622000,416994,67.0,386991,62.2,30003,7.2
1440,May 1978,Idaho,630000,416175,66.1,394650,62.6,21525,5.2
1441,May 1978,Illinois,8359000,5413243,64.8,5082006,60.8,331237,6.1
1442,May 1978,Indiana,3923000,2579613,65.8,2435707,62.1,143906,5.6
1443,May 1978,Iowa,2128000,1419846,66.7,1366002,64.2,53844,3.8
1444,May 1978,Kansas,1695000,1135094,67.0,1100181,64.9,34913,3.1
1445,May 1978,Kentucky,2577000,1581563,61.4,1501882,58.3,79681,5.0
1446,May 1978,Louisiana,2828000,1667548,59.0,1548990,54.8,118558,7.1
1447,May 1978,Maine,804000,480665,59.8,450556,56.0,30109,6.3
1448,May 1978,Maryland,3072000,2034586,66.2,1923421,62.6,111165,5.5
1449,May 1978,Massachusetts,4292000,2806240,65.4,2630614,61.3,175626,6.3
1450,May 1978,Michigan,6624000,4193157,63.3,3907083,59.0,286074,6.8
1451,May 1978,Minnesota,2902000,1959830,67.5,1885393,65.0,74437,3.8
1452,May 1978,Mississippi,1719000,1008595,58.7,936358,54.5,72237,7.2
1453,May 1978,Missouri,3577000,2251359,62.9,2137812,59.8,113547,5.0
1454,May 1978,Montana,564000,365708,64.8,344093,61.0,21615,5.9
1455,May 1978,Nebraska,1126000,753351,66.9,729091,64.8,24260,3.2
1456,May 1978,Nevada,524000,371102,70.8,355461,67.8,15641,4.2
1457,May 1978,New Hampshire,645000,432705,67.1,415687,64.4,17018,3.9
1458,May 1978,New Jersey,5491000,3443104,62.7,3191130,58.1,251974,7.3
1459,May 1978,New Mexico,863000,535447,62.0,504289,58.4,31158,5.8
1460,May 1978,New York,13249000,7819734,59.0,7205741,54.4,613993,7.9
1461,May 1978,North Carolina,4103000,2755167,67.2,2633936,64.2,121231,4.4
1462,May 1978,North Dakota,458000,293102,64.0,280953,61.3,12149,4.1
1463,May 1978,Ohio,7884000,4931885,62.6,4663393,59.2,268492,5.4
1464,May 1978,Oklahoma,2106000,1267581,60.2,1221947,58.0,45634,3.6
1465,May 1978,Oregon,1855000,1208473,65.1,1139675,61.4,68798,5.7
1466,May 1978,Pennsylvania,8931000,5295970,59.3,4930438,55.2,365532,6.9
1467,May 1978,Rhode Island,714000,450358,63.1,420589,58.9,29769,6.6
1468,May 1978,South Carolina,2111000,1351256,64.0,1271638,60.2,79618,5.9
1469,May 1978,South Dakota,490000,325618,66.5,315666,64.4,9952,3.1
1470,May 1978,Tennessee,3245000,1967844,60.6,1854549,57.2,113295,5.8
1471,May 1978,Texas,9494000,6168511,65.0,5873637,61.9,294874,4.8
1472,May 1978,Utah,893000,562309,63.0,541157,60.6,21152,3.8
1473,May 1978,Vermont,359000,238908,66.5,225487,62.8,13421,5.6
1474,May 1978,Virginia,3747000,2489029,66.4,2357436,62.9,131593,5.3
1475,May 1978,Washington,2809000,1798346,64.0,1677632,59.7,120714,6.7
1476,May 1978,West Virginia,1410000,732579,52.0,690141,48.9,42438,5.8
1477,May 1978,Wisconsin,3360000,2247881,66.9,2138446,63.6,109435,4.9
1478,May 1978,Wyoming,302000,207997,68.9,201878,66.8,6119,2.9
1479,June 1978,Alabama,2744000,1620381,59.1,1522416,55.5,97965,6.0
1480,June 1978,Alaska,255000,181909,71.3,162228,63.6,19681,10.8
1481,June 1978,Arizona,1803000,1076814,59.7,1013060,56.2,63754,5.9
1482,June 1978,Arkansas,1615000,950080,58.8,892655,55.3,57425,6.0
1483,June 1978,California,16748000,10910642,65.1,10116371,60.4,794271,7.3
1484,June 1978,Colorado,1991000,1344064,67.5,1268812,63.7,75252,5.6
1485,June 1978,Connecticut,2312000,1509892,65.3,1433075,62.0,76817,5.1
1486,June 1978,Delaware,435000,277760,63.9,256964,59.1,20796,7.5
1487,June 1978,District of Columbia,509000,335054,65.8,306999,60.3,28055,8.4
1488,June 1978,Florida,6953000,3956057,56.9,3690425,53.1,265632,6.7
1489,June 1978,Georgia,3727000,2412852,64.7,2273513,61.0,139339,5.8
1490,June 1978,Hawaii,623000,417847,67.1,387773,62.2,30074,7.2
1491,June 1978,Idaho,631000,417716,66.2,395686,62.7,22030,5.3
1492,June 1978,Illinois,8366000,5422060,64.8,5096035,60.9,326025,6.0
1493,June 1978,Indiana,3928000,2590550,66.0,2447637,62.3,142913,5.5
1494,June 1978,Iowa,2129000,1421822,66.8,1368892,64.3,52930,3.7
1495,June 1978,Kansas,1697000,1138303,67.1,1104337,65.1,33966,3.0
1496,June 1978,Kentucky,2580000,1585900,61.5,1505469,58.4,80431,5.1
1497,June 1978,Louisiana,2833000,1669619,58.9,1554561,54.9,115058,6.9
1498,June 1978,Maine,805000,482411,59.9,452286,56.2,30125,6.2
1499,June 1978,Maryland,3076000,2042412,66.4,1931119,62.8,111293,5.4
1500,June 1978,Massachusetts,4295000,2811159,65.5,2637168,61.4,173991,6.2
1501,June 1978,Michigan,6631000,4200891,63.4,3913720,59.0,287171,6.8
1502,June 1978,Minnesota,2905000,1966430,67.7,1892564,65.1,73866,3.8
1503,June 1978,Mississippi,1721000,1010581,58.7,938641,54.5,71940,7.1
1504,June 1978,Missouri,3581000,2249517,62.8,2140258,59.8,109259,4.9
1505,June 1978,Montana,565000,367157,65.0,346099,61.3,21058,5.7
1506,June 1978,Nebraska,1127000,754034,66.9,731200,64.9,22834,3.0
1507,June 1978,Nevada,527000,373460,70.9,357752,67.9,15708,4.2
1508,June 1978,New Hampshire,647000,434672,67.2,417912,64.6,16760,3.9
1509,June 1978,New Jersey,5496000,3460159,63.0,3208664,58.4,251495,7.3
1510,June 1978,New Mexico,865000,538050,62.2,506693,58.6,31357,5.8
1511,June 1978,New York,13250000,7832827,59.1,7223321,54.5,609506,7.8
1512,June 1978,North Carolina,4110000,2760638,67.2,2640652,64.2,119986,4.3
1513,June 1978,North Dakota,459000,293777,64.0,281654,61.4,12123,4.1
1514,June 1978,Ohio,7890000,4949554,62.7,4682446,59.3,267108,5.4
1515,June 1978,Oklahoma,2110000,1268858,60.1,1226131,58.1,42727,3.4
1516,June 1978,Oregon,1860000,1215121,65.3,1144115,61.5,71006,5.8
1517,June 1978,Pennsylvania,8935000,5310837,59.4,4948723,55.4,362114,6.8
1518,June 1978,Rhode Island,714000,451363,63.2,422093,59.1,29270,6.5
1519,June 1978,South Carolina,2116000,1354890,64.0,1274843,60.2,80047,5.9
1520,June 1978,South Dakota,490000,326991,66.7,316770,64.6,10221,3.1
1521,June 1978,Tennessee,3250000,1971006,60.6,1856368,57.1,114638,5.8
1522,June 1978,Texas,9518000,6192173,65.1,5899185,62.0,292988,4.7
1523,June 1978,Utah,895000,564976,63.1,544499,60.8,20477,3.6
1524,June 1978,Vermont,359000,239666,66.8,226375,63.1,13291,5.5
1525,June 1978,Virginia,3754000,2497402,66.5,2365680,63.0,131722,5.3
1526,June 1978,Washington,2818000,1809470,64.2,1687399,59.9,122071,6.7
1527,June 1978,West Virginia,1412000,738612,52.3,696270,49.3,42342,5.7
1528,June 1978,Wisconsin,3363000,2256815,67.1,2146450,63.8,110365,4.9
1529,June 1978,Wyoming,304000,209187,68.8,202879,66.7,6308,3.0
1530,July 1978,Alabama,2749000,1627399,59.2,1527689,55.6,99710,6.1
1531,July 1978,Alaska,256000,182220,71.2,162701,63.6,19519,10.7
1532,July 1978,Arizona,1810000,1082843,59.8,1019978,56.4,62865,5.8
1533,July 1978,Arkansas,1618000,952750,58.9,894666,55.3,58084,6.1
1534,July 1978,California,16789000,10941527,65.2,10159808,60.5,781719,7.1
1535,July 1978,Colorado,1997000,1350043,67.6,1275960,63.9,74083,5.5
1536,July 1978,Connecticut,2314000,1513927,65.4,1437508,62.1,76419,5.0
1537,July 1978,Delaware,435000,278508,64.0,257815,59.3,20693,7.4
1538,July 1978,District of Columbia,509000,335102,65.8,307417,60.4,27685,8.3
1539,July 1978,Florida,6974000,3973552,57.0,3707691,53.2,265861,6.7
1540,July 1978,Georgia,3734000,2421690,64.9,2280699,61.1,140991,5.8
1541,July 1978,Hawaii,624000,418807,67.1,388786,62.3,30021,7.2
1542,July 1978,Idaho,633000,418858,66.2,396237,62.6,22621,5.4
1543,July 1978,Illinois,8373000,5430839,64.9,5109904,61.0,320935,5.9
1544,July 1978,Indiana,3933000,2600238,66.1,2457912,62.5,142326,5.5
1545,July 1978,Iowa,2131000,1422705,66.8,1370223,64.3,52482,3.7
1546,July 1978,Kansas,1699000,1141414,67.2,1107978,65.2,33436,2.9
1547,July 1978,Kentucky,2584000,1589111,61.5,1507673,58.3,81438,5.1
1548,July 1978,Louisiana,2838000,1671163,58.9,1559652,55.0,111511,6.7
1549,July 1978,Maine,806000,484304,60.1,453976,56.3,30328,6.3
1550,July 1978,Maryland,3080000,2049513,66.5,1938292,62.9,111221,5.4
1551,July 1978,Massachusetts,4299000,2815937,65.5,2643536,61.5,172401,6.1
1552,July 1978,Michigan,6639000,4208185,63.4,3918966,59.0,289219,6.9
1553,July 1978,Minnesota,2909000,1973568,67.8,1899756,65.3,73812,3.7
1554,July 1978,Mississippi,1724000,1012781,58.7,941537,54.6,71244,7.0
1555,July 1978,Missouri,3585000,2248702,62.7,2142742,59.8,105960,4.7
1556,July 1978,Montana,566000,368365,65.1,347851,61.5,20514,5.6
1557,July 1978,Nebraska,1128000,754806,66.9,733078,65.0,21728,2.9
1558,July 1978,Nevada,530000,375611,70.9,359622,67.9,15989,4.3
1559,July 1978,New Hampshire,649000,436383,67.2,419874,64.7,16509,3.8
1560,July 1978,New Jersey,5501000,3476762,63.2,3226375,58.7,250387,7.2
1561,July 1978,New Mexico,867000,540353,62.3,508764,58.7,31589,5.8
1562,July 1978,New York,13250000,7847213,59.2,7242277,54.7,604936,7.7
1563,July 1978,North Carolina,4117000,2765998,67.2,2646913,64.3,119085,4.3
1564,July 1978,North Dakota,459000,294379,64.1,282176,61.5,12203,4.1
1565,July 1978,Ohio,7897000,4963666,62.9,4698110,59.5,265556,5.3
1566,July 1978,Oklahoma,2114000,1270140,60.1,1229360,58.2,40780,3.2
1567,July 1978,Oregon,1865000,1221613,65.5,1148134,61.6,73479,6.0
1568,July 1978,Pennsylvania,8940000,5321863,59.5,4961261,55.5,360602,6.8
1569,July 1978,Rhode Island,715000,452054,63.2,423166,59.2,28888,6.4
1570,July 1978,South Carolina,2121000,1357614,64.0,1278122,60.3,79492,5.9
1571,July 1978,South Dakota,490000,328204,67.0,317819,64.9,10385,3.2
1572,July 1978,Tennessee,3255000,1974865,60.7,1858799,57.1,116066,5.9
1573,July 1978,Texas,9542000,6217451,65.2,5924030,62.1,293421,4.7
1574,July 1978,Utah,898000,567695,63.2,547648,61.0,20047,3.5
1575,July 1978,Vermont,360000,240301,66.8,227108,63.1,13193,5.5
1576,July 1978,Virginia,3762000,2503172,66.5,2371482,63.0,131690,5.3
1577,July 1978,Washington,2827000,1819165,64.3,1695680,60.0,123485,6.8
1578,July 1978,West Virginia,1413000,743471,52.6,700329,49.6,43142,5.8
1579,July 1978,Wisconsin,3367000,2266048,67.3,2154123,64.0,111925,4.9
1580,July 1978,Wyoming,305000,210395,69.0,203892,66.8,6503,3.1
1581,August 1978,Alabama,2753000,1633399,59.3,1531117,55.6,102282,6.3
1582,August 1978,Alaska,256000,182543,71.3,163238,63.8,19305,10.6
1583,August 1978,Arizona,1819000,1089073,59.9,1026450,56.4,62623,5.8
1584,August 1978,Arkansas,1621000,955415,58.9,896415,55.3,59000,6.2
1585,August 1978,California,16825000,10968580,65.2,10199635,60.6,768945,7.0
1586,August 1978,Colorado,2004000,1355843,67.7,1283026,64.0,72817,5.4
1587,August 1978,Connecticut,2316000,1518005,65.5,1441586,62.2,76419,5.0
1588,August 1978,Delaware,435000,279000,64.1,258456,59.4,20544,7.4
1589,August 1978,District of Columbia,508000,335143,66.0,307872,60.6,27271,8.1
1590,August 1978,Florida,7000000,3989934,57.0,3723828,53.2,266106,6.7
1591,August 1978,Georgia,3742000,2428571,64.9,2286683,61.1,141888,5.8
1592,August 1978,Hawaii,626000,419622,67.0,389881,62.3,29741,7.1
1593,August 1978,Idaho,634000,419591,66.2,396355,62.5,23236,5.5
1594,August 1978,Illinois,8377000,5438582,64.9,5121852,61.1,316730,5.8
1595,August 1978,Indiana,3937000,2608117,66.2,2465669,62.6,142448,5.5
1596,August 1978,Iowa,2132000,1422477,66.7,1369630,64.2,52847,3.7
1597,August 1978,Kansas,1701000,1144552,67.3,1111060,65.3,33492,2.9
1598,August 1978,Kentucky,2587000,1591204,61.5,1508728,58.3,82476,5.2
1599,August 1978,Louisiana,2844000,1672168,58.8,1564110,55.0,108058,6.5
1600,August 1978,Maine,807000,486159,60.2,455573,56.5,30586,6.3
1601,August 1978,Maryland,3083000,2055978,66.7,1944678,63.1,111300,5.4
1602,August 1978,Massachusetts,4303000,2820487,65.5,2649325,61.6,171162,6.1
1603,August 1978,Michigan,6646000,4216022,63.4,3923561,59.0,292461,6.9
1604,August 1978,Minnesota,2913000,1980861,68.0,1906706,65.5,74155,3.7
1605,August 1978,Mississippi,1726000,1014787,58.8,944492,54.7,70295,6.9
1606,August 1978,Missouri,3588000,2249466,62.7,2145593,59.8,103873,4.6
1607,August 1978,Montana,567000,369189,65.1,349138,61.6,20051,5.4
1608,August 1978,Nebraska,1129000,755653,66.9,734515,65.1,21138,2.8
1609,August 1978,Nevada,533000,377357,70.8,360940,67.7,16417,4.4
1610,August 1978,New Hampshire,651000,437770,67.2,421563,64.8,16207,3.7
1611,August 1978,New Jersey,5506000,3491582,63.4,3242482,58.9,249100,7.1
1612,August 1978,New Mexico,870000,542281,62.3,510444,58.7,31837,5.9
1613,August 1978,New York,13253000,7862942,59.3,7262302,54.8,600640,7.6
1614,August 1978,North Carolina,4124000,2770674,67.2,2651981,64.3,118693,4.3
1615,August 1978,North Dakota,459000,294868,64.2,282526,61.6,12342,4.2
1616,August 1978,Ohio,7902000,4975739,63.0,4710535,59.6,265204,5.3
1617,August 1978,Oklahoma,2118000,1271903,60.1,1231640,58.2,40263,3.2
1618,August 1978,Oregon,1870000,1227414,65.6,1151310,61.6,76104,6.2
1619,August 1978,Pennsylvania,8946000,5329262,59.6,4968316,55.5,360946,6.8
1620,August 1978,Rhode Island,715000,452346,63.3,423755,59.3,28591,6.3
1621,August 1978,South Carolina,2125000,1359587,64.0,1281326,60.3,78261,5.8
1622,August 1978,South Dakota,490000,329182,67.2,318737,65.0,10445,3.2
1623,August 1978,Tennessee,3262000,1979410,60.7,1862036,57.1,117374,5.9
1624,August 1978,Texas,9570000,6243179,65.2,5947634,62.1,295545,4.7
1625,August 1978,Utah,901000,570621,63.3,550647,61.1,19974,3.5
1626,August 1978,Vermont,361000,240842,66.7,227720,63.1,13122,5.4
1627,August 1978,Virginia,3768000,2506516,66.5,2374757,63.0,131759,5.3
1628,August 1978,Washington,2837000,1827229,64.4,1702229,60.0,125000,6.8
1629,August 1978,West Virginia,1415000,747350,52.8,702797,49.7,44553,6.0
1630,August 1978,Wisconsin,3372000,2275179,67.5,2161042,64.1,114137,5.0
1631,August 1978,Wyoming,306000,211605,69.2,204938,67.0,6667,3.2
1632,September 1978,Alabama,2756000,1637866,59.4,1532949,55.6,104917,6.4
1633,September 1978,Alaska,256000,182855,71.4,163815,64.0,19040,10.4
1634,September 1978,Arizona,1827000,1095979,60.0,1033103,56.5,62876,5.7
1635,September 1978,Arkansas,1623000,958433,59.1,898223,55.3,60210,6.3
1636,September 1978,California,16861000,10996589,65.2,10239151,60.7,757438,6.9
1637,September 1978,Colorado,2010000,1361886,67.8,1290402,64.2,71484,5.2
1638,September 1978,Connecticut,2318000,1522650,65.7,1445744,62.4,76906,5.1
1639,September 1978,Delaware,436000,279253,64.0,258888,59.4,20365,7.3
1640,September 1978,District of Columbia,508000,335161,66.0,308266,60.7,26895,8.0
1641,September 1978,Florida,7027000,4006225,57.0,3740244,53.2,265981,6.6
1642,September 1978,Georgia,3751000,2434172,64.9,2292157,61.1,142015,5.8
1643,September 1978,Hawaii,628000,420187,66.9,390910,62.2,29277,7.0
1644,September 1978,Idaho,636000,420079,66.1,396226,62.3,23853,5.7
1645,September 1978,Illinois,8381000,5444403,65.0,5131592,61.2,312811,5.7
1646,September 1978,Indiana,3941000,2614264,66.3,2471068,62.7,143196,5.5
1647,September 1978,Iowa,2133000,1421466,66.6,1367564,64.1,53902,3.8
1648,September 1978,Kansas,1703000,1147825,67.4,1113829,65.4,33996,3.0
1649,September 1978,Kentucky,2590000,1592342,61.5,1509202,58.3,83140,5.2
1650,September 1978,Louisiana,2850000,1673075,58.7,1568245,55.0,104830,6.3
1651,September 1978,Maine,808000,487773,60.4,456977,56.6,30796,6.3
1652,September 1978,Maryland,3086000,2062526,66.8,1950340,63.2,112186,5.4
1653,September 1978,Massachusetts,4306000,2824969,65.6,2654730,61.7,170239,6.0
1654,September 1978,Michigan,6653000,4225542,63.5,3929790,59.1,295752,7.0
1655,September 1978,Minnesota,2917000,1987751,68.1,1913144,65.6,74607,3.8
1656,September 1978,Mississippi,1728000,1016469,58.8,947328,54.8,69141,6.8
1657,September 1978,Missouri,3591000,2252126,62.7,2149837,59.9,102289,4.5
1658,September 1978,Montana,567000,369522,65.2,349802,61.7,19720,5.3
1659,September 1978,Nebraska,1130000,756410,66.9,735472,65.1,20938,2.8
1660,September 1978,Nevada,537000,378642,70.5,361760,67.4,16882,4.5
1661,September 1978,New Hampshire,652000,439025,67.3,423190,64.9,15835,3.6
1662,September 1978,New Jersey,5511000,3504731,63.6,3256927,59.1,247804,7.1
1663,September 1978,New Mexico,872000,543849,62.4,511665,58.7,32184,5.9
1664,September 1978,New York,13255000,7880750,59.5,7284730,55.0,596020,7.6
1665,September 1978,North Carolina,4131000,2775125,67.2,2656367,64.3,118758,4.3
1666,September 1978,North Dakota,460000,295265,64.2,282784,61.5,12481,4.2
1667,September 1978,Ohio,7906000,4988569,63.1,4721534,59.7,267035,5.4
1668,September 1978,Oklahoma,2122000,1274439,60.1,1233576,58.1,40863,3.2
1669,September 1978,Oregon,1875000,1232211,65.7,1153311,61.5,78900,6.4
1670,September 1978,Pennsylvania,8951000,5334396,59.6,4972130,55.5,362266,6.8
1671,September 1978,Rhode Island,716000,452516,63.2,424136,59.2,28380,6.3
1672,September 1978,South Carolina,2129000,1360966,63.9,1284263,60.3,76703,5.6
1673,September 1978,South Dakota,491000,329858,67.2,319406,65.1,10452,3.2
1674,September 1978,Tennessee,3268000,1985375,60.8,1866970,57.1,118405,6.0
1675,September 1978,Texas,9599000,6268160,65.3,5971075,62.2,297085,4.7
1676,September 1978,Utah,903000,573904,63.6,553635,61.3,20269,3.5
1677,September 1978,Vermont,362000,241362,66.7,228274,63.1,13088,5.4
1678,September 1978,Virginia,3773000,2508691,66.5,2376816,63.0,131875,5.3
1679,September 1978,Washington,2846000,1833849,64.4,1707501,60.0,126348,6.9
1680,September 1978,West Virginia,1416000,750732,53.0,704558,49.8,46174,6.2
1681,September 1978,Wisconsin,3376000,2283627,67.6,2167419,64.2,116208,5.1
1682,September 1978,Wyoming,308000,212761,69.1,206026,66.9,6735,3.2
1683,October 1978,Alabama,2760000,1641178,59.5,1533922,55.6,107256,6.5
1684,October 1978,Alaska,256000,183199,71.6,164427,64.2,18772,10.2
1685,October 1978,Arizona,1836000,1104172,60.1,1040900,56.7,63272,5.7
1686,October 1978,Arkansas,1626000,962093,59.2,900646,55.4,61447,6.4
1687,October 1978,California,16897000,11029927,65.3,10282077,60.9,747850,6.8
1688,October 1978,Colorado,2017000,1368817,67.9,1298426,64.4,70391,5.1
1689,October 1978,Connecticut,2320000,1528491,65.9,1450604,62.5,77887,5.1
1690,October 1978,Delaware,436000,279351,64.1,259164,59.4,20187,7.2
1691,October 1978,District of Columbia,507000,335056,66.1,308434,60.8,26622,7.9
1692,October 1978,Florida,7053000,4024534,57.1,3759083,53.3,265451,6.6
1693,October 1978,Georgia,3759000,2439854,64.9,2298211,61.1,141643,5.8
1694,October 1978,Hawaii,629000,420445,66.8,391788,62.3,28657,6.8
1695,October 1978,Idaho,637000,420602,66.0,396151,62.2,24451,5.8
1696,October 1978,Illinois,8385000,5449656,65.0,5139995,61.3,309661,5.7
1697,October 1978,Indiana,3945000,2620055,66.4,2475615,62.8,144440,5.5
1698,October 1978,Iowa,2134000,1420314,66.6,1365106,64.0,55208,3.9
1699,October 1978,Kansas,1704000,1151315,67.6,1116681,65.5,34634,3.0
1700,October 1978,Kentucky,2593000,1593201,61.4,1509859,58.2,83342,5.2
1701,October 1978,Louisiana,2855000,1674793,58.7,1572845,55.1,101948,6.1
1702,October 1978,Maine,809000,489144,60.5,458150,56.6,30994,6.3
1703,October 1978,Maryland,3089000,2069366,67.0,1955593,63.3,113773,5.5
1704,October 1978,Massachusetts,4310000,2830160,65.7,2660490,61.7,169670,6.0
1705,October 1978,Michigan,6660000,4238487,63.6,3939856,59.2,298631,7.0
1706,October 1978,Minnesota,2921000,1994046,68.3,1919022,65.7,75024,3.8
1707,October 1978,Mississippi,1730000,1017920,58.8,950145,54.9,67775,6.7
1708,October 1978,Missouri,3594000,2257129,62.8,2156490,60.0,100639,4.5
1709,October 1978,Montana,568000,369284,65.0,349843,61.6,19441,5.3
1710,October 1978,Nebraska,1130000,756895,67.0,736035,65.1,20860,2.8
1711,October 1978,Nevada,540000,379689,70.3,362387,67.1,17302,4.6
1712,October 1978,New Hampshire,654000,440347,67.3,424918,65.0,15429,3.5
1713,October 1978,New Jersey,5515000,3518354,63.8,3271064,59.3,247290,7.0
1714,October 1978,New Mexico,875000,545228,62.3,512513,58.6,32715,6.0
1715,October 1978,New York,13258000,7901898,59.6,7310842,55.1,591056,7.5
1716,October 1978,North Carolina,4137000,2781236,67.2,2661152,64.3,120084,4.3
1717,October 1978,North Dakota,460000,295684,64.3,283101,61.5,12583,4.3
1718,October 1978,Ohio,7911000,5004296,63.3,4733668,59.8,270628,5.4
1719,October 1978,Oklahoma,2126000,1278004,60.1,1236078,58.1,41926,3.3
1720,October 1978,Oregon,1880000,1235914,65.7,1154296,61.4,81618,6.6
1721,October 1978,Pennsylvania,8957000,5339970,59.6,4976434,55.6,363536,6.8
1722,October 1978,Rhode Island,716000,452883,63.3,424681,59.3,28202,6.2
1723,October 1978,South Carolina,2133000,1362041,63.9,1286867,60.3,75174,5.5
1724,October 1978,South Dakota,491000,330237,67.3,319778,65.1,10459,3.2
1725,October 1978,Tennessee,3275000,1993146,60.9,1874602,57.2,118544,5.9
1726,October 1978,Texas,9627000,6292671,65.4,5996126,62.3,296545,4.7
1727,October 1978,Utah,906000,577566,63.7,556792,61.5,20774,3.6
1728,October 1978,Vermont,362000,241921,66.8,228847,63.2,13074,5.4
1729,October 1978,Virginia,3779000,2511549,66.5,2379703,63.0,131846,5.2
1730,October 1978,Washington,2856000,1840400,64.4,1712872,60.0,127528,6.9
1731,October 1978,West Virginia,1418000,754246,53.2,706799,49.8,47447,6.3
1732,October 1978,Wisconsin,3381000,2291156,67.8,2173893,64.3,117263,5.1
1733,October 1978,Wyoming,309000,213819,69.2,207161,67.0,6658,3.1
1734,November 1978,Alabama,2764000,1643767,59.5,1534609,55.5,109158,6.6
1735,November 1978,Alaska,257000,183536,71.4,165048,64.2,18488,10.1
1736,November 1978,Arizona,1845000,1113812,60.4,1050048,56.9,63764,5.7
1737,November 1978,Arkansas,1628000,966340,59.4,903797,55.5,62543,6.5
1738,November 1978,California,16934000,11067799,65.4,10327770,61.0,740029,6.7
1739,November 1978,Colorado,2023000,1376217,68.0,1306875,64.6,69342,5.0
1740,November 1978,Connecticut,2323000,1535393,66.1,1456190,62.7,79203,5.2
1741,November 1978,Delaware,437000,279391,63.9,259310,59.3,20081,7.2
1742,November 1978,District of Columbia,507000,334692,66.0,308226,60.8,26466,7.9
1743,November 1978,Florida,7079000,4045188,57.1,3780545,53.4,264643,6.5
1744,November 1978,Georgia,3767000,2446007,64.9,2304969,61.2,141038,5.8
1745,November 1978,Hawaii,631000,420473,66.6,392467,62.2,28006,6.7
1746,November 1978,Idaho,638000,421342,66.0,396348,62.1,24994,5.9
1747,November 1978,Illinois,8389000,5454292,65.0,5146787,61.4,307505,5.6
1748,November 1978,Indiana,3949000,2625841,66.5,2480148,62.8,145693,5.5
1749,November 1978,Iowa,2135000,1419557,66.5,1363139,63.8,56418,4.0
1750,November 1978,Kansas,1706000,1154847,67.7,1119651,65.6,35196,3.0
1751,November 1978,Kentucky,2597000,1594132,61.4,1510817,58.2,83315,5.2
1752,November 1978,Louisiana,2861000,1677787,58.6,1578073,55.2,99714,5.9
1753,November 1978,Maine,811000,490327,60.5,459090,56.6,31237,6.4
1754,November 1978,Maryland,3093000,2076372,67.1,1960553,63.4,115819,5.6
1755,November 1978,Massachusetts,4313000,2836186,65.8,2666707,61.8,169479,6.0
1756,November 1978,Michigan,6668000,4254688,63.8,3952888,59.3,301800,7.1
1757,November 1978,Minnesota,2925000,1999721,68.4,1924283,65.8,75438,3.8
1758,November 1978,Mississippi,1733000,1019109,58.8,952953,55.0,66156,6.5
1759,November 1978,Missouri,3597000,2263761,62.9,2164895,60.2,98866,4.4
1760,November 1978,Montana,568000,368580,64.9,349393,61.5,19187,5.2
1761,November 1978,Nebraska,1131000,757112,66.9,736368,65.1,20744,2.7
1762,November 1978,Nevada,543000,380844,70.1,363201,66.9,17643,4.6
1763,November 1978,New Hampshire,656000,441832,67.4,426787,65.1,15045,3.4
1764,November 1978,New Jersey,5520000,3532887,64.0,3284857,59.5,248030,7.0
1765,November 1978,New Mexico,877000,546519,62.3,513103,58.5,33416,6.1
1766,November 1978,New York,13261000,7924783,59.8,7338896,55.3,585887,7.4
1767,November 1978,North Carolina,4144000,2789401,67.3,2666419,64.3,122982,4.4
1768,November 1978,North Dakota,461000,296192,64.2,283553,61.5,12639,4.3
1769,November 1978,Ohio,7915000,5022376,63.5,4747307,60.0,275069,5.5
1770,November 1978,Oklahoma,2131000,1282396,60.2,1239311,58.2,43085,3.4
1771,November 1978,Oregon,1885000,1238603,65.7,1154582,61.3,84021,6.8
1772,November 1978,Pennsylvania,8963000,5346873,59.7,4982771,55.6,364102,6.8
1773,November 1978,Rhode Island,717000,453529,63.3,425468,59.3,28061,6.2
1774,November 1978,South Carolina,2138000,1363127,63.8,1289146,60.3,73981,5.4
1775,November 1978,South Dakota,491000,330422,67.3,319889,65.2,10533,3.2
1776,November 1978,Tennessee,3281000,2001850,61.0,1884608,57.4,117242,5.9
1777,November 1978,Texas,9655000,6316381,65.4,6022940,62.4,293441,4.6
1778,November 1978,Utah,909000,581432,64.0,560094,61.6,21338,3.7
1779,November 1978,Vermont,363000,242535,66.8,229462,63.2,13073,5.4
1780,November 1978,Virginia,3784000,2515652,66.5,2384215,63.0,131437,5.2
1781,November 1978,Washington,2866000,1848433,64.5,1719871,60.0,128562,7.0
1782,November 1978,West Virginia,1419000,757665,53.4,709636,50.0,48029,6.3
1783,November 1978,Wisconsin,3385000,2297624,67.9,2180701,64.4,116923,5.1
1784,November 1978,Wyoming,310000,214792,69.3,208322,67.2,6470,3.0
1785,December 1978,Alabama,2767000,1645893,59.5,1535097,55.5,110796,6.7
1786,December 1978,Alaska,257000,183811,71.5,165629,64.4,18182,9.9
1787,December 1978,Arizona,1853000,1123492,60.6,1059541,57.2,63951,5.7
1788,December 1978,Arkansas,1631000,970682,59.5,907360,55.6,63322,6.5
1789,December 1978,California,16970000,11104386,65.4,10370987,61.1,733399,6.6
1790,December 1978,Colorado,2030000,1383534,68.2,1315057,64.8,68477,4.9
1791,December 1978,Connecticut,2325000,1542363,66.3,1461641,62.9,80722,5.2
1792,December 1978,Delaware,437000,279429,63.9,259327,59.3,20102,7.2
1793,December 1978,District of Columbia,506000,333978,66.0,307615,60.8,26363,7.9
1794,December 1978,Florida,7105000,4065529,57.2,3802128,53.5,263401,6.5
1795,December 1978,Georgia,3776000,2451612,64.9,2311421,61.2,140191,5.7
1796,December 1978,Hawaii,633000,420461,66.4,392958,62.1,27503,6.5
1797,December 1978,Idaho,640000,422337,66.0,396893,62.0,25444,6.0
1798,December 1978,Illinois,8393000,5455519,65.0,5149603,61.4,305916,5.6
1799,December 1978,Indiana,3953000,2630718,66.5,2484023,62.8,146695,5.6
1800,December 1978,Iowa,2136000,1419307,66.4,1361918,63.8,57389,4.0
1801,December 1978,Kansas,1708000,1157912,67.8,1122288,65.7,35624,3.1
1802,December 1978,Kentucky,2600000,1594884,61.3,1511600,58.1,83284,5.2
1803,December 1978,Louisiana,2867000,1681702,58.7,1583251,55.2,98451,5.9
1804,December 1978,Maine,812000,491389,60.5,459778,56.6,31611,6.4
1805,December 1978,Maryland,3096000,2083214,67.3,1964984,63.5,118230,5.7
1806,December 1978,Massachusetts,4317000,2841893,65.8,2672539,61.9,169354,6.0
1807,December 1978,Michigan,6675000,4270972,64.0,3965614,59.4,305358,7.1
1808,December 1978,Minnesota,2929000,2005015,68.5,1928907,65.9,76108,3.8
1809,December 1978,Mississippi,1735000,1019927,58.8,955616,55.1,64311,6.3
1810,December 1978,Missouri,3600000,2270000,63.1,2172552,60.3,97448,4.3
1811,December 1978,Montana,569000,367716,64.6,348728,61.3,18988,5.2
1812,December 1978,Nebraska,1132000,757397,66.9,736673,65.1,20724,2.7
1813,December 1978,Nevada,546000,382352,70.0,364443,66.7,17909,4.7
1814,December 1978,New Hampshire,657000,443424,67.5,428723,65.3,14701,3.3
1815,December 1978,New Jersey,5525000,3545837,64.2,3296370,59.7,249467,7.0
1816,December 1978,New Mexico,880000,547713,62.2,513605,58.4,34108,6.2
1817,December 1978,New York,13263000,7944266,59.9,7363972,55.5,580294,7.3
1818,December 1978,North Carolina,4151000,2797544,67.4,2670564,64.3,126980,4.5
1819,December 1978,North Dakota,461000,296800,64.4,284089,61.6,12711,4.3
1820,December 1978,Ohio,7920000,5039574,63.6,4759682,60.1,279892,5.6
1821,December 1978,Oklahoma,2135000,1286526,60.3,1242554,58.2,43972,3.4
1822,December 1978,Oregon,1890000,1240337,65.6,1154527,61.1,85810,6.9
1823,December 1978,Pennsylvania,8968000,5353414,59.7,4989490,55.6,363924,6.8
1824,December 1978,Rhode Island,717000,454360,63.4,426366,59.5,27994,6.2
1825,December 1978,South Carolina,2142000,1364408,63.7,1291073,60.3,73335,5.4
1826,December 1978,South Dakota,491000,330570,67.3,319842,65.1,10728,3.2
1827,December 1978,Tennessee,3288000,2010026,61.1,1894902,57.6,115124,5.7
1828,December 1978,Texas,9684000,6337938,65.4,6049161,62.5,288777,4.6
1829,December 1978,Utah,911000,585161,64.2,563281,61.8,21880,3.7
1830,December 1978,Vermont,364000,243141,66.8,230071,63.2,13070,5.4
1831,December 1978,Virginia,3790000,2519926,66.5,2389378,63.0,130548,5.2
1832,December 1978,Washington,2875000,1858795,64.7,1729286,60.1,129509,7.0
1833,December 1978,West Virginia,1421000,760342,53.5,712187,50.1,48155,6.3
1834,December 1978,Wisconsin,3390000,2302605,67.9,2187436,64.5,115169,5.0
1835,December 1978,Wyoming,311000,215697,69.4,209487,67.4,6210,2.9
1836,January 1979,Alabama,2771000,1647812,59.5,1535258,55.4,112554,6.8
1837,January 1979,Alaska,257000,183977,71.6,166119,64.6,17858,9.7
1838,January 1979,Arizona,1862000,1131494,60.8,1067974,57.4,63520,5.6
1839,January 1979,Arkansas,1633000,974685,59.7,911083,55.8,63602,6.5
1840,January 1979,California,17006000,11133630,65.5,10406766,61.2,726864,6.5
1841,January 1979,Colorado,2036000,1390268,68.3,1322425,65.0,67843,4.9
1842,January 1979,Connecticut,2327000,1548148,66.5,1465976,63.0,82172,5.3
1843,January 1979,Delaware,437000,279470,64.0,259239,59.3,20231,7.2
1844,January 1979,District of Columbia,506000,332921,65.8,306713,60.6,26208,7.9
1845,January 1979,Florida,7132000,4082104,57.2,3820723,53.6,261381,6.4
1846,January 1979,Georgia,3784000,2455448,64.9,2316637,61.2,138811,5.7
1847,January 1979,Hawaii,635000,420610,66.2,393360,61.9,27250,6.5
1848,January 1979,Idaho,641000,423600,66.1,397894,62.1,25706,6.1
1849,January 1979,Illinois,8397000,5450816,64.9,5146556,61.3,304260,5.6
1850,January 1979,Indiana,3957000,2633644,66.6,2486271,62.8,147373,5.6
1851,January 1979,Iowa,2137000,1419290,66.4,1361275,63.7,58015,4.1
1852,January 1979,Kansas,1710000,1160001,67.8,1124118,65.7,35883,3.1
1853,January 1979,Kentucky,2603000,1595459,61.3,1512070,58.1,83389,5.2
1854,January 1979,Louisiana,2873000,1686136,58.7,1587769,55.3,98367,5.8
1855,January 1979,Maine,813000,492253,60.5,460131,56.6,32122,6.5
1856,January 1979,Maryland,3099000,2089611,67.4,1969034,63.5,120577,5.8
1857,January 1979,Massachusetts,4320000,2846200,65.9,2677304,62.0,168896,5.9
1858,January 1979,Michigan,6682000,4284035,64.1,3975332,59.5,308703,7.2
1859,January 1979,Minnesota,2933000,2010310,68.5,1933137,65.9,77173,3.8
1860,January 1979,Mississippi,1737000,1020520,58.8,958121,55.2,62399,6.1
1861,January 1979,Missouri,3603000,2273989,63.1,2176998,60.4,96991,4.3
1862,January 1979,Montana,569000,367132,64.5,348300,61.2,18832,5.1
1863,January 1979,Nebraska,1133000,758094,66.9,737214,65.1,20880,2.8
1864,January 1979,Nevada,550000,384374,69.9,366192,66.6,18182,4.7
1865,January 1979,New Hampshire,659000,445041,67.5,430659,65.4,14382,3.2
1866,January 1979,New Jersey,5530000,3554894,64.3,3304123,59.7,250771,7.1
1867,January 1979,New Mexico,882000,548863,62.2,514236,58.3,34627,6.3
1868,January 1979,New York,13266000,7955684,60.0,7381316,55.6,574368,7.2
1869,January 1979,North Carolina,4158000,2803000,67.4,2672026,64.3,130974,4.7
1870,January 1979,North Dakota,461000,297467,64.5,284657,61.7,12810,4.3
1871,January 1979,Ohio,7924000,5052104,63.8,4767944,60.2,284160,5.6
1872,January 1979,Oklahoma,2139000,1289540,60.3,1245120,58.2,44420,3.4
1873,January 1979,Oregon,1895000,1241365,65.5,1154719,60.9,86646,7.0
1874,January 1979,Pennsylvania,8974000,5358154,59.7,4994906,55.7,363248,6.8
1875,January 1979,Rhode Island,717000,455241,63.5,427249,59.6,27992,6.1
1876,January 1979,South Carolina,2146000,1365685,63.6,1292726,60.2,72959,5.3
1877,January 1979,South Dakota,492000,330804,67.2,319808,65.0,10996,3.3
1878,January 1979,Tennessee,3294000,2016586,61.2,1903163,57.8,113423,5.6
1879,January 1979,Texas,9712000,6355993,65.4,6072281,62.5,283712,4.5
1880,January 1979,Utah,914000,588488,64.4,566078,61.9,22410,3.8
1881,January 1979,Vermont,365000,243651,66.8,230628,63.2,13023,5.3
1882,January 1979,Virginia,3795000,2522789,66.5,2393658,63.1,129131,5.1
1883,January 1979,Washington,2885000,1871493,64.9,1741312,60.4,130181,7.0
1884,January 1979,West Virginia,1422000,762071,53.6,713986,50.2,48085,6.3
1885,January 1979,Wisconsin,3394000,2305836,67.9,2193562,64.6,112274,4.9
1886,January 1979,Wyoming,313000,216577,69.2,210655,67.3,5922,2.7
1887,February 1979,Alabama,2775000,1649538,59.4,1534963,55.3,114575,6.9
1888,February 1979,Alaska,257000,184048,71.6,166492,64.8,17556,9.5
1889,February 1979,Arizona,1871000,1136935,60.8,1074575,57.4,62360,5.5
1890,February 1979,Arkansas,1636000,978121,59.8,914818,55.9,63303,6.5
1891,February 1979,California,17042000,11153562,65.4,10435092,61.2,718470,6.4
1892,February 1979,Colorado,2043000,1396441,68.4,1329204,65.1,67237,4.8
1893,February 1979,Connecticut,2329000,1552211,66.6,1469003,63.1,83208,5.4
1894,February 1979,Delaware,438000,279484,63.8,259103,59.2,20381,7.3
1895,February 1979,District of Columbia,505000,331629,65.7,305746,60.5,25883,7.8
1896,February 1979,Florida,7158000,4093813,57.2,3835543,53.6,258270,6.3
1897,February 1979,Georgia,3792000,2456858,64.8,2320610,61.2,136248,5.5
1898,February 1979,Hawaii,636000,421047,66.2,393824,61.9,27223,6.5
1899,February 1979,Idaho,642000,424994,66.2,399311,62.2,25683,6.0
1900,February 1979,Illinois,8402000,5441129,64.8,5139335,61.2,301794,5.5
1901,February 1979,Indiana,3961000,2633951,66.5,2486179,62.8,147772,5.6
1902,February 1979,Iowa,2138000,1419208,66.4,1360951,63.7,58257,4.1
1903,February 1979,Kansas,1711000,1161119,67.9,1125107,65.8,36012,3.1
1904,February 1979,Kentucky,2606000,1596382,61.3,1512697,58.0,83685,5.2
1905,February 1979,Louisiana,2878000,1690966,58.8,1591436,55.3,99530,5.9
1906,February 1979,Maine,814000,492899,60.6,460193,56.5,32706,6.6
1907,February 1979,Maryland,3102000,2095269,67.5,1973146,63.6,122123,5.8
1908,February 1979,Massachusetts,4324000,2848588,65.9,2681244,62.0,167344,5.9
1909,February 1979,Michigan,6689000,4292133,64.2,3982060,59.5,310073,7.2
1910,February 1979,Minnesota,2938000,2015861,68.6,1937447,65.9,78414,3.9
1911,February 1979,Mississippi,1739000,1021137,58.7,960753,55.2,60384,5.9
1912,February 1979,Missouri,3606000,2274965,63.1,2177792,60.4,97173,4.3
1913,February 1979,Montana,570000,367125,64.4,348400,61.1,18725,5.1
1914,February 1979,Nebraska,1134000,759308,67.0,738116,65.1,21192,2.8
1915,February 1979,Nevada,553000,386963,70.0,368422,66.6,18541,4.8
1916,February 1979,New Hampshire,661000,446564,67.6,432494,65.4,14070,3.2
1917,February 1979,New Jersey,5535000,3558935,64.3,3308318,59.8,250617,7.0
1918,February 1979,New Mexico,885000,550021,62.1,515114,58.2,34907,6.3
1919,February 1979,New York,13269000,7959763,60.0,7391227,55.7,568536,7.1
1920,February 1979,North Carolina,4164000,2804438,67.3,2670996,64.1,133442,4.8
1921,February 1979,North Dakota,462000,298124,64.5,285268,61.7,12856,4.3
1922,February 1979,Ohio,7929000,5057785,63.8,4771024,60.2,286761,5.7
1923,February 1979,Oklahoma,2143000,1291606,60.3,1247203,58.2,44403,3.4
1924,February 1979,Oregon,1901000,1242077,65.3,1155688,60.8,86389,7.0
1925,February 1979,Pennsylvania,8980000,5360567,59.7,4998444,55.7,362123,6.8
1926,February 1979,Rhode Island,718000,456166,63.5,428024,59.6,28142,6.2
1927,February 1979,South Carolina,2150000,1366387,63.6,1294377,60.2,72010,5.3
1928,February 1979,South Dakota,492000,331138,67.3,319936,65.0,11202,3.4
1929,February 1979,Tennessee,3301000,2021454,61.2,1908635,57.8,112819,5.6
1930,February 1979,Texas,9740000,6371423,65.4,6092317,62.5,279106,4.4
1931,February 1979,Utah,917000,591479,64.5,568486,62.0,22993,3.9
1932,February 1979,Vermont,365000,243988,66.8,231097,63.3,12891,5.3
1933,February 1979,Virginia,3801000,2523714,66.4,2396705,63.1,127009,5.0
1934,February 1979,Washington,2895000,1885756,65.1,1755501,60.6,130255,6.9
1935,February 1979,West Virginia,1424000,763046,53.6,714824,50.2,48222,6.3
1936,February 1979,Wisconsin,3399000,2307880,67.9,2198977,64.7,108903,4.7
1937,February 1979,Wyoming,314000,217522,69.3,211849,67.5,5673,2.6
1938,March 1979,Alabama,2778000,1650980,59.4,1534270,55.2,116710,7.1
1939,March 1979,Alaska,257000,184013,71.6,166721,64.9,17292,9.4
1940,March 1979,Arizona,1879000,1139708,60.7,1079124,57.4,60584,5.3
1941,March 1979,Arkansas,1639000,980897,59.8,918386,56.0,62511,6.4
1942,March 1979,California,17078000,11167257,65.4,10459189,61.2,708068,6.3
1943,March 1979,Colorado,2050000,1402704,68.4,1336013,65.2,66691,4.8
1944,March 1979,Connecticut,2331000,1554741,66.7,1471329,63.1,83412,5.4
1945,March 1979,Delaware,438000,279433,63.8,258989,59.1,20444,7.3
1946,March 1979,District of Columbia,504000,330268,65.5,304953,60.5,25315,7.7
1947,March 1979,Florida,7184000,4101708,57.1,3847359,53.6,254349,6.2
1948,March 1979,Georgia,3801000,2456167,64.6,2323833,61.1,132334,5.4
1949,March 1979,Hawaii,638000,421835,66.1,394525,61.8,27310,6.5
1950,March 1979,Idaho,644000,426263,66.2,400930,62.3,25333,5.9
1951,March 1979,Illinois,8406000,5429335,64.6,5132116,61.1,297219,5.5
1952,March 1979,Indiana,3965000,2632070,66.4,2483431,62.6,148639,5.6
1953,March 1979,Iowa,2139000,1418878,66.3,1360710,63.6,58168,4.1
1954,March 1979,Kansas,1713000,1161630,67.8,1125543,65.7,36087,3.1
1955,March 1979,Kentucky,2609000,1598355,61.3,1514124,58.0,84231,5.3
1956,March 1979,Louisiana,2884000,1696194,58.8,1594135,55.3,102059,6.0
1957,March 1979,Maine,815000,493374,60.5,460156,56.5,33218,6.7
1958,March 1979,Maryland,3105000,2100091,67.6,1977437,63.7,122654,5.8
1959,March 1979,Massachusetts,4328000,2849066,65.8,2684716,62.0,164350,5.8
1960,March 1979,Michigan,6696000,4295722,64.2,3986200,59.5,309522,7.2
1961,March 1979,Minnesota,2942000,2021836,68.7,1942152,66.0,79684,3.9
1962,March 1979,Mississippi,1741000,1021852,58.7,963592,55.3,58260,5.7
1963,March 1979,Missouri,3609000,2273843,63.0,2175946,60.3,97897,4.3
1964,March 1979,Montana,571000,367710,64.4,349034,61.1,18676,5.1
1965,March 1979,Nebraska,1135000,760923,67.0,739300,65.1,21623,2.8
1966,March 1979,Nevada,556000,389988,70.1,370991,66.7,18997,4.9
1967,March 1979,New Hampshire,662000,447869,67.7,434090,65.6,13779,3.1
1968,March 1979,New Jersey,5540000,3559174,64.2,3310161,59.8,249013,7.0
1969,March 1979,New Mexico,887000,551160,62.1,516211,58.2,34949,6.3
1970,March 1979,New York,13271000,7960601,60.0,7396959,55.7,563642,7.1
1971,March 1979,North Carolina,4171000,2802268,67.2,2668756,64.0,133512,4.8
1972,March 1979,North Dakota,462000,298722,64.7,285946,61.9,12776,4.3
1973,March 1979,Ohio,7934000,5057075,63.7,4769330,60.1,287745,5.7
1974,March 1979,Oklahoma,2147000,1293768,60.3,1249615,58.2,44153,3.4
1975,March 1979,Oregon,1906000,1243014,65.2,1157627,60.7,85387,6.9
1976,March 1979,Pennsylvania,8985000,5360842,59.7,5000122,55.6,360720,6.7
1977,March 1979,Rhode Island,718000,457142,63.7,428641,59.7,28501,6.2
1978,March 1979,South Carolina,2154000,1366301,63.4,1296202,60.2,70099,5.1
1979,March 1979,South Dakota,492000,331509,67.4,320272,65.1,11237,3.4
1980,March 1979,Tennessee,3308000,2025258,61.2,1911767,57.8,113491,5.6
1981,March 1979,Texas,9769000,6386829,65.4,6110727,62.6,276102,4.3
1982,March 1979,Utah,919000,594469,64.7,570800,62.1,23669,4.0
1983,March 1979,Vermont,366000,244130,66.7,231445,63.2,12685,5.2
1984,March 1979,Virginia,3806000,2523307,66.3,2399028,63.0,124279,4.9
1985,March 1979,Washington,2904000,1900104,65.4,1770700,61.0,129404,6.8
1986,March 1979,West Virginia,1426000,763632,53.6,714889,50.1,48743,6.4
1987,March 1979,Wisconsin,3403000,2309340,67.9,2203715,64.8,105625,4.6
1988,March 1979,Wyoming,315000,218574,69.4,213058,67.6,5516,2.5
1989,April 1979,Alabama,2782000,1652094,59.4,1533457,55.1,118637,7.2
1990,April 1979,Alaska,257000,183856,71.5,166789,64.9,17067,9.3
1991,April 1979,Arizona,1888000,1140474,60.4,1081848,57.3,58626,5.1
1992,April 1979,Arkansas,1641000,982900,59.9,921373,56.1,61527,6.3
1993,April 1979,California,17114000,11180830,65.3,10482334,61.3,698496,6.2
1994,April 1979,Colorado,2056000,1409605,68.6,1343293,65.3,66312,4.7
1995,April 1979,Connecticut,2333000,1556044,66.7,1473413,63.2,82631,5.3
1996,April 1979,Delaware,439000,279336,63.6,258963,59.0,20373,7.3
1997,April 1979,District of Columbia,504000,329155,65.3,304615,60.4,24540,7.5
1998,April 1979,Florida,7210000,4107701,57.0,3857117,53.5,250584,6.1
1999,April 1979,Georgia,3809000,2454523,64.4,2326846,61.1,127677,5.2
2000,April 1979,Hawaii,640000,422942,66.1,395624,61.8,27318,6.5
2001,April 1979,Idaho,645000,427235,66.2,402477,62.4,24758,5.8
2002,April 1979,Illinois,8410000,5418993,64.4,5128267,61.0,290726,5.4
2003,April 1979,Indiana,3969000,2629445,66.2,2478349,62.4,151096,5.7
2004,April 1979,Iowa,2140000,1418459,66.3,1360470,63.6,57989,4.1
2005,April 1979,Kansas,1715000,1162085,67.8,1125819,65.6,36266,3.1
2006,April 1979,Kentucky,2612000,1601999,61.3,1516756,58.1,85243,5.3
2007,April 1979,Louisiana,2890000,1701742,58.9,1595825,55.2,105917,6.2
2008,April 1979,Maine,816000,493870,60.5,460301,56.4,33569,6.8
2009,April 1979,Maryland,3108000,2104520,67.7,1981809,63.8,122711,5.8
2010,April 1979,Massachusetts,4331000,2848602,65.8,2688045,62.1,160557,5.6
2011,April 1979,Michigan,6703000,4296743,64.1,3987304,59.5,309439,7.2
2012,April 1979,Minnesota,2946000,2028451,68.9,1947250,66.1,81201,4.0
2013,April 1979,Mississippi,1743000,1022714,58.7,966286,55.4,56428,5.5
2014,April 1979,Missouri,3612000,2272439,62.9,2172734,60.2,99705,4.4
2015,April 1979,Montana,571000,368813,64.6,350122,61.3,18691,5.1
2016,April 1979,Nebraska,1135000,762732,67.2,740553,65.2,22179,2.9
2017,April 1979,Nevada,559000,393227,70.3,373723,66.9,19504,5.0
2018,April 1979,New Hampshire,664000,448899,67.6,435337,65.6,13562,3.0
2019,April 1979,New Jersey,5544000,3558156,64.2,3310986,59.7,247170,6.9
2020,April 1979,New Mexico,890000,552249,62.1,517421,58.1,34828,6.3
2021,April 1979,New York,13274000,7962758,60.0,7401466,55.8,561292,7.0
2022,April 1979,North Carolina,4178000,2798287,67.0,2666310,63.8,131977,4.7
2023,April 1979,North Dakota,463000,299240,64.6,286694,61.9,12546,4.2
2024,April 1979,Ohio,7938000,5052760,63.7,4764425,60.0,288335,5.7
2025,April 1979,Oklahoma,2151000,1296986,60.3,1252946,58.2,44040,3.4
2026,April 1979,Oregon,1911000,1244605,65.1,1160397,60.7,84208,6.8
2027,April 1979,Pennsylvania,8991000,5360239,59.6,5000363,55.6,359876,6.7
2028,April 1979,Rhode Island,719000,458055,63.7,429123,59.7,28932,6.3
2029,April 1979,South Carolina,2158000,1366008,63.3,1298259,60.2,67749,5.0
2030,April 1979,South Dakota,492000,331900,67.5,320783,65.2,11117,3.3
2031,April 1979,Tennessee,3314000,2028960,61.2,1913463,57.7,115497,5.7
2032,April 1979,Texas,9797000,6405159,65.4,6129384,62.6,275775,4.3
2033,April 1979,Utah,922000,597728,64.8,573264,62.2,24464,4.1
2034,April 1979,Vermont,367000,244127,66.5,231658,63.1,12469,5.1
2035,April 1979,Virginia,3812000,2522571,66.2,2401169,63.0,121402,4.8
2036,April 1979,Washington,2914000,1913608,65.7,1785655,61.3,127953,6.7
2037,April 1979,West Virginia,1427000,764206,53.6,714672,50.1,49534,6.5
2038,April 1979,Wisconsin,3408000,2310921,67.8,2207812,64.8,103109,4.5
2039,April 1979,Wyoming,316000,219747,69.5,214259,67.8,5488,2.5
2040,May 1979,Alabama,2786000,1653228,59.3,1533152,55.0,120076,7.3
2041,May 1979,Alaska,258000,183646,71.2,166750,64.6,16896,9.2
2042,May 1979,Arizona,1897000,1140642,60.1,1083835,57.1,56807,5.0
2043,May 1979,Arkansas,1644000,984185,59.9,923532,56.2,60653,6.2
2044,May 1979,California,17151000,11201201,65.3,10508505,61.3,692696,6.2
2045,May 1979,Colorado,2063000,1417528,68.7,1351293,65.5,66235,4.7
2046,May 1979,Connecticut,2336000,1557009,66.7,1475809,63.2,81200,5.2
2047,May 1979,Delaware,439000,279317,63.6,259104,59.0,20213,7.2
2048,May 1979,District of Columbia,503000,328534,65.3,304852,60.6,23682,7.2
2049,May 1979,Florida,7237000,4114563,56.9,3866770,53.4,247793,6.0
2050,May 1979,Georgia,3817000,2454155,64.3,2330499,61.1,123656,5.0
2051,May 1979,Hawaii,642000,424172,66.1,397139,61.9,27033,6.4
2052,May 1979,Idaho,646000,427931,66.2,403760,62.5,24171,5.6
2053,May 1979,Illinois,8414000,5413890,64.3,5129683,61.0,284207,5.2
2054,May 1979,Indiana,3973000,2628052,66.1,2472176,62.2,155876,5.9
2055,May 1979,Iowa,2141000,1418091,66.2,1360205,63.5,57886,4.1
2056,May 1979,Kansas,1717000,1163229,67.7,1126502,65.6,36727,3.2
2057,May 1979,Kentucky,2616000,1607418,61.4,1520632,58.1,86786,5.4
2058,May 1979,Louisiana,2896000,1708189,59.0,1597591,55.2,110598,6.5
2059,May 1979,Maine,818000,494673,60.5,460885,56.3,33788,6.8
2060,May 1979,Maryland,3112000,2108803,67.8,1986099,63.8,122704,5.8
2061,May 1979,Massachusetts,4335000,2848475,65.7,2691596,62.1,156879,5.5
2062,May 1979,Michigan,6711000,4298107,64.0,3985641,59.4,312466,7.3
2063,May 1979,Minnesota,2950000,2035705,69.0,1952728,66.2,82977,4.1
2064,May 1979,Mississippi,1746000,1023996,58.6,968606,55.5,55390,5.4
2065,May 1979,Missouri,3615000,2272418,62.9,2169808,60.0,102610,4.5
2066,May 1979,Montana,572000,370216,64.7,351420,61.4,18796,5.1
2067,May 1979,Nebraska,1136000,764496,67.3,741637,65.3,22859,3.0
2068,May 1979,Nevada,563000,396502,70.4,376524,66.9,19978,5.0
2069,May 1979,New Hampshire,666000,449728,67.5,436261,65.5,13467,3.0
2070,May 1979,New Jersey,5549000,3558655,64.1,3312527,59.7,246128,6.9
2071,May 1979,New Mexico,892000,553442,62.0,518750,58.2,34692,6.3
2072,May 1979,New York,13277000,7970035,60.0,7407580,55.8,562455,7.1
2073,May 1979,North Carolina,4185000,2795182,66.8,2664961,63.7,130221,4.7
2074,May 1979,North Dakota,463000,299692,64.7,287495,62.1,12197,4.1
2075,May 1979,Ohio,7943000,5048724,63.6,4759176,59.9,289548,5.7
2076,May 1979,Oklahoma,2156000,1301648,60.4,1257457,58.3,44191,3.4
2077,May 1979,Oregon,1916000,1246946,65.1,1163719,60.7,83227,6.7
2078,May 1979,Pennsylvania,8997000,5361238,59.6,5000927,55.6,360311,6.7
2079,May 1979,Rhode Island,719000,458859,63.8,429562,59.7,29297,6.4
2080,May 1979,South Carolina,2163000,1366141,63.2,1300436,60.1,65705,4.8
2081,May 1979,South Dakota,493000,332332,67.4,321386,65.2,10946,3.3
2082,May 1979,Tennessee,3321000,2033193,61.2,1915039,57.7,118154,5.8
2083,May 1979,Texas,9825000,6427782,65.4,6150075,62.6,277707,4.3
2084,May 1979,Utah,925000,601198,65.0,575869,62.3,25329,4.2
2085,May 1979,Vermont,368000,244091,66.3,231789,63.0,12302,5.0
2086,May 1979,Virginia,3817000,2523193,66.1,2404161,63.0,119032,4.7
2087,May 1979,Washington,2924000,1925968,65.9,1799297,61.5,126671,6.6
2088,May 1979,West Virginia,1429000,765291,53.6,714736,50.0,50555,6.6
2089,May 1979,Wisconsin,3412000,2313692,67.8,2211795,64.8,101897,4.4
2090,May 1979,Wyoming,318000,221056,69.5,215461,67.8,5595,2.5
2091,June 1979,Alabama,2789000,1654719,59.3,1533709,55.0,121010,7.3
2092,June 1979,Alaska,258000,183455,71.1,166658,64.6,16797,9.2
2093,June 1979,Arizona,1905000,1141618,59.9,1086193,57.0,55425,4.9
2094,June 1979,Arkansas,1646000,984966,59.8,924817,56.2,60149,6.1
2095,June 1979,California,17187000,11231899,65.4,10539499,61.3,692400,6.2
2096,June 1979,Colorado,2069000,1426110,68.9,1359527,65.7,66583,4.7
2097,June 1979,Connecticut,2338000,1558467,66.7,1478796,63.3,79671,5.1
2098,June 1979,Delaware,440000,279528,63.5,259471,59.0,20057,7.2
2099,June 1979,District of Columbia,503000,328379,65.3,305479,60.7,22900,7.0
2100,June 1979,Florida,7263000,4123188,56.8,3877029,53.4,246159,6.0
2101,June 1979,Georgia,3826000,2456261,64.2,2335080,61.0,121181,4.9
2102,June 1979,Hawaii,643000,425369,66.2,398840,62.0,26529,6.2
2103,June 1979,Idaho,648000,428588,66.1,404819,62.5,23769,5.5
2104,June 1979,Illinois,8418000,5415706,64.3,5135092,61.0,280614,5.2
2105,June 1979,Indiana,3977000,2628732,66.1,2465934,62.0,162798,6.2
2106,June 1979,Iowa,2142000,1417913,66.2,1359876,63.5,58037,4.1
2107,June 1979,Kansas,1718000,1165384,67.8,1127976,65.7,37408,3.2
2108,June 1979,Kentucky,2619000,1613981,61.6,1525140,58.2,88841,5.5
2109,June 1979,Louisiana,2901000,1716342,59.2,1600858,55.2,115484,6.7
2110,June 1979,Maine,819000,495880,60.5,461934,56.4,33946,6.8
2111,June 1979,Maryland,3115000,2112826,67.8,1989907,63.9,122919,5.8
2112,June 1979,Massachusetts,4338000,2849080,65.7,2694969,62.1,154111,5.4
2113,June 1979,Michigan,6718000,4300459,64.0,3981094,59.3,319365,7.4
2114,June 1979,Minnesota,2954000,2043308,69.2,1958432,66.3,84876,4.2
2115,June 1979,Mississippi,1748000,1025825,58.7,970336,55.5,55489,5.4
2116,June 1979,Missouri,3618000,2274045,62.9,2167748,59.9,106297,4.7
2117,June 1979,Montana,572000,371659,65.0,352668,61.7,18991,5.1
2118,June 1979,Nebraska,1137000,765997,67.4,742408,65.3,23589,3.1
2119,June 1979,Nevada,566000,399693,70.6,379309,67.0,20384,5.1
2120,June 1979,New Hampshire,667000,450583,67.6,437025,65.5,13558,3.0
2121,June 1979,New Jersey,5554000,3562210,64.1,3315465,59.7,246745,6.9
2122,June 1979,New Mexico,895000,554885,62.0,520213,58.1,34672,6.2
2123,June 1979,New York,13279000,7982659,60.1,7415310,55.8,567349,7.1
2124,June 1979,North Carolina,4191000,2794892,66.7,2665500,63.6,129392,4.6
2125,June 1979,North Dakota,464000,300079,64.7,288264,62.1,11815,3.9
2126,June 1979,Ohio,7947000,5047381,63.5,4755113,59.8,292268,5.8
2127,June 1979,Oklahoma,2160000,1307274,60.5,1262771,58.5,44503,3.4
2128,June 1979,Oregon,1921000,1249883,65.1,1167158,60.8,82725,6.6
2129,June 1979,Pennsylvania,9002000,5365584,59.6,5003015,55.6,362569,6.8
2130,June 1979,Rhode Island,720000,459645,63.8,430108,59.7,29537,6.4
2131,June 1979,South Carolina,2167000,1367106,63.1,1302405,60.1,64701,4.7
2132,June 1979,South Dakota,493000,332769,67.5,321956,65.3,10813,3.2
2133,June 1979,Tennessee,3327000,2038256,61.3,1917241,57.6,121015,5.9
2134,June 1979,Texas,9854000,6453188,65.5,6172466,62.6,280722,4.4
2135,June 1979,Utah,927000,604570,65.2,578416,62.4,26154,4.3
2136,June 1979,Vermont,368000,244134,66.3,231917,63.0,12217,5.0
2137,June 1979,Virginia,3823000,2526095,66.1,2408316,63.0,117779,4.7
2138,June 1979,Washington,2933000,1936458,66.0,1810349,61.7,126109,6.5
2139,June 1979,West Virginia,1430000,767190,53.6,715276,50.0,51914,6.8
2140,June 1979,Wisconsin,3417000,2318375,67.8,2216117,64.9,102258,4.4
2141,June 1979,Wyoming,319000,222440,69.7,216643,67.9,5797,2.6
2142,July 1979,Alabama,2793000,1656477,59.3,1535256,55.0,121221,7.3
2143,July 1979,Alaska,258000,183343,71.1,166547,64.6,16796,9.2
2144,July 1979,Arizona,1914000,1144815,59.8,1090164,57.0,54651,4.8
2145,July 1979,Arkansas,1649000,985557,59.8,925507,56.1,60050,6.1
2146,July 1979,California,17223000,11272889,65.5,10576797,61.4,696092,6.2
2147,July 1979,Colorado,2076000,1434777,69.1,1367521,65.9,67256,4.7
2148,July 1979,Connecticut,2340000,1560846,66.7,1482471,63.4,78375,5.0
2149,July 1979,Delaware,440000,280069,63.7,260084,59.1,19985,7.1
2150,July 1979,District of Columbia,502000,328514,65.4,306241,61.0,22273,6.8
2151,July 1979,Florida,7289000,4133934,56.7,3889195,53.4,244739,5.9
2152,July 1979,Georgia,3834000,2460891,64.2,2340882,61.1,120009,4.9
2153,July 1979,Hawaii,645000,426417,66.1,400446,62.1,25971,6.1
2154,July 1979,Idaho,649000,429441,66.2,405769,62.5,23672,5.5
2155,July 1979,Illinois,8422000,5424660,64.4,5143098,61.1,281562,5.2
2156,July 1979,Indiana,3981000,2631761,66.1,2460879,61.8,170882,6.5
2157,July 1979,Iowa,2143000,1418414,66.2,1359862,63.5,58552,4.1
2158,July 1979,Kansas,1720000,1168513,67.9,1130465,65.7,38048,3.3
2159,July 1979,Kentucky,2622000,1620680,61.8,1529807,58.3,90873,5.6
2160,July 1979,Louisiana,2907000,1726439,59.4,1606758,55.3,119681,6.9
2161,July 1979,Maine,820000,497462,60.7,463389,56.5,34073,6.8
2162,July 1979,Maryland,3118000,2116249,67.9,1993203,63.9,123046,5.8
2163,July 1979,Massachusetts,4342000,2850741,65.7,2698301,62.1,152440,5.3
2164,July 1979,Michigan,6725000,4303437,64.0,3974854,59.1,328583,7.6
2165,July 1979,Minnesota,2958000,2050709,69.3,1964118,66.4,86591,4.2
2166,July 1979,Mississippi,1750000,1028032,58.7,971557,55.5,56475,5.5
2167,July 1979,Missouri,3621000,2277316,62.9,2167139,59.8,110177,4.8
2168,July 1979,Montana,573000,372858,65.1,353646,61.7,19212,5.2
2169,July 1979,Nebraska,1138000,767100,67.4,742893,65.3,24207,3.2
2170,July 1979,Nevada,569000,402780,70.8,382147,67.2,20633,5.1
2171,July 1979,New Hampshire,669000,451728,67.5,437873,65.5,13855,3.1
2172,July 1979,New Jersey,5559000,3569308,64.2,3320747,59.7,248561,7.0
2173,July 1979,New Mexico,897000,556583,62.0,521735,58.2,34848,6.3
2174,July 1979,New York,13282000,7999247,60.2,7425317,55.9,573930,7.2
2175,July 1979,North Carolina,4198000,2798704,66.7,2668871,63.6,129833,4.6
2176,July 1979,North Dakota,464000,300402,64.7,288911,62.3,11491,3.8
2177,July 1979,Ohio,7952000,5049262,63.5,4753509,59.8,295753,5.9
2178,July 1979,Oklahoma,2164000,1313303,60.7,1268554,58.6,44749,3.4
2179,July 1979,Oregon,1926000,1253229,65.1,1170611,60.8,82618,6.6
2180,July 1979,Pennsylvania,9008000,5374038,59.7,5007985,55.6,366053,6.8
2181,July 1979,Rhode Island,720000,460569,64.0,430893,59.8,29676,6.4
2182,July 1979,South Carolina,2171000,1368994,63.1,1304126,60.1,64868,4.7
2183,July 1979,South Dakota,493000,333199,67.6,322419,65.4,10780,3.2
2184,July 1979,Tennessee,3334000,2044253,61.3,1921057,57.6,123196,6.0
2185,July 1979,Texas,9882000,6479252,65.6,6196822,62.7,282430,4.4
2186,July 1979,Utah,930000,607609,65.3,580781,62.4,26828,4.4
2187,July 1979,Vermont,369000,244340,66.2,232106,62.9,12234,5.0
2188,July 1979,Virginia,3828000,2531563,66.1,2414115,63.1,117448,4.6
2189,July 1979,Washington,2943000,1944332,66.1,1818370,61.8,125962,6.5
2190,July 1979,West Virginia,1432000,769850,53.8,716356,50.0,53494,6.9
2191,July 1979,Wisconsin,3421000,2324874,68.0,2221492,64.9,103382,4.4
2192,July 1979,Wyoming,320000,223824,69.9,217790,68.1,6034,2.7
2193,August 1979,Alabama,2796000,1658553,59.3,1537606,55.0,120947,7.3
2194,August 1979,Alaska,258000,183334,71.1,166482,64.5,16852,9.2
2195,August 1979,Arizona,1921000,1150919,59.9,1096266,57.1,54653,4.7
2196,August 1979,Arkansas,1651000,986147,59.7,926036,56.1,60111,6.1
2197,August 1979,California,17267000,11320187,65.6,10618850,61.5,701337,6.2
2198,August 1979,Colorado,2080000,1442967,69.4,1374884,66.1,68083,4.7
2199,August 1979,Connecticut,2342000,1564304,66.8,1486672,63.5,77632,5.0
2200,August 1979,Delaware,440000,280906,63.8,260859,59.3,20047,7.1
2201,August 1979,District of Columbia,501000,328585,65.6,306782,61.2,21803,6.6
2202,August 1979,Florida,7318000,4146610,56.7,3903766,53.3,242844,5.9
2203,August 1979,Georgia,3841000,2467857,64.3,2347664,61.1,120193,4.9
2204,August 1979,Hawaii,647000,427284,66.0,401891,62.1,25393,5.9
2205,August 1979,Idaho,650000,430531,66.2,406606,62.6,23925,5.6
2206,August 1979,Illinois,8426000,5440509,64.6,5152362,61.1,288147,5.3
2207,August 1979,Indiana,3984000,2636719,66.2,2457281,61.7,179438,6.8
2208,August 1979,Iowa,2144000,1419880,66.2,1360424,63.5,59456,4.2
2209,August 1979,Kansas,1722000,1172421,68.1,1133872,65.8,38549,3.3
2210,August 1979,Kentucky,2625000,1626376,62.0,1534103,58.4,92273,5.7
2211,August 1979,Louisiana,2914000,1738019,59.6,1615414,55.4,122605,7.1
2212,August 1979,Maine,820000,499318,60.9,465088,56.7,34230,6.9
2213,August 1979,Maryland,3120000,2119053,67.9,1996136,64.0,122917,5.8
2214,August 1979,Massachusetts,4344000,2853371,65.7,2701559,62.2,151812,5.3
2215,August 1979,Michigan,6730000,4306901,64.0,3967435,59.0,339466,7.9
2216,August 1979,Minnesota,2963000,2057777,69.4,1969407,66.5,88370,4.3
2217,August 1979,Mississippi,1752000,1030508,58.8,972459,55.5,58049,5.6
2218,August 1979,Missouri,3625000,2282041,63.0,2167871,59.8,114170,5.0
2219,August 1979,Montana,573000,373660,65.2,354267,61.8,19393,5.2
2220,August 1979,Nebraska,1139000,767821,67.4,743224,65.3,24597,3.2
2221,August 1979,Nevada,572000,405771,70.9,385105,67.3,20666,5.1
2222,August 1979,New Hampshire,670000,453255,67.7,438913,65.5,14342,3.2
2223,August 1979,New Jersey,5562000,3578870,64.3,3328436,59.8,250434,7.0
2224,August 1979,New Mexico,899000,558392,62.1,523125,58.2,35267,6.3
2225,August 1979,New York,13283000,8017455,60.4,7437082,56.0,580373,7.2
2226,August 1979,North Carolina,4207000,2806660,66.7,2675064,63.6,131596,4.7
2227,August 1979,North Dakota,464000,300655,64.8,289334,62.4,11321,3.8
2228,August 1979,Ohio,7956000,5053443,63.5,4754171,59.8,299272,5.9
2229,August 1979,Oklahoma,2169000,1319378,60.8,1274468,58.8,44910,3.4
2230,August 1979,Oregon,1931000,1256998,65.1,1174160,60.8,82838,6.6
2231,August 1979,Pennsylvania,9011000,5386483,59.8,5015852,55.7,370631,6.9
2232,August 1979,Rhode Island,720000,461733,64.1,431960,60.0,29773,6.4
2233,August 1979,South Carolina,2176000,1371645,63.0,1305632,60.0,66013,4.8
2234,August 1979,South Dakota,493000,333605,67.7,322748,65.5,10857,3.3
2235,August 1979,Tennessee,3340000,2050772,61.4,1926650,57.7,124122,6.1
2236,August 1979,Texas,9913000,6505104,65.6,6222616,62.8,282488,4.3
2237,August 1979,Utah,933000,610194,65.4,582839,62.5,27355,4.5
2238,August 1979,Vermont,370000,244732,66.1,232394,62.8,12338,5.0
2239,August 1979,Virginia,3833000,2539060,66.2,2421315,63.2,117745,4.6
2240,August 1979,Washington,2954000,1950146,66.0,1823765,61.7,126381,6.5
2241,August 1979,West Virginia,1433000,772938,53.9,717817,50.1,55121,7.1
2242,August 1979,Wisconsin,3426000,2332428,68.1,2227827,65.0,104601,4.5
2243,August 1979,Wyoming,321000,225168,70.1,218896,68.2,6272,2.8
2244,September 1979,Alabama,2799000,1661023,59.3,1540377,55.0,120646,7.3
2245,September 1979,Alaska,259000,183425,70.8,166537,64.3,16888,9.2
2246,September 1979,Arizona,1929000,1159434,60.1,1103839,57.2,55595,4.8
2247,September 1979,Arkansas,1653000,986918,59.7,926785,56.1,60133,6.1
2248,September 1979,California,17310000,11367481,65.7,10661120,61.6,706361,6.2
2249,September 1979,Colorado,2085000,1450186,69.6,1381319,66.3,68867,4.7
2250,September 1979,Connecticut,2345000,1568679,66.9,1490995,63.6,77684,5.0
2251,September 1979,Delaware,440000,281876,64.1,261662,59.5,20214,7.2
2252,September 1979,District of Columbia,500000,328309,65.7,306841,61.4,21468,6.5
2253,September 1979,Florida,7347000,4160344,56.6,3919911,53.4,240433,5.8
2254,September 1979,Georgia,3849000,2476203,64.3,2354574,61.2,121629,4.9
2255,September 1979,Hawaii,649000,428055,66.0,403249,62.1,24806,5.8
2256,September 1979,Idaho,651000,431788,66.3,407317,62.6,24471,5.7
2257,September 1979,Illinois,8431000,5461423,64.8,5160998,61.2,300425,5.5
2258,September 1979,Indiana,3987000,2642135,66.3,2454316,61.6,187819,7.1
2259,September 1979,Iowa,2144000,1422294,66.3,1361521,63.5,60773,4.3
2260,September 1979,Kansas,1724000,1176669,68.3,1137679,66.0,38990,3.3
2261,September 1979,Kentucky,2627000,1630605,62.1,1537382,58.5,93223,5.7
2262,September 1979,Louisiana,2921000,1750063,59.9,1625838,55.7,124225,7.1
2263,September 1979,Maine,821000,501274,61.1,466807,56.9,34467,6.9
2264,September 1979,Maryland,3121000,2121485,68.0,1998924,64.0,122561,5.8
2265,September 1979,Massachusetts,4347000,2856326,65.7,2704332,62.2,151994,5.3
2266,September 1979,Michigan,6734000,4310759,64.0,3958126,58.8,352633,8.2
2267,September 1979,Minnesota,2968000,2064756,69.6,1973901,66.5,90855,4.4
2268,September 1979,Mississippi,1753000,1033328,58.9,973254,55.5,60074,5.8
2269,September 1979,Missouri,3629000,2287359,63.0,2168934,59.8,118425,5.2
2270,September 1979,Montana,573000,374154,65.3,354630,61.9,19524,5.2
2271,September 1979,Nebraska,1140000,768326,67.4,743546,65.2,24780,3.2
2272,September 1979,Nevada,576000,408637,70.9,388120,67.4,20517,5.0
2273,September 1979,New Hampshire,671000,455004,67.8,440096,65.6,14908,3.3
2274,September 1979,New Jersey,5564000,3588171,64.5,3337008,60.0,251163,7.0
2275,September 1979,New Mexico,902000,560092,62.1,524235,58.1,35857,6.4
2276,September 1979,New York,13285000,8034013,60.5,7448242,56.1,585771,7.3
2277,September 1979,North Carolina,4216000,2817075,66.8,2682527,63.6,134548,4.8
2278,September 1979,North Dakota,464000,300827,64.8,289470,62.4,11357,3.8
2279,September 1979,Ohio,7959000,5058005,63.6,4755595,59.8,302410,6.0
2280,September 1979,Oklahoma,2174000,1325062,61.0,1280163,58.9,44899,3.4
2281,September 1979,Oregon,1936000,1261002,65.1,1177933,60.8,83069,6.6
2282,September 1979,Pennsylvania,9014000,5401498,59.9,5025618,55.8,375880,7.0
2283,September 1979,Rhode Island,720000,463083,64.3,433177,60.2,29906,6.5
2284,September 1979,South Carolina,2180000,1375073,63.1,1307008,60.0,68065,4.9
2285,September 1979,South Dakota,493000,334032,67.8,322996,65.5,11036,3.3
2286,September 1979,Tennessee,3347000,2057201,61.5,1933052,57.8,124149,6.0
2287,September 1979,Texas,9943000,6530768,65.7,6248171,62.8,282597,4.3
2288,September 1979,Utah,936000,612357,65.4,584495,62.4,27862,4.5
2289,September 1979,Vermont,370000,245285,66.3,232784,62.9,12501,5.1
2290,September 1979,Virginia,3838000,2546941,66.4,2428755,63.3,118186,4.6
2291,September 1979,Washington,2966000,1955117,65.9,1827323,61.6,127794,6.5
2292,September 1979,West Virginia,1434000,775983,54.1,719372,50.2,56611,7.3
2293,September 1979,Wisconsin,3431000,2340350,68.2,2233931,65.1,106419,4.5
2294,September 1979,Wyoming,323000,226445,70.1,219920,68.1,6525,2.9
2295,October 1979,Alabama,2803000,1663350,59.3,1543103,55.1,120247,7.2
2296,October 1979,Alaska,259000,183587,70.9,166748,64.4,16839,9.2
2297,October 1979,Arizona,1936000,1169321,60.4,1111832,57.4,57489,4.9
2298,October 1979,Arkansas,1655000,987977,59.7,927948,56.1,60029,6.1
2299,October 1979,California,17354000,11407816,65.7,10699686,61.7,708130,6.2
2300,October 1979,Colorado,2089000,1456190,69.7,1386935,66.4,69255,4.8
2301,October 1979,Connecticut,2347000,1573424,67.0,1495075,63.7,78349,5.0
2302,October 1979,Delaware,440000,282730,64.3,262379,59.6,20351,7.2
2303,October 1979,District of Columbia,499000,327660,65.7,306427,61.4,21233,6.5
2304,October 1979,Florida,7376000,4173810,56.6,3936833,53.4,236977,5.7
2305,October 1979,Georgia,3856000,2484341,64.4,2360922,61.2,123419,5.0
2306,October 1979,Hawaii,650000,428876,66.0,404637,62.3,24239,5.7
2307,October 1979,Idaho,652000,433005,66.4,407833,62.6,25172,5.8
2308,October 1979,Illinois,8435000,5483015,65.0,5167243,61.3,315772,5.8
2309,October 1979,Indiana,3990000,2645764,66.3,2450837,61.4,194927,7.4
2310,October 1979,Iowa,2145000,1425201,66.4,1362951,63.5,62250,4.4
2311,October 1979,Kansas,1725000,1180500,68.4,1141134,66.2,39366,3.3
2312,October 1979,Kentucky,2630000,1633338,62.1,1539206,58.5,94132,5.8
2313,October 1979,Louisiana,2927000,1760954,60.2,1636517,55.9,124437,7.1
2314,October 1979,Maine,821000,502937,61.3,468322,57.0,34615,6.9
2315,October 1979,Maryland,3123000,2123593,68.0,2001712,64.1,121881,5.7
2316,October 1979,Massachusetts,4349000,2858732,65.7,2706446,62.2,152286,5.3
2317,October 1979,Michigan,6739000,4313919,64.0,3947190,58.6,366729,8.5
2318,October 1979,Minnesota,2973000,2071377,69.7,1977432,66.5,93945,4.5
2319,October 1979,Mississippi,1755000,1036479,59.1,974352,55.5,62127,6.0
2320,October 1979,Missouri,3633000,2292215,63.1,2169529,59.7,122686,5.4
2321,October 1979,Montana,573000,374539,65.4,354893,61.9,19646,5.2
2322,October 1979,Nebraska,1141000,768780,67.4,744034,65.2,24746,3.2
2323,October 1979,Nevada,579000,411311,71.0,391024,67.5,20287,4.9
2324,October 1979,New Hampshire,673000,456797,67.9,441414,65.6,15383,3.4
2325,October 1979,New Jersey,5567000,3593967,64.6,3345026,60.1,248941,6.9
2326,October 1979,New Mexico,904000,561471,62.1,525003,58.1,36468,6.5
2327,October 1979,New York,13286000,8044467,60.5,7456960,56.1,587507,7.3
2328,October 1979,North Carolina,4225000,2827308,66.9,2689701,63.7,137607,4.9
2329,October 1979,North Dakota,465000,300906,64.7,289353,62.2,11553,3.8
2330,October 1979,Ohio,7963000,5059841,63.5,4756296,59.7,303545,6.0
2331,October 1979,Oklahoma,2179000,1329946,61.0,1285416,59.0,44530,3.3
2332,October 1979,Oregon,1941000,1264829,65.2,1182050,60.9,82779,6.5
2333,October 1979,Pennsylvania,9017000,5416194,60.1,5035975,55.8,380219,7.0
2334,October 1979,Rhode Island,719000,464509,64.6,434319,60.4,30190,6.5
2335,October 1979,South Carolina,2185000,1378811,63.1,1308388,59.9,70423,5.1
2336,October 1979,South Dakota,494000,334491,67.7,323191,65.4,11300,3.4
2337,October 1979,Tennessee,3353000,2062904,61.5,1939164,57.8,123740,6.0
2338,October 1979,Texas,9974000,6556039,65.7,6272510,62.9,283529,4.3
2339,October 1979,Utah,939000,614286,65.4,585803,62.4,28483,4.6
2340,October 1979,Vermont,371000,245924,66.3,233226,62.9,12698,5.2
2341,October 1979,Virginia,3843000,2553107,66.4,2435254,63.4,117853,4.6
2342,October 1979,Washington,2977000,1959464,65.8,1829800,61.5,129664,6.6
2343,October 1979,West Virginia,1435000,778594,54.3,720655,50.2,57939,7.4
2344,October 1979,Wisconsin,3437000,2347106,68.3,2238363,65.1,108743,4.6
2345,October 1979,Wyoming,324000,227633,70.3,220822,68.2,6811,3.0
2346,November 1979,Alabama,2806000,1664951,59.3,1545207,55.1,119744,7.2
2347,November 1979,Alaska,260000,183887,70.7,167118,64.3,16769,9.1
2348,November 1979,Arizona,1944000,1179665,60.7,1119450,57.6,60215,5.1
2349,November 1979,Arkansas,1657000,989285,59.7,929439,56.1,59846,6.0
2350,November 1979,California,17397000,11437692,65.7,10732056,61.7,705636,6.2
2351,November 1979,Colorado,2093000,1461281,69.8,1392049,66.5,69232,4.7
2352,November 1979,Connecticut,2350000,1577899,67.1,1498655,63.8,79244,5.0
2353,November 1979,Delaware,440000,283258,64.4,262906,59.8,20352,7.2
2354,November 1979,District of Columbia,498000,326792,65.6,305732,61.4,21060,6.4
2355,November 1979,Florida,7405000,4186531,56.5,3953754,53.4,232777,5.6
2356,November 1979,Georgia,3864000,2491467,64.5,2366338,61.2,125129,5.0
2357,November 1979,Hawaii,652000,429918,65.9,406240,62.3,23678,5.5
2358,November 1979,Idaho,653000,433911,66.4,407969,62.5,25942,6.0
2359,November 1979,Illinois,8439000,5501644,65.2,5170104,61.3,331540,6.0
2360,November 1979,Indiana,3993000,2646575,66.3,2445896,61.3,200679,7.6
2361,November 1979,Iowa,2146000,1428064,66.5,1364504,63.6,63560,4.5
2362,November 1979,Kansas,1727000,1183454,68.5,1143606,66.2,39848,3.4
2363,November 1979,Kentucky,2632000,1634995,62.1,1539529,58.5,95466,5.8
2364,November 1979,Louisiana,2934000,1769447,60.3,1646020,56.1,123427,7.0
2365,November 1979,Maine,822000,504112,61.3,469455,57.1,34657,6.9
2366,November 1979,Maryland,3125000,2125675,68.0,2004417,64.1,121258,5.7
2367,November 1979,Massachusetts,4352000,2860145,65.7,2707986,62.2,152159,5.3
2368,November 1979,Michigan,6744000,4314777,64.0,3934367,58.3,380410,8.8
2369,November 1979,Minnesota,2978000,2077588,69.8,1980065,66.5,97523,4.7
2370,November 1979,Mississippi,1757000,1040031,59.2,976217,55.6,63814,6.1
2371,November 1979,Missouri,3637000,2295672,63.1,2169229,59.6,126443,5.5
2372,November 1979,Montana,573000,374958,65.4,355129,62.0,19829,5.3
2373,November 1979,Nebraska,1142000,769220,67.4,744639,65.2,24581,3.2
2374,November 1979,Nevada,583000,413727,71.0,393610,67.5,20117,4.9
2375,November 1979,New Hampshire,674000,458489,68.0,442773,65.7,15716,3.4
2376,November 1979,New Jersey,5570000,3595316,64.5,3351857,60.2,243459,6.8
2377,November 1979,New Mexico,906000,562440,62.1,525403,58.0,37037,6.6
2378,November 1979,New York,13287000,8046086,60.6,7461673,56.2,584413,7.3
2379,November 1979,North Carolina,4234000,2835694,67.0,2695440,63.7,140254,4.9
2380,November 1979,North Dakota,465000,300962,64.7,289123,62.2,11839,3.9
2381,November 1979,Ohio,7967000,5057914,63.5,4755289,59.7,302625,6.0
2382,November 1979,Oklahoma,2184000,1334056,61.1,1290139,59.1,43917,3.3
2383,November 1979,Oregon,1946000,1268295,65.2,1186276,61.0,82019,6.5
2384,November 1979,Pennsylvania,9020000,5428217,60.2,5045457,55.9,382760,7.1
2385,November 1979,Rhode Island,719000,465898,64.8,435254,60.5,30644,6.6
2386,November 1979,South Carolina,2189000,1382133,63.1,1309807,59.8,72326,5.2
2387,November 1979,South Dakota,494000,334940,67.8,323317,65.4,11623,3.5
2388,November 1979,Tennessee,3360000,2067523,61.5,1944036,57.9,123487,6.0
2389,November 1979,Texas,10005000,6581769,65.8,6295448,62.9,286321,4.4
2390,November 1979,Utah,942000,616305,65.4,586967,62.3,29338,4.8
2391,November 1979,Vermont,372000,246570,66.3,233669,62.8,12901,5.2
2392,November 1979,Virginia,3848000,2556456,66.4,2439933,63.4,116523,4.6
2393,November 1979,Washington,2988000,1963474,65.7,1831706,61.3,131768,6.7
2394,November 1979,West Virginia,1436000,780758,54.4,721421,50.2,59337,7.6
2395,November 1979,Wisconsin,3442000,2351669,68.3,2240158,65.1,111511,4.7
2396,November 1979,Wyoming,326000,228710,70.2,221609,68.0,7101,3.1
2397,December 1979,Alabama,2809000,1666044,59.3,1546087,55.0,119957,7.2
2398,December 1979,Alaska,260000,184357,70.9,167607,64.5,16750,9.1
2399,December 1979,Arizona,1951000,1190048,61.0,1126195,57.7,63853,5.4
2400,December 1979,Arkansas,1659000,990904,59.7,930868,56.1,60036,6.1
2401,December 1979,California,17441000,11459312,65.7,10756724,61.7,702588,6.1
2402,December 1979,Colorado,2098000,1465918,69.9,1396744,66.6,69174,4.7
2403,December 1979,Connecticut,2352000,1581752,67.3,1501565,63.8,80187,5.1
2404,December 1979,Delaware,439000,283390,64.6,263176,59.9,20214,7.1
2405,December 1979,District of Columbia,497000,325915,65.6,304966,61.4,20949,6.4
2406,December 1979,Florida,7434000,4198924,56.5,3969198,53.4,229726,5.5
2407,December 1979,Georgia,3871000,2498072,64.5,2370401,61.2,127671,5.1
2408,December 1979,Hawaii,654000,431236,65.9,408161,62.4,23075,5.4
2409,December 1979,Idaho,654000,434295,66.4,407475,62.3,26820,6.2
2410,December 1979,Illinois,8444000,5516566,65.3,5169767,61.2,346799,6.3
2411,December 1979,Indiana,3996000,2645461,66.2,2439157,61.0,206304,7.8
2412,December 1979,Iowa,2146000,1430579,66.7,1365755,63.6,64824,4.5
2413,December 1979,Kansas,1729000,1185506,68.6,1144742,66.2,40764,3.4
2414,December 1979,Kentucky,2635000,1636511,62.1,1538616,58.4,97895,6.0
2415,December 1979,Louisiana,2941000,1775044,60.4,1653058,56.2,121986,6.9
2416,December 1979,Maine,822000,504859,61.4,470140,57.2,34719,6.9
2417,December 1979,Maryland,3126000,2128322,68.1,2006767,64.2,121555,5.7
2418,December 1979,Massachusetts,4354000,2860694,65.7,2708829,62.2,151865,5.3
2419,December 1979,Michigan,6749000,4313929,63.9,3917534,58.0,396395,9.2
2420,December 1979,Minnesota,2982000,2083406,69.9,1981965,66.5,101441,4.9
2421,December 1979,Mississippi,1759000,1044021,59.4,978859,55.6,65162,6.2
2422,December 1979,Missouri,3641000,2297685,63.1,2167641,59.5,130044,5.7
2423,December 1979,Montana,573000,375405,65.5,355269,62.0,20136,5.4
2424,December 1979,Nebraska,1143000,769553,67.3,745093,65.2,24460,3.2
2425,December 1979,Nevada,586000,415856,71.0,395699,67.5,20157,4.8
2426,December 1979,New Hampshire,675000,460010,68.1,443989,65.8,16021,3.5
2427,December 1979,New Jersey,5573000,3593971,64.5,3356934,60.2,237037,6.6
2428,December 1979,New Mexico,908000,563059,62.0,525440,57.9,37619,6.7
2429,December 1979,New York,13288000,8040294,60.5,7460829,56.1,579465,7.2
2430,December 1979,North Carolina,4243000,2842242,67.0,2699034,63.6,143208,5.0
2431,December 1979,North Dakota,465000,301077,64.7,288964,62.1,12113,4.0
2432,December 1979,Ohio,7970000,5054867,63.4,4751575,59.6,303292,6.0
2433,December 1979,Oklahoma,2189000,1337649,61.1,1294204,59.1,43445,3.2
2434,December 1979,Oregon,1951000,1271900,65.2,1189898,61.0,82002,6.4
2435,December 1979,Pennsylvania,9023000,5436940,60.3,5052287,56.0,384653,7.1
2436,December 1979,Rhode Island,719000,467117,65.0,435923,60.6,31194,6.7
2437,December 1979,South Carolina,2194000,1384755,63.1,1311202,59.8,73553,5.3
2438,December 1979,South Dakota,494000,335383,67.9,323352,65.5,12031,3.6
2439,December 1979,Tennessee,3366000,2071011,61.5,1946863,57.8,124148,6.0
2440,December 1979,Texas,10035000,6609263,65.9,6316803,62.9,292460,4.4
2441,December 1979,Utah,945000,618661,65.5,588238,62.2,30423,4.9
2442,December 1979,Vermont,373000,247170,66.3,234066,62.8,13104,5.3
2443,December 1979,Virginia,3853000,2557218,66.4,2442148,63.4,115070,4.5
2444,December 1979,Washington,3000000,1967356,65.6,1833162,61.1,134194,6.8
2445,December 1979,West Virginia,1437000,782584,54.5,721633,50.2,60951,7.8
2446,December 1979,Wisconsin,3447000,2354066,68.3,2238443,64.9,115623,4.9
2447,December 1979,Wyoming,327000,229690,70.2,222323,68.0,7367,3.2
2448,January 1980,Alabama,2812000,1666594,59.3,1545102,54.9,121492,7.3
2449,January 1980,Alaska,261000,184951,70.9,168115,64.4,16836,9.1
2450,January 1980,Arizona,1959000,1199875,61.2,1131550,57.8,68325,5.7
2451,January 1980,Arkansas,1661000,992602,59.8,931492,56.1,61110,6.2
2452,January 1980,California,17485000,11475997,65.6,10771482,61.6,704515,6.1
2453,January 1980,Colorado,2102000,1470282,69.9,1400615,66.6,69667,4.7
2454,January 1980,Connecticut,2355000,1584557,67.3,1503361,63.8,81196,5.1
2455,January 1980,Delaware,439000,283209,64.5,263181,60.0,20028,7.1
2456,January 1980,District of Columbia,495000,325218,65.7,304283,61.5,20935,6.4
2457,January 1980,Florida,7463000,4210270,56.4,3980580,53.3,229690,5.5
2458,January 1980,Georgia,3879000,2504584,64.6,2372221,61.2,132363,5.3
2459,January 1980,Hawaii,656000,432730,66.0,410280,62.5,22450,5.2
2460,January 1980,Idaho,655000,433983,66.3,406044,62.0,27939,6.4
2461,January 1980,Illinois,8448000,5527858,65.4,5165643,61.1,362215,6.6
2462,January 1980,Indiana,4000000,2643812,66.1,2429913,60.7,213899,8.1
2463,January 1980,Iowa,2147000,1432696,66.7,1366013,63.6,66683,4.7
2464,January 1980,Kansas,1731000,1186808,68.6,1144402,66.1,42406,3.6
2465,January 1980,Kentucky,2637000,1638679,62.1,1536646,58.3,102033,6.2
2466,January 1980,Louisiana,2948000,1777343,60.3,1656635,56.2,120708,6.8
2467,January 1980,Maine,822000,505405,61.5,470433,57.2,34972,6.9
2468,January 1980,Maryland,3128000,2131570,68.1,2007990,64.2,123580,5.8
2469,January 1980,Massachusetts,4357000,2860287,65.6,2708207,62.2,152080,5.3
2470,January 1980,Michigan,6753000,4312467,63.9,3893661,57.7,418806,9.7
2471,January 1980,Minnesota,2987000,2088673,69.9,1983093,66.4,105580,5.1
2472,January 1980,Mississippi,1760000,1048126,59.6,981537,55.8,66589,6.4
2473,January 1980,Missouri,3645000,2298482,63.1,2163901,59.4,134581,5.9
2474,January 1980,Montana,573000,375699,65.6,355143,62.0,20556,5.5
2475,January 1980,Nebraska,1143000,769732,67.3,745059,65.2,24673,3.2
2476,January 1980,Nevada,589000,417663,70.9,397125,67.4,20538,4.9
2477,January 1980,New Hampshire,676000,461317,68.2,444850,65.8,16467,3.6
2478,January 1980,New Jersey,5575000,3591186,64.4,3358678,60.2,232508,6.5
2479,January 1980,New Mexico,911000,563382,61.8,525066,57.6,38316,6.8
2480,January 1980,New York,13290000,8028702,60.4,7452203,56.1,576499,7.2
2481,January 1980,North Carolina,4252000,2847007,67.0,2699371,63.5,147636,5.2
2482,January 1980,North Dakota,465000,301266,64.8,288889,62.1,12377,4.1
2483,January 1980,Ohio,7974000,5053919,63.4,4743072,59.5,310847,6.2
2484,January 1980,Oklahoma,2194000,1340634,61.1,1297081,59.1,43553,3.2
2485,January 1980,Oregon,1955000,1276153,65.3,1192015,61.0,84138,6.6
2486,January 1980,Pennsylvania,9026000,5441419,60.3,5053355,56.0,388064,7.1
2487,January 1980,Rhode Island,719000,468068,65.1,436278,60.7,31790,6.8
2488,January 1980,South Carolina,2199000,1386955,63.1,1312179,59.7,74776,5.4
2489,January 1980,South Dakota,494000,335756,68.0,323169,65.4,12587,3.7
2490,January 1980,Tennessee,3372000,2072929,61.5,1946630,57.7,126299,6.1
2491,January 1980,Texas,10066000,6637791,65.9,6335078,62.9,302713,4.6
2492,January 1980,Utah,948000,621442,65.6,589704,62.2,31738,5.1
2493,January 1980,Vermont,373000,247648,66.4,234308,62.8,13340,5.4
2494,January 1980,Virginia,3858000,2555905,66.2,2441154,63.3,114751,4.5
2495,January 1980,Washington,3011000,1970995,65.5,1833580,60.9,137415,7.0
2496,January 1980,West Virginia,1438000,783947,54.5,721196,50.2,62751,8.0
2497,January 1980,Wisconsin,3452000,2354564,68.2,2232506,64.7,122058,5.2
2498,January 1980,Wyoming,329000,230599,70.1,222990,67.8,7609,3.3
2499,February 1980,Alabama,2815000,1666602,59.2,1541785,54.8,124817,7.5
2500,February 1980,Alaska,261000,185625,71.1,168552,64.6,17073,9.2
2501,February 1980,Arizona,1966000,1208477,61.5,1135235,57.7,73242,6.1
2502,February 1980,Arkansas,1663000,994149,59.8,930776,56.0,63373,6.4
2503,February 1980,California,17528000,11490920,65.6,10775347,61.5,715573,6.2
2504,February 1980,Colorado,2106000,1474693,70.0,1403225,66.6,71468,4.8
2505,February 1980,Connecticut,2357000,1586212,67.3,1503701,63.8,82511,5.2
2506,February 1980,Delaware,439000,282926,64.4,262975,59.9,19951,7.1
2507,February 1980,District of Columbia,494000,324833,65.8,303773,61.5,21060,6.5
2508,February 1980,Florida,7491000,4219406,56.3,3986257,53.2,233149,5.5
2509,February 1980,Georgia,3886000,2511458,64.6,2371310,61.0,140148,5.6
2510,February 1980,Hawaii,657000,434206,66.1,412358,62.8,21848,5.0
2511,February 1980,Idaho,655000,433076,66.1,403713,61.6,29363,6.8
2512,February 1980,Illinois,8452000,5536017,65.5,5156497,61.0,379520,6.9
2513,February 1980,Indiana,4003000,2642605,66.0,2417618,60.4,224987,8.5
2514,February 1980,Iowa,2148000,1434587,66.8,1364847,63.5,69740,4.9
2515,February 1980,Kansas,1733000,1187614,68.5,1142755,65.9,44859,3.8
2516,February 1980,Kentucky,2640000,1641478,62.2,1533609,58.1,107869,6.6
2517,February 1980,Louisiana,2955000,1776694,60.1,1656961,56.1,119733,6.7
2518,February 1980,Maine,823000,505790,61.5,470257,57.1,35533,7.0
2519,February 1980,Maryland,3130000,2135312,68.2,2007631,64.1,127681,6.0
2520,February 1980,Massachusetts,4359000,2859235,65.6,2705679,62.1,153556,5.4
2521,February 1980,Michigan,6758000,4311656,63.8,3861737,57.1,449919,10.4
2522,February 1980,Minnesota,2992000,2093427,70.0,1983277,66.3,110150,5.3
2523,February 1980,Mississippi,1762000,1051833,59.7,983340,55.8,68493,6.5
2524,February 1980,Missouri,3648000,2298451,63.0,2157488,59.1,140963,6.1
2525,February 1980,Montana,573000,375682,65.6,354621,61.9,21061,5.6
2526,February 1980,Nebraska,1144000,769759,67.3,744322,65.1,25437,3.3
2527,February 1980,Nevada,593000,419176,70.7,397851,67.1,21325,5.1
2528,February 1980,New Hampshire,677000,462481,68.3,445267,65.8,17214,3.7
2529,February 1980,New Jersey,5578000,3588284,64.3,3356017,60.2,232267,6.5
2530,February 1980,New Mexico,913000,563464,61.7,524303,57.4,39161,7.0
2531,February 1980,New York,13291000,8012458,60.3,7434606,55.9,577852,7.2
2532,February 1980,North Carolina,4261000,2850206,66.9,2695353,63.3,154853,5.4
2533,February 1980,North Dakota,465000,301513,64.8,288772,62.1,12741,4.2
2534,February 1980,Ohio,7978000,5057615,63.4,4728275,59.3,329340,6.5
2535,February 1980,Oklahoma,2199000,1342783,61.1,1298295,59.0,44488,3.3
2536,February 1980,Oregon,1960000,1281308,65.4,1192007,60.8,89301,7.0
2537,February 1980,Pennsylvania,9029000,5442032,60.3,5046347,55.9,395685,7.3
2538,February 1980,Rhode Island,718000,468552,65.3,436238,60.8,32314,6.9
2539,February 1980,South Carolina,2203000,1389421,63.1,1312122,59.6,77299,5.6
2540,February 1980,South Dakota,495000,335968,67.9,322630,65.2,13338,4.0
2541,February 1980,Tennessee,3379000,2073587,61.4,1943164,57.5,130423,6.3
2542,February 1980,Texas,10097000,6664900,66.0,6348569,62.9,316331,4.7
2543,February 1980,Utah,951000,624321,65.6,591078,62.2,33243,5.3
2544,February 1980,Vermont,374000,248010,66.3,234326,62.7,13684,5.5
2545,February 1980,Virginia,3863000,2553641,66.1,2436777,63.1,116864,4.6
2546,February 1980,Washington,3023000,1974341,65.3,1832320,60.6,142021,7.2
2547,February 1980,West Virginia,1439000,784805,54.5,720029,50.0,64776,8.3
2548,February 1980,Wisconsin,3457000,2353577,68.1,2222732,64.3,130845,5.6
2549,February 1980,Wyoming,330000,231428,70.1,223601,67.8,7827,3.4
2550,March 1980,Alabama,2818000,1666667,59.1,1536128,54.5,130539,7.8
2551,March 1980,Alaska,262000,186373,71.1,168902,64.5,17471,9.4
2552,March 1980,Arizona,1974000,1215704,61.6,1137477,57.6,78227,6.4
2553,March 1980,Arkansas,1665000,995492,59.8,928681,55.8,66811,6.7
2554,March 1980,California,17572000,11507409,65.5,10770415,61.3,736994,6.4
2555,March 1980,Colorado,2111000,1479234,70.1,1404421,66.5,74813,5.1
2556,March 1980,Connecticut,2360000,1587021,67.2,1502517,63.7,84504,5.3
2557,March 1980,Delaware,439000,282778,64.4,262653,59.8,20125,7.1
2558,March 1980,District of Columbia,493000,324788,65.9,303440,61.5,21348,6.6
2559,March 1980,Florida,7520000,4226343,56.2,3986769,53.0,239574,5.7
2560,March 1980,Georgia,3894000,2519056,64.7,2368170,60.8,150886,6.0
2561,March 1980,Hawaii,659000,435491,66.1,414130,62.8,21361,4.9
2562,March 1980,Idaho,656000,431850,65.8,400871,61.1,30979,7.2
2563,March 1980,Illinois,8457000,5542657,65.5,5142025,60.8,400632,7.2
2564,March 1980,Indiana,4006000,2641722,65.9,2402389,60.0,239333,9.1
2565,March 1980,Iowa,2148000,1436394,66.9,1362017,63.4,74377,5.2
2566,March 1980,Kansas,1735000,1188247,68.5,1140282,65.7,47965,4.0
2567,March 1980,Kentucky,2642000,1644595,62.2,1529824,57.9,114771,7.0
2568,March 1980,Louisiana,2961000,1774359,59.9,1655470,55.9,118889,6.7
2569,March 1980,Maine,823000,505948,61.5,469557,57.1,36391,7.2
2570,March 1980,Maryland,3132000,2139573,68.3,2006271,64.1,133302,6.2
2571,March 1980,Massachusetts,4362000,2858359,65.5,2701843,61.9,156516,5.5
2572,March 1980,Michigan,6763000,4312171,63.8,3824771,56.6,487400,11.3
2573,March 1980,Minnesota,2997000,2097618,70.0,1982529,66.2,115089,5.5
2574,March 1980,Mississippi,1764000,1054900,59.8,983854,55.8,71046,6.7
2575,March 1980,Missouri,3652000,2298603,62.9,2149178,58.8,149425,6.5
2576,March 1980,Montana,573000,375380,65.5,353751,61.7,21629,5.8
2577,March 1980,Nebraska,1145000,769719,67.2,742935,64.9,26784,3.5
2578,March 1980,Nevada,596000,420579,70.6,398042,66.8,22537,5.4
2579,March 1980,New Hampshire,678000,463665,68.4,445328,65.7,18337,4.0
2580,March 1980,New Jersey,5581000,3586752,64.3,3349330,60.0,237422,6.6
2581,March 1980,New Mexico,915000,563443,61.6,523352,57.2,40091,7.1
2582,March 1980,New York,13292000,7993688,60.1,7409844,55.7,583844,7.3
2583,March 1980,North Carolina,4270000,2852358,66.8,2687046,62.9,165312,5.8
2584,March 1980,North Dakota,465000,301805,64.9,288519,62.0,13286,4.4
2585,March 1980,Ohio,7981000,5066859,63.5,4707653,59.0,359206,7.1
2586,March 1980,Oklahoma,2204000,1344254,61.0,1297998,58.9,46256,3.4
2587,March 1980,Oregon,1965000,1287054,65.5,1189965,60.6,97089,7.5
2588,March 1980,Pennsylvania,9032000,5441036,60.2,5031810,55.7,409226,7.5
2589,March 1980,Rhode Island,718000,468531,65.3,435784,60.7,32747,7.0
2590,March 1980,South Carolina,2208000,1392677,63.1,1310880,59.4,81797,5.9
2591,March 1980,South Dakota,495000,335992,67.9,321720,65.0,14272,4.2
2592,March 1980,Tennessee,3385000,2074107,61.3,1937349,57.2,136758,6.6
2593,March 1980,Texas,10127000,6688533,66.0,6357152,62.8,331381,5.0
2594,March 1980,Utah,953000,626716,65.8,591829,62.1,34887,5.6
2595,March 1980,Vermont,375000,248345,66.2,234166,62.4,14179,5.7
2596,March 1980,Virginia,3868000,2551823,66.0,2429881,62.8,121942,4.8
2597,March 1980,Washington,3034000,1977307,65.2,1829358,60.3,147949,7.5
2598,March 1980,West Virginia,1440000,785327,54.5,718056,49.9,67271,8.6
2599,March 1980,Wisconsin,3462000,2351895,67.9,2210616,63.9,141279,6.0
2600,March 1980,Wyoming,331000,232206,70.2,224164,67.7,8042,3.5
2601,April 1980,Alabama,2822000,1666794,59.1,1528732,54.2,138062,8.3
2602,April 1980,Alaska,262000,187132,71.4,169170,64.6,17962,9.6
2603,April 1980,Arizona,1981000,1221587,61.7,1138920,57.5,82667,6.8
2604,April 1980,Arkansas,1667000,996535,59.8,925651,55.5,70884,7.1
2605,April 1980,California,17615000,11526649,65.4,10761561,61.1,765088,6.6
2606,April 1980,Colorado,2115000,1483866,70.2,1404408,66.4,79458,5.4
2607,April 1980,Connecticut,2362000,1587505,67.2,1500222,63.5,87283,5.5
2608,April 1980,Delaware,439000,282899,64.4,262306,59.8,20593,7.3
2609,April 1980,District of Columbia,492000,324900,66.0,303087,61.6,21813,6.7
2610,April 1980,Florida,7549000,4232383,56.1,3984610,52.8,247773,5.9
2611,April 1980,Georgia,3901000,2526722,64.8,2364139,60.6,162583,6.4
2612,April 1980,Hawaii,661000,436513,66.0,415358,62.8,21155,4.8
2613,April 1980,Idaho,657000,430482,65.5,397941,60.6,32541,7.6
2614,April 1980,Illinois,8461000,5548404,65.6,5124072,60.6,424332,7.6
2615,April 1980,Indiana,4009000,2640200,65.9,2385471,59.5,254729,9.6
2616,April 1980,Iowa,2149000,1437993,66.9,1357605,63.2,80388,5.6
2617,April 1980,Kansas,1736000,1188810,68.5,1137535,65.5,51275,4.3
2618,April 1980,Kentucky,2645000,1647859,62.3,1526006,57.7,121853,7.4
2619,April 1980,Louisiana,2968000,1771777,59.7,1653934,55.7,117843,6.7
2620,April 1980,Maine,824000,505938,61.4,468471,56.9,37467,7.4
2621,April 1980,Maryland,3133000,2143654,68.4,2004557,64.0,139097,6.5
2622,April 1980,Massachusetts,4364000,2857966,65.5,2697887,61.8,160079,5.6
2623,April 1980,Michigan,6768000,4312461,63.7,3787718,56.0,524743,12.2
2624,April 1980,Minnesota,3002000,2101069,70.0,1981174,66.0,119895,5.7
2625,April 1980,Mississippi,1766000,1056963,59.9,983145,55.7,73818,7.0
2626,April 1980,Missouri,3656000,2299462,62.9,2140626,58.6,158836,6.9
2627,April 1980,Montana,573000,374785,65.4,352582,61.5,22203,5.9
2628,April 1980,Nebraska,1146000,769679,67.2,741139,64.7,28540,3.7
2629,April 1980,Nevada,600000,422154,70.4,398075,66.3,24079,5.7
2630,April 1980,New Hampshire,680000,464864,68.4,445102,65.5,19762,4.3
2631,April 1980,New Jersey,5584000,3586728,64.2,3340318,59.8,246410,6.9
2632,April 1980,New Mexico,917000,563491,61.4,522444,57.0,41047,7.3
2633,April 1980,New York,13293000,7975051,60.0,7382931,55.5,592120,7.4
2634,April 1980,North Carolina,4279000,2853483,66.7,2676067,62.5,177416,6.2
2635,April 1980,North Dakota,466000,302117,64.8,288096,61.8,14021,4.6
2636,April 1980,Ohio,7985000,5079532,63.6,4683514,58.7,396018,7.8
2637,April 1980,Oklahoma,2209000,1345632,60.9,1297112,58.7,48520,3.6
2638,April 1980,Oregon,1970000,1292615,65.6,1186650,60.2,105965,8.2
2639,April 1980,Pennsylvania,9036000,5439158,60.2,5012102,55.5,427056,7.9
2640,April 1980,Rhode Island,718000,468194,65.2,434997,60.6,33197,7.1
2641,April 1980,South Carolina,2212000,1396536,63.1,1308866,59.2,87670,6.3
2642,April 1980,South Dakota,495000,335815,67.8,320538,64.8,15277,4.5
2643,April 1980,Tennessee,3392000,2074969,61.2,1930639,56.9,144330,7.0
2644,April 1980,Texas,10158000,6706951,66.0,6362265,62.6,344686,5.1
2645,April 1980,Utah,956000,628294,65.7,591741,61.9,36553,5.8
2646,April 1980,Vermont,376000,248736,66.2,233934,62.2,14802,6.0
2647,April 1980,Virginia,3873000,2551419,65.9,2422424,62.5,128995,5.1
2648,April 1980,Washington,3045000,1979341,65.0,1825184,59.9,154157,7.8
2649,April 1980,West Virginia,1442000,785690,54.5,715416,49.6,70274,8.9
2650,April 1980,Wisconsin,3468000,2349824,67.8,2198074,63.4,151750,6.5
2651,April 1980,Wyoming,333000,232968,70.0,224707,67.5,8261,3.5
2652,May 1980,Alabama,2825000,1666872,59.0,1520782,53.8,146090,8.8
2653,May 1980,Alaska,263000,187785,71.4,169355,64.4,18430,9.8
2654,May 1980,Arizona,1986000,1226105,61.7,1140128,57.4,85977,7.0
2655,May 1980,Arkansas,1668000,997305,59.8,922449,55.3,74856,7.5
2656,May 1980,California,17646000,11548406,65.4,10754094,60.9,794312,6.9
2657,May 1980,Colorado,2120000,1488455,70.2,1403676,66.2,84779,5.7
2658,May 1980,Connecticut,2364000,1587983,67.2,1497480,63.3,90503,5.7
2659,May 1980,Delaware,439000,283267,64.5,261995,59.7,21272,7.5
2660,May 1980,District of Columbia,492000,324836,66.0,302403,61.5,22433,6.9
2661,May 1980,Florida,7574000,4239330,56.0,3982923,52.6,256407,6.0
2662,May 1980,Georgia,3909000,2533536,64.8,2360789,60.4,172747,6.8
2663,May 1980,Hawaii,662000,437355,66.1,416025,62.8,21330,4.9
2664,May 1980,Idaho,658000,429129,65.2,395352,60.1,33777,7.9
2665,May 1980,Illinois,8466000,5553271,65.6,5105610,60.3,447661,8.1
2666,May 1980,Indiana,4011000,2637104,65.7,2369036,59.1,268068,10.2
2667,May 1980,Iowa,2150000,1439286,66.9,1352381,62.9,86905,6.0
2668,May 1980,Kansas,1737000,1189111,68.5,1134929,65.3,54182,4.6
2669,May 1980,Kentucky,2647000,1651513,62.4,1522888,57.5,128625,7.8
2670,May 1980,Louisiana,2973000,1770519,59.6,1653605,55.6,116914,6.6
2671,May 1980,Maine,825000,505815,61.3,467226,56.6,38589,7.6
2672,May 1980,Maryland,3137000,2147069,68.4,2003045,63.9,144024,6.7
2673,May 1980,Massachusetts,4368000,2858502,65.4,2695062,61.7,163440,5.7
2674,May 1980,Michigan,6769000,4311401,63.7,3755447,55.5,555954,12.9
2675,May 1980,Minnesota,3005000,2103788,70.0,1979682,65.9,124106,5.9
2676,May 1980,Mississippi,1768000,1057819,59.8,981433,55.5,76386,7.2
2677,May 1980,Missouri,3658000,2301261,62.9,2133304,58.3,167957,7.3
2678,May 1980,Montana,574000,374056,65.2,351317,61.2,22739,6.1
2679,May 1980,Nebraska,1147000,769672,67.1,739307,64.5,30365,3.9
2680,May 1980,Nevada,602000,424107,70.4,398389,66.2,25718,6.1
2681,May 1980,New Hampshire,681000,465966,68.4,444711,65.3,21255,4.6
2682,May 1980,New Jersey,5590000,3587806,64.2,3331022,59.6,256784,7.2
2683,May 1980,New Mexico,919000,563727,61.3,521699,56.8,42028,7.5
2684,May 1980,New York,13300000,7959384,59.8,7359185,55.3,600199,7.5
2685,May 1980,North Carolina,4285000,2853707,66.6,2664880,62.2,188827,6.6
2686,May 1980,North Dakota,466000,302432,64.9,287580,61.7,14852,4.9
2687,May 1980,Ohio,7989000,5092410,63.7,4659273,58.3,433137,8.5
2688,May 1980,Oklahoma,2213000,1347660,60.9,1296860,58.6,50800,3.8
2689,May 1980,Oregon,1972000,1297290,65.8,1183222,60.0,114068,8.8
2690,May 1980,Pennsylvania,9041000,5436732,60.1,4991213,55.2,445519,8.2
2691,May 1980,Rhode Island,719000,467792,65.1,434097,60.4,33695,7.2
2692,May 1980,South Carolina,2216000,1400747,63.2,1306737,59.0,94010,6.7
2693,May 1980,South Dakota,495000,335454,67.8,319262,64.5,16192,4.8
2694,May 1980,Tennessee,3395000,2076660,61.2,1924564,56.7,152096,7.3
2695,May 1980,Texas,10185000,6720742,66.0,6366680,62.5,354062,5.3
2696,May 1980,Utah,958000,629188,65.7,591027,61.7,38161,6.1
2697,May 1980,Vermont,376000,249230,66.3,233738,62.2,15492,6.2
2698,May 1980,Virginia,3879000,2552681,65.8,2416446,62.3,136235,5.3
2699,May 1980,Washington,3051000,1980289,64.9,1820640,59.7,159649,8.1
2700,May 1980,West Virginia,1443000,785962,54.5,712543,49.4,73419,9.3
2701,May 1980,Wisconsin,3471000,2346900,67.6,2186633,63.0,160267,6.8
2702,May 1980,Wyoming,334000,233776,70.0,225272,67.4,8504,3.6
2703,June 1980,Alabama,2828000,1667196,59.0,1513892,53.5,153304,9.2
2704,June 1980,Alaska,263000,188217,71.6,169468,64.4,18749,10.0
2705,June 1980,Arizona,1991000,1229764,61.8,1141836,57.3,87928,7.1
2706,June 1980,Arkansas,1670000,997950,59.8,919849,55.1,78101,7.8
2707,June 1980,California,17678000,11573267,65.5,10753605,60.8,819662,7.1
2708,June 1980,Colorado,2125000,1492946,70.3,1403093,66.0,89853,6.0
2709,June 1980,Connecticut,2367000,1588708,67.1,1495016,63.2,93692,5.9
2710,June 1980,Delaware,440000,283771,64.5,261785,59.5,21986,7.7
2711,June 1980,District of Columbia,491000,324376,66.1,301206,61.3,23170,7.1
2712,June 1980,Florida,7599000,4250168,55.9,3985850,52.5,264318,6.2
2713,June 1980,Georgia,3916000,2539209,64.8,2359875,60.3,179334,7.1
2714,June 1980,Hawaii,663000,438138,66.1,416431,62.8,21707,5.0
2715,June 1980,Idaho,659000,427930,64.9,393420,59.7,34510,8.1
2716,June 1980,Illinois,8471000,5558454,65.6,5090240,60.1,468214,8.4
2717,June 1980,Indiana,4013000,2632410,65.6,2355675,58.7,276735,10.5
2718,June 1980,Iowa,2151000,1440224,67.0,1347450,62.6,92774,6.4
2719,June 1980,Kansas,1739000,1189146,68.4,1132855,65.1,56291,4.7
2720,June 1980,Kentucky,2649000,1656061,62.5,1521195,57.4,134866,8.1
2721,June 1980,Louisiana,2979000,1771898,59.5,1655187,55.6,116711,6.6
2722,June 1980,Maine,826000,505718,61.2,466175,56.4,39543,7.8
2723,June 1980,Maryland,3142000,2149860,68.4,2002474,63.7,147386,6.9
2724,June 1980,Massachusetts,4372000,2860928,65.4,2694852,61.6,166076,5.8
2725,June 1980,Michigan,6771000,4310320,63.7,3733327,55.1,576993,13.4
2726,June 1980,Minnesota,3008000,2105989,70.0,1978697,65.8,127292,6.0
2727,June 1980,Mississippi,1770000,1057979,59.8,979313,55.3,78666,7.4
2728,June 1980,Missouri,3661000,2304536,62.9,2128940,58.2,175596,7.6
2729,June 1980,Montana,574000,373517,65.1,350322,61.0,23195,6.2
2730,June 1980,Nebraska,1148000,769713,67.0,737801,64.3,31912,4.1
2731,June 1980,Nevada,605000,426524,70.5,399399,66.0,27125,6.4
2732,June 1980,New Hampshire,682000,466865,68.5,444367,65.2,22498,4.8
2733,June 1980,New Jersey,5595000,3590017,64.2,3323890,59.4,266127,7.4
2734,June 1980,New Mexico,921000,564255,61.3,521222,56.6,43033,7.6
2735,June 1980,New York,13307000,7950541,59.7,7344270,55.2,606271,7.6
2736,June 1980,North Carolina,4291000,2854109,66.5,2656498,61.9,197611,6.9
2737,June 1980,North Dakota,467000,302771,64.8,287156,61.5,15615,5.2
2738,June 1980,Ohio,7992000,5102984,63.9,4639458,58.1,463526,9.1
2739,June 1980,Oklahoma,2217000,1369593,61.8,1298559,58.6,71034,5.2
2740,June 1980,Oregon,1974000,1300781,65.9,1180965,59.8,119816,9.2
2741,June 1980,Pennsylvania,9046000,5435212,60.1,4974646,55.0,460566,8.5
2742,June 1980,Rhode Island,719000,467600,65.0,433392,60.3,34208,7.3
2743,June 1980,South Carolina,2220000,1405080,63.3,1305250,58.8,99830,7.1
2744,June 1980,South Dakota,495000,334989,67.7,318099,64.3,16890,5.0
2745,June 1980,Tennessee,3399000,2079764,61.2,1920666,56.5,159098,7.6
2746,June 1980,Texas,10211000,6734210,66.0,6374931,62.4,359279,5.3
2747,June 1980,Utah,961000,629777,65.5,590091,61.4,39686,6.3
2748,June 1980,Vermont,377000,249837,66.3,233685,62.0,16152,6.5
2749,June 1980,Virginia,3885000,2555824,65.8,2413978,62.1,141846,5.5
2750,June 1980,Washington,3056000,1981097,64.8,1817107,59.5,163990,8.3
2751,June 1980,West Virginia,1444000,786255,54.4,710036,49.2,76219,9.7
2752,June 1980,Wisconsin,3474000,2342824,67.4,2177466,62.7,165358,7.1
2753,June 1980,Wyoming,335000,234740,70.1,225919,67.4,8821,3.8
2754,July 1980,Alabama,2831000,1667937,58.9,1509355,53.3,158582,9.5
2755,July 1980,Alaska,264000,188350,71.3,169508,64.2,18842,10.0
2756,July 1980,Arizona,1996000,1232887,61.8,1144482,57.3,88405,7.2
2757,July 1980,Arkansas,1671000,998471,59.8,918170,54.9,80301,8.0
2758,July 1980,California,17709000,11597609,65.5,10761760,60.8,835849,7.2
2759,July 1980,Colorado,2130000,1496909,70.3,1403211,65.9,93698,6.3
2760,July 1980,Connecticut,2369000,1589608,67.1,1493205,63.0,96403,6.1
2761,July 1980,Delaware,440000,284258,64.6,261720,59.5,22538,7.9
2762,July 1980,District of Columbia,491000,323381,65.9,299392,61.0,23989,7.4
2763,July 1980,Florida,7624000,4265523,55.9,3995287,52.4,270236,6.3
2764,July 1980,Georgia,3924000,2543148,64.8,2362206,60.2,180942,7.1
2765,July 1980,Hawaii,664000,438980,66.1,416906,62.8,22074,5.0
2766,July 1980,Idaho,660000,426943,64.7,392269,59.4,34674,8.1
2767,July 1980,Illinois,8476000,5563157,65.6,5079298,59.9,483859,8.7
2768,July 1980,Indiana,4015000,2625980,65.4,2347010,58.5,278970,10.6
2769,July 1980,Iowa,2152000,1440110,66.9,1343351,62.4,96759,6.7
2770,July 1980,Kansas,1740000,1188788,68.3,1131368,65.0,57420,4.8
2771,July 1980,Kentucky,2651000,1661210,62.7,1521017,57.4,140193,8.4
2772,July 1980,Louisiana,2984000,1776489,59.5,1658877,55.6,117612,6.6
2773,July 1980,Maine,826000,505709,61.2,465534,56.4,40175,7.9
2774,July 1980,Maryland,3146000,2151888,68.4,2003103,63.7,148785,6.9
2775,July 1980,Massachusetts,4376000,2864854,65.5,2697568,61.6,167286,5.8
2776,July 1980,Michigan,6772000,4308289,63.6,3723064,55.0,585225,13.6
2777,July 1980,Minnesota,3011000,2107734,70.0,1978800,65.7,128934,6.1
2778,July 1980,Mississippi,1772000,1057986,59.7,977286,55.2,80700,7.6
2779,July 1980,Missouri,3663000,2308303,63.0,2127957,58.1,180346,7.8
2780,July 1980,Montana,575000,373454,64.9,349883,60.8,23571,6.3
2781,July 1980,Nebraska,1149000,769807,67.0,736871,64.1,32936,4.3
2782,July 1980,Nevada,607000,429402,70.7,401245,66.1,28157,6.6
2783,July 1980,New Hampshire,684000,467525,68.4,444266,65.0,23259,5.0
2784,July 1980,New Jersey,5601000,3592391,64.1,3320135,59.3,272256,7.6
2785,July 1980,New Mexico,923000,565099,61.2,521097,56.5,44002,7.8
2786,July 1980,New York,13313000,7948491,59.7,7339732,55.1,608759,7.7
2787,July 1980,North Carolina,4297000,2854497,66.4,2652401,61.7,202096,7.1
2788,July 1980,North Dakota,467000,303167,64.9,287004,61.5,16163,5.3
2789,July 1980,Ohio,7996000,5108231,63.9,4627034,57.9,481197,9.4
2790,July 1980,Oklahoma,2221000,1379698,62.1,1302776,58.7,76922,5.6
2791,July 1980,Oregon,1976000,1303015,65.9,1180658,59.7,122357,9.4
2792,July 1980,Pennsylvania,9051000,5434145,60.0,4965494,54.9,468651,8.6
2793,July 1980,Rhode Island,720000,467780,65.0,433114,60.2,34666,7.4
2794,July 1980,South Carolina,2223000,1408953,63.4,1304891,58.7,104062,7.4
2795,July 1980,South Dakota,495000,334519,67.6,317218,64.1,17301,5.2
2796,July 1980,Tennessee,3402000,2083250,61.2,1919052,56.4,164198,7.9
2797,July 1980,Texas,10238000,6750256,65.9,6389170,62.4,361086,5.3
2798,July 1980,Utah,963000,630325,65.5,589294,61.2,41031,6.5
2799,July 1980,Vermont,377000,250502,66.4,233845,62.0,16657,6.6
2800,July 1980,Virginia,3891000,2559825,65.8,2415524,62.1,144301,5.6
2801,July 1980,Washington,3062000,1982830,64.8,1815640,59.3,167190,8.4
2802,July 1980,West Virginia,1445000,786534,54.4,708237,49.0,78297,10.0
2803,July 1980,Wisconsin,3478000,2337303,67.2,2170932,62.4,166371,7.1
2804,July 1980,Wyoming,336000,235896,70.2,226677,67.5,9219,3.9
2805,August 1980,Alabama,2834000,1669058,58.9,1507746,53.2,161312,9.7
2806,August 1980,Alaska,265000,188274,71.0,169521,64.0,18753,10.0
2807,August 1980,Arizona,2000000,1235500,61.8,1148049,57.4,87451,7.1
2808,August 1980,Arkansas,1673000,998968,59.7,917525,54.8,81443,8.2
2809,August 1980,California,17740000,11617932,65.5,10777266,60.8,840666,7.2
2810,August 1980,Colorado,2135000,1499791,70.2,1404052,65.8,95739,6.4
2811,August 1980,Connecticut,2372000,1590171,67.0,1492055,62.9,98116,6.2
2812,August 1980,Delaware,441000,284612,64.5,261815,59.4,22797,8.0
2813,August 1980,District of Columbia,491000,321937,65.6,297113,60.5,24824,7.7
2814,August 1980,Florida,7649000,4284306,56.0,4010715,52.4,273591,6.4
2815,August 1980,Georgia,3932000,2544345,64.7,2367733,60.2,176612,6.9
2816,August 1980,Hawaii,665000,440007,66.2,417587,62.8,22420,5.1
2817,August 1980,Idaho,661000,426298,64.5,391989,59.3,34309,8.0
2818,August 1980,Illinois,8481000,5565343,65.6,5072084,59.8,493259,8.9
2819,August 1980,Indiana,4016000,2618303,65.2,2343744,58.4,274559,10.5
2820,August 1980,Iowa,2152000,1438558,66.8,1340376,62.3,98182,6.8
2821,August 1980,Kansas,1741000,1187908,68.2,1130382,64.9,57526,4.8
2822,August 1980,Kentucky,2653000,1666376,62.8,1522074,57.4,144302,8.7
2823,August 1980,Louisiana,2989000,1784225,59.7,1664297,55.7,119928,6.7
2824,August 1980,Maine,827000,505821,61.2,465366,56.3,40455,8.0
2825,August 1980,Maryland,3151000,2153167,68.3,2004785,63.6,148382,6.9
2826,August 1980,Massachusetts,4379000,2869537,65.5,2702628,61.7,166909,5.8
2827,August 1980,Michigan,6773000,4303754,63.5,3723165,55.0,580589,13.5
2828,August 1980,Minnesota,3014000,2109097,70.0,1980276,65.7,128821,6.1
2829,August 1980,Mississippi,1774000,1058215,59.7,975693,55.0,82522,7.8
2830,August 1980,Missouri,3665000,2311276,63.1,2129526,58.1,181750,7.9
2831,August 1980,Montana,575000,374052,65.1,350201,60.9,23851,6.4
2832,August 1980,Nebraska,1149000,769935,67.0,736593,64.1,33342,4.3
2833,August 1980,Nevada,609000,432623,71.0,403757,66.3,28866,6.7
2834,August 1980,New Hampshire,685000,468063,68.3,444572,64.9,23491,5.0
2835,August 1980,New Jersey,5606000,3594277,64.1,3319652,59.2,274625,7.6
2836,August 1980,New Mexico,924000,566313,61.3,521481,56.4,44832,7.9
2837,August 1980,New York,13320000,7950512,59.7,7343684,55.1,606828,7.6
2838,August 1980,North Carolina,4304000,2854310,66.3,2652660,61.6,201650,7.1
2839,August 1980,North Dakota,468000,303682,64.9,287255,61.4,16427,5.4
2840,August 1980,Ohio,7999000,5107295,63.8,4622645,57.8,484650,9.5
2841,August 1980,Oklahoma,2225000,1386392,62.3,1309266,58.8,77126,5.6
2842,August 1980,Oregon,1979000,1304154,65.9,1182539,59.8,121615,9.3
2843,August 1980,Pennsylvania,9056000,5432680,60.0,4964613,54.8,468067,8.6
2844,August 1980,Rhode Island,720000,468335,65.0,433385,60.2,34950,7.5
2845,August 1980,South Carolina,2227000,1411821,63.4,1305901,58.6,105920,7.5
2846,August 1980,South Dakota,496000,334214,67.4,316748,63.9,17466,5.2
2847,August 1980,Tennessee,3406000,2085926,61.2,1918848,56.3,167078,8.0
2848,August 1980,Texas,10264000,6770147,66.0,6409449,62.4,360698,5.3
2849,August 1980,Utah,965000,631044,65.4,588968,61.0,42076,6.7
2850,August 1980,Vermont,378000,251158,66.4,234261,62.0,16897,6.7
2851,August 1980,Virginia,3897000,2563299,65.8,2420229,62.1,143070,5.6
2852,August 1980,Washington,3067000,1985454,64.7,1816466,59.2,168988,8.5
2853,August 1980,West Virginia,1446000,786805,54.4,707215,48.9,79590,10.1
2854,August 1980,Wisconsin,3481000,2367215,68.0,2167116,62.3,200099,8.5
2855,August 1980,Wyoming,337000,237211,70.4,227566,67.5,9645,4.1
2856,September 1980,Alabama,2837000,1670565,58.9,1508703,53.2,161862,9.7
2857,September 1980,Alaska,266000,188161,70.7,169583,63.8,18578,9.9
2858,September 1980,Arizona,2005000,1237586,61.7,1152188,57.5,85398,6.9
2859,September 1980,Arkansas,1674000,999684,59.7,917880,54.8,81804,8.2
2860,September 1980,California,17772000,11634855,65.5,10797596,60.8,837259,7.2
2861,September 1980,Colorado,2140000,1501571,70.2,1405392,65.7,96179,6.4
2862,September 1980,Connecticut,2374000,1590016,67.0,1491329,62.8,98687,6.2
2863,September 1980,Delaware,441000,284831,64.6,262051,59.4,22780,8.0
2864,September 1980,District of Columbia,491000,320230,65.2,294657,60.0,25573,8.0
2865,September 1980,Florida,7674000,4305153,56.1,4030260,52.5,274893,6.4
2866,September 1980,Georgia,3939000,2544060,64.6,2375571,60.3,168489,6.6
2867,September 1980,Hawaii,666000,441210,66.2,418478,62.8,22732,5.2
2868,September 1980,Idaho,662000,426049,64.4,392502,59.3,33547,7.9
2869,September 1980,Illinois,8486000,5564825,65.6,5067712,59.7,497113,8.9
2870,September 1980,Indiana,4018000,2611600,65.0,2345679,58.4,265921,10.2
2871,September 1980,Iowa,2153000,1435711,66.7,1338434,62.2,97277,6.8
2872,September 1980,Kansas,1743000,1186749,68.1,1129911,64.8,56838,4.8
2873,September 1980,Kentucky,2655000,1671022,62.9,1524109,57.4,146913,8.8
2874,September 1980,Louisiana,2995000,1794228,59.9,1670676,55.8,123552,6.9
2875,September 1980,Maine,828000,506054,61.1,465609,56.2,40445,8.0
2876,September 1980,Maryland,3155000,2154127,68.3,2007141,63.6,146986,6.8
2877,September 1980,Massachusetts,4383000,2874639,65.6,2709016,61.8,165623,5.8
2878,September 1980,Michigan,6774000,4297324,63.4,3730008,55.1,567316,13.2
2879,September 1980,Minnesota,3017000,2110309,69.9,1982987,65.7,127322,6.0
2880,September 1980,Mississippi,1776000,1058726,59.6,974623,54.9,84103,7.9
2881,September 1980,Missouri,3667000,2313114,63.1,2132473,58.2,180641,7.8
2882,September 1980,Montana,576000,375323,65.2,351274,61.0,24049,6.4
2883,September 1980,Nebraska,1150000,770080,67.0,736857,64.1,33223,4.3
2884,September 1980,Nevada,612000,435990,71.2,406621,66.4,29369,6.7
2885,September 1980,New Hampshire,686000,468704,68.3,445358,64.9,23346,5.0
2886,September 1980,New Jersey,5612000,3595870,64.1,3321581,59.2,274289,7.6
2887,September 1980,New Mexico,926000,567884,61.3,522472,56.4,45412,8.0
2888,September 1980,New York,13327000,7955340,59.7,7352626,55.2,602714,7.6
2889,September 1980,North Carolina,4310000,2854335,66.2,2656712,61.6,197623,6.9
2890,September 1980,North Dakota,468000,304357,65.0,287929,61.5,16428,5.4
2891,September 1980,Ohio,8003000,5102881,63.8,4624726,57.8,478155,9.4
2892,September 1980,Oklahoma,2229000,1391711,62.4,1317270,59.1,74441,5.3
2893,September 1980,Oregon,1981000,1305095,65.9,1186127,59.9,118968,9.1
2894,September 1980,Pennsylvania,9061000,5431067,59.9,4970997,54.9,460070,8.5
2895,September 1980,Rhode Island,721000,469188,65.1,434224,60.2,34964,7.5
2896,September 1980,South Carolina,2231000,1413654,63.4,1308192,58.6,105462,7.5
2897,September 1980,South Dakota,496000,334211,67.4,316700,63.9,17511,5.2
2898,September 1980,Tennessee,3409000,2087377,61.2,1918932,56.3,168445,8.1
2899,September 1980,Texas,10291000,6794147,66.0,6434553,62.5,359594,5.3
2900,September 1980,Utah,968000,632024,65.3,589327,60.9,42697,6.8
2901,September 1980,Vermont,378000,251765,66.6,234941,62.2,16824,6.7
2902,September 1980,Virginia,3903000,2566104,65.7,2426603,62.2,139501,5.4
2903,September 1980,Washington,3073000,1988450,64.7,1819049,59.2,169401,8.5
2904,September 1980,West Virginia,1447000,787192,54.4,706912,48.9,80280,10.2
2905,September 1980,Wisconsin,3484000,2371442,68.1,2165976,62.2,205466,8.7
2906,September 1980,Wyoming,338000,238627,70.6,228604,67.6,10023,4.2
2907,October 1980,Alabama,2840000,1672526,58.9,1511190,53.2,161336,9.6
2908,October 1980,Alaska,266000,188134,70.7,169766,63.8,18368,9.8
2909,October 1980,Arizona,2010000,1239163,61.6,1156406,57.5,82757,6.7
2910,October 1980,Arkansas,1675000,1000852,59.8,918918,54.9,81934,8.2
2911,October 1980,California,17803000,11650624,65.4,10819086,60.8,831538,7.1
2912,October 1980,Colorado,2145000,1502766,70.1,1407086,65.6,95680,6.4
2913,October 1980,Connecticut,2377000,1589200,66.9,1490756,62.7,98444,6.2
2914,October 1980,Delaware,441000,284997,64.6,262376,59.5,22621,7.9
2915,October 1980,District of Columbia,490000,318441,65.0,292277,59.6,26164,8.2
2916,October 1980,Florida,7699000,4326666,56.2,4050961,52.6,275705,6.4
2917,October 1980,Georgia,3947000,2544513,64.5,2384012,60.4,160501,6.3
2918,October 1980,Hawaii,667000,442501,66.3,419530,62.9,22971,5.2
2919,October 1980,Idaho,663000,426192,64.3,393577,59.4,32615,7.7
2920,October 1980,Illinois,8491000,5563804,65.5,5065969,59.7,497835,8.9
2921,October 1980,Indiana,4020000,2607816,64.9,2351170,58.5,256646,9.8
2922,October 1980,Iowa,2154000,1432197,66.5,1337203,62.1,94994,6.6
2923,October 1980,Kansas,1744000,1185780,68.0,1129980,64.8,55800,4.7
2924,October 1980,Kentucky,2657000,1674604,63.0,1526711,57.5,147893,8.8
2925,October 1980,Louisiana,3000000,1805058,60.2,1676924,55.9,128134,7.1
2926,October 1980,Maine,829000,506426,61.1,466121,56.2,40305,8.0
2927,October 1980,Maryland,3159000,2155411,68.2,2009648,63.6,145763,6.8
2928,October 1980,Massachusetts,4387000,2879871,65.6,2715390,61.9,164481,5.7
2929,October 1980,Michigan,6776000,4291210,63.3,3738369,55.2,552841,12.9
2930,October 1980,Minnesota,3020000,2111880,69.9,1986380,65.8,125500,5.9
2931,October 1980,Mississippi,1778000,1059377,59.6,973690,54.8,85687,8.1
2932,October 1980,Missouri,3670000,2313757,63.0,2135311,58.2,178446,7.7
2933,October 1980,Montana,577000,377080,65.4,352895,61.2,24185,6.4
2934,October 1980,Nebraska,1151000,770206,66.9,737409,64.1,32797,4.3
2935,October 1980,Nevada,614000,439262,71.5,409424,66.7,29838,6.8
2936,October 1980,New Hampshire,687000,469562,68.3,446459,65.0,23103,4.9
2937,October 1980,New Jersey,5617000,3597263,64.0,3324282,59.2,272981,7.6
2938,October 1980,New Mexico,928000,569630,61.4,523924,56.5,45706,8.0
2939,October 1980,New York,13334000,7963137,59.7,7362102,55.2,601035,7.5
2940,October 1980,North Carolina,4316000,2855809,66.2,2663213,61.7,192596,6.7
2941,October 1980,North Dakota,469000,305160,65.1,288874,61.6,16286,5.3
2942,October 1980,Ohio,8007000,5099065,63.7,4629925,57.8,469140,9.2
2943,October 1980,Oklahoma,2233000,1395914,62.5,1325857,59.4,70057,5.0
2944,October 1980,Oregon,1983000,1307141,65.9,1190401,60.0,116740,8.9
2945,October 1980,Pennsylvania,9066000,5430709,59.9,4981863,55.0,448846,8.3
2946,October 1980,Rhode Island,722000,470236,65.1,435498,60.3,34738,7.4
2947,October 1980,South Carolina,2235000,1415217,63.3,1311250,58.7,103967,7.3
2948,October 1980,South Dakota,496000,334519,67.4,316966,63.9,17553,5.2
2949,October 1980,Tennessee,3413000,2088043,61.2,1918198,56.2,169845,8.1
2950,October 1980,Texas,10318000,6821438,66.1,6461970,62.6,359468,5.3
2951,October 1980,Utah,970000,633225,65.3,590338,60.9,42887,6.8
2952,October 1980,Vermont,378000,252301,66.7,235814,62.4,16487,6.5
2953,October 1980,Virginia,3909000,2568839,65.7,2432785,62.2,136054,5.3
2954,October 1980,Washington,3078000,1991647,64.7,1822229,59.2,169418,8.5
2955,October 1980,West Virginia,1448000,787733,54.4,707411,48.9,80322,10.2
2956,October 1980,Wisconsin,3487000,2369758,68.0,2166836,62.1,202922,8.6
2957,October 1980,Wyoming,339000,240067,70.8,229753,67.8,10314,4.3
2958,November 1980,Alabama,2843000,1674692,58.9,1514019,53.3,160673,9.6
2959,November 1980,Alaska,267000,188256,70.5,170140,63.7,18116,9.6
2960,November 1980,Arizona,2015000,1240750,61.6,1160692,57.6,80058,6.5
2961,November 1980,Arkansas,1677000,1002807,59.8,920512,54.9,82295,8.2
2962,November 1980,California,17834000,11668969,65.4,10841456,60.8,827513,7.1
2963,November 1980,Colorado,2150000,1504370,70.0,1409635,65.6,94735,6.3
2964,November 1980,Connecticut,2379000,1588280,66.8,1490501,62.7,97779,6.2
2965,November 1980,Delaware,442000,285205,64.5,262774,59.5,22431,7.9
2966,November 1980,District of Columbia,490000,316755,64.6,290204,59.2,26551,8.4
2967,November 1980,Florida,7724000,4349575,56.3,4072794,52.7,276781,6.4
2968,November 1980,Georgia,3955000,2547632,64.4,2392357,60.5,155275,6.1
2969,November 1980,Hawaii,668000,443761,66.4,420645,63.0,23116,5.2
2970,November 1980,Idaho,664000,426722,64.3,394996,59.5,31726,7.4
2971,November 1980,Illinois,8496000,5565128,65.5,5068386,59.7,496742,8.9
2972,November 1980,Indiana,4022000,2608148,64.8,2358634,58.6,249514,9.6
2973,November 1980,Iowa,2155000,1428973,66.3,1336637,62.0,92336,6.5
2974,November 1980,Kansas,1745000,1185498,67.9,1130761,64.8,54737,4.6
2975,November 1980,Kentucky,2659000,1676816,63.1,1529501,57.5,147315,8.8
2976,November 1980,Louisiana,3005000,1815765,60.4,1682706,56.0,133059,7.3
2977,November 1980,Maine,830000,506857,61.1,466814,56.2,40043,7.9
2978,November 1980,Maryland,3164000,2157284,68.2,2012145,63.6,145139,6.7
2979,November 1980,Massachusetts,4391000,2885769,65.7,2721564,62.0,164205,5.7
2980,November 1980,Michigan,6777000,4288875,63.3,3746564,55.3,542311,12.6
2981,November 1980,Minnesota,3023000,2113801,69.9,1989941,65.8,123860,5.9
2982,November 1980,Mississippi,1780000,1059910,59.5,972712,54.6,87198,8.2
2983,November 1980,Missouri,3672000,2314553,63.0,2137930,58.2,176623,7.6
2984,November 1980,Montana,577000,379028,65.7,354802,61.5,24226,6.4
2985,November 1980,Nebraska,1152000,770363,66.9,738121,64.1,32242,4.2
2986,November 1980,Nevada,616000,442286,71.8,411925,66.9,30361,6.9
2987,November 1980,New Hampshire,688000,470599,68.4,447669,65.1,22930,4.9
2988,November 1980,New Jersey,5623000,3599662,64.0,3327535,59.2,272127,7.6
2989,November 1980,New Mexico,930000,571385,61.4,525694,56.5,45691,8.0
2990,November 1980,New York,13341000,7975839,59.8,7372157,55.3,603682,7.6
2991,November 1980,North Carolina,4322000,2860348,66.2,2671779,61.8,188569,6.6
2992,November 1980,North Dakota,469000,305971,65.2,289898,61.8,16073,5.3
2993,November 1980,Ohio,8010000,5098354,63.6,4636073,57.9,462281,9.1
2994,November 1980,Oklahoma,2237000,1399408,62.6,1334669,59.7,64739,4.6
2995,November 1980,Oregon,1985000,1310968,66.0,1194738,60.2,116230,8.9
2996,November 1980,Pennsylvania,9071000,5433190,59.9,4994800,55.1,438390,8.1
2997,November 1980,Rhode Island,722000,471384,65.3,436956,60.5,34428,7.3
2998,November 1980,South Carolina,2239000,1417292,63.3,1314495,58.7,102797,7.3
2999,November 1980,South Dakota,496000,334991,67.5,317390,64.0,17601,5.3
3000,November 1980,Tennessee,3416000,2089381,61.2,1917466,56.1,171915,8.2
3001,November 1980,Texas,10344000,6851048,66.2,6490940,62.8,360108,5.3
3002,November 1980,Utah,972000,634546,65.3,591829,60.9,42717,6.7
3003,November 1980,Vermont,379000,252785,66.7,236801,62.5,15984,6.3
3004,November 1980,Virginia,3915000,2572633,65.7,2438281,62.3,134352,5.2
3005,November 1980,Washington,3084000,1994662,64.7,1824939,59.2,169723,8.5
3006,November 1980,West Virginia,1449000,788352,54.4,708373,48.9,79979,10.1
3007,November 1980,Wisconsin,3490000,2368726,67.9,2169504,62.2,199222,8.4
3008,November 1980,Wyoming,340000,241486,71.0,230964,67.9,10522,4.4
3009,December 1980,Alabama,2846000,1676614,58.9,1516136,53.3,160478,9.6
3010,December 1980,Alaska,268000,188548,70.4,170738,63.7,17810,9.4
3011,December 1980,Arizona,2020000,1243446,61.6,1165674,57.7,77772,6.3
3012,December 1980,Arkansas,1678000,1005818,59.9,922868,55.0,82950,8.2
3013,December 1980,California,17866000,11693603,65.5,10867447,60.8,826156,7.1
3014,December 1980,Colorado,2155000,1507387,69.9,1413846,65.6,93541,6.2
3015,December 1980,Connecticut,2382000,1588241,66.7,1491150,62.6,97091,6.1
3016,December 1980,Delaware,442000,285511,64.6,263226,59.6,22285,7.8
3017,December 1980,District of Columbia,490000,315281,64.3,288556,58.9,26725,8.5
3018,December 1980,Florida,7749000,4376671,56.5,4098700,52.9,277971,6.4
3019,December 1980,Georgia,3962000,2554784,64.5,2401181,60.6,153603,6.0
3020,December 1980,Hawaii,669000,444955,66.5,421749,63.0,23206,5.2
3021,December 1980,Idaho,664000,427580,64.4,396599,59.7,30981,7.2
3022,December 1980,Illinois,8500000,5571678,65.5,5077315,59.7,494363,8.9
3023,December 1980,Indiana,4024000,2612683,64.9,2366839,58.8,245844,9.4
3024,December 1980,Iowa,2156000,1426862,66.2,1336936,62.0,89926,6.3
3025,December 1980,Kansas,1747000,1186298,67.9,1132510,64.8,53788,4.5
3026,December 1980,Kentucky,2662000,1677778,63.0,1532170,57.6,145608,8.7
3027,December 1980,Louisiana,3011000,1826049,60.6,1688551,56.1,137498,7.5
3028,December 1980,Maine,830000,507194,61.1,467641,56.3,39553,7.8
3029,December 1980,Maryland,3168000,2159915,68.2,2014802,63.6,145113,6.7
3030,December 1980,Massachusetts,4395000,2893417,65.8,2728419,62.1,164998,5.7
3031,December 1980,Michigan,6778000,4292384,63.3,3756666,55.4,535718,12.5
3032,December 1980,Minnesota,3027000,2115703,69.9,1993277,65.8,122426,5.8
3033,December 1980,Mississippi,1782000,1060300,59.5,972038,54.5,88262,8.3
3034,December 1980,Missouri,3674000,2317589,63.1,2141710,58.3,175879,7.6
3035,December 1980,Montana,578000,380892,65.9,356693,61.7,24199,6.4
3036,December 1980,Nebraska,1153000,770660,66.8,738997,64.1,31663,4.1
3037,December 1980,Nevada,619000,445120,71.9,414193,66.9,30927,6.9
3038,December 1980,New Hampshire,690000,471735,68.4,448862,65.1,22873,4.8
3039,December 1980,New Jersey,5628000,3604822,64.1,3332690,59.2,272132,7.5
3040,December 1980,New Mexico,932000,573048,61.5,527714,56.6,45334,7.9
3041,December 1980,New York,13347000,7995685,59.9,7386605,55.3,609080,7.6
3042,December 1980,North Carolina,4328000,2869306,66.3,2683097,62.0,186209,6.5
3043,December 1980,North Dakota,470000,306680,65.3,290850,61.9,15830,5.2
3044,December 1980,Ohio,8014000,5101147,63.7,4642817,57.9,458330,9.0
3045,December 1980,Oklahoma,2242000,1403256,62.6,1343943,59.9,59313,4.2
3046,December 1980,Oregon,1987000,1316264,66.2,1199038,60.3,117226,8.9
3047,December 1980,Pennsylvania,9077000,5439959,59.9,5008442,55.2,431517,7.9
3048,December 1980,Rhode Island,723000,472521,65.4,438331,60.6,34190,7.2
3049,December 1980,South Carolina,2242000,1420134,63.3,1317507,58.8,102627,7.2
3050,December 1980,South Dakota,496000,335398,67.6,317804,64.1,17594,5.2
3051,December 1980,Tennessee,3420000,2093450,61.2,1918999,56.1,174451,8.3
3052,December 1980,Texas,10371000,6883288,66.4,6522615,62.9,360673,5.2
3053,December 1980,Utah,975000,635845,65.2,593525,60.9,42320,6.7
3054,December 1980,Vermont,379000,253279,66.8,237838,62.8,15441,6.1
3055,December 1980,Virginia,3921000,2578928,65.8,2443944,62.3,134984,5.2
3056,December 1980,Washington,3089000,1997300,64.7,1826706,59.1,170594,8.5
3057,December 1980,West Virginia,1450000,789070,54.4,708800,48.9,80270,10.2
3058,December 1980,Wisconsin,3494000,2370139,67.8,2174536,62.2,195603,8.3
3059,December 1980,Wyoming,342000,242839,71.0,232208,67.9,10631,4.4
3060,January 1981,Alabama,2849000,1677881,58.9,1516568,53.2,161313,9.6
3061,January 1981,Alaska,269000,189018,70.3,171524,63.8,17494,9.3
3062,January 1981,Arizona,2025000,1247648,61.6,1171601,57.9,76047,6.1
3063,January 1981,Arkansas,1680000,1009793,60.1,925860,55.1,83933,8.3
3064,January 1981,California,17897000,11724099,65.5,10896475,60.9,827624,7.1
3065,January 1981,Colorado,2160000,1512057,70.0,1419683,65.7,92374,6.1
3066,January 1981,Connecticut,2384000,1589533,66.7,1492705,62.6,96828,6.1
3067,January 1981,Delaware,443000,285879,64.5,263668,59.5,22211,7.8
3068,January 1981,District of Columbia,490000,313993,64.1,287239,58.6,26754,8.5
3069,January 1981,Florida,7774000,4408535,56.7,4128788,53.1,279747,6.3
3070,January 1981,Georgia,3970000,2565522,64.6,2410410,60.7,155112,6.0
3071,January 1981,Hawaii,670000,446093,66.6,422804,63.1,23289,5.2
3072,January 1981,Idaho,665000,428559,64.4,398119,59.9,30440,7.1
3073,January 1981,Illinois,8505000,5582922,65.6,5091853,59.9,491069,8.8
3074,January 1981,Indiana,4026000,2619525,65.1,2374106,59.0,245419,9.4
3075,January 1981,Iowa,2157000,1426035,66.1,1337855,62.0,88180,6.2
3076,January 1981,Kansas,1748000,1188018,68.0,1134983,64.9,53035,4.5
3077,January 1981,Kentucky,2664000,1677589,63.0,1534186,57.6,143403,8.5
3078,January 1981,Louisiana,3016000,1835619,60.9,1694415,56.2,141204,7.7
3079,January 1981,Maine,831000,507450,61.1,468483,56.4,38967,7.7
3080,January 1981,Maryland,3173000,2163253,68.2,2017478,63.6,145775,6.7
3081,January 1981,Massachusetts,4399000,2902770,66.0,2736104,62.2,166666,5.7
3082,January 1981,Michigan,6779000,4300302,63.4,3769182,55.6,531120,12.4
3083,January 1981,Minnesota,3030000,2117632,69.9,1996012,65.9,121620,5.7
3084,January 1981,Mississippi,1784000,1060360,59.4,971791,54.5,88569,8.4
3085,January 1981,Missouri,3676000,2322791,63.2,2146879,58.4,175912,7.6
3086,January 1981,Montana,578000,382470,66.2,358243,62.0,24227,6.3
3087,January 1981,Nebraska,1154000,771134,66.8,739987,64.1,31147,4.0
3088,January 1981,Nevada,621000,447864,72.1,416433,67.1,31431,7.0
3089,January 1981,New Hampshire,691000,472862,68.4,449909,65.1,22953,4.9
3090,January 1981,New Jersey,5634000,3612416,64.1,3339638,59.3,272778,7.6
3091,January 1981,New Mexico,934000,574553,61.5,529855,56.7,44698,7.8
3092,January 1981,New York,13354000,8021001,60.1,7405176,55.5,615825,7.7
3093,January 1981,North Carolina,4334000,2882321,66.5,2696568,62.2,185753,6.4
3094,January 1981,North Dakota,470000,307231,65.4,291633,62.0,15598,5.1
3095,January 1981,Ohio,8017000,5105959,63.7,4649270,58.0,456689,8.9
3096,January 1981,Oklahoma,2246000,1408150,62.7,1353530,60.3,54620,3.9
3097,January 1981,Oregon,1989000,1322123,66.5,1202970,60.5,119153,9.0
3098,January 1981,Pennsylvania,9082000,5451083,60.0,5021142,55.3,429941,7.9
3099,January 1981,Rhode Island,723000,473510,65.5,439390,60.8,34120,7.2
3100,January 1981,South Carolina,2246000,1423668,63.4,1320068,58.8,103600,7.3
3101,January 1981,South Dakota,496000,335606,67.7,318110,64.1,17496,5.2
3102,January 1981,Tennessee,3423000,2100893,61.4,1923543,56.2,177350,8.4
3103,January 1981,Texas,10397000,6917849,66.5,6556298,63.1,361551,5.2
3104,January 1981,Utah,977000,637013,65.2,595157,60.9,41856,6.6
3105,January 1981,Vermont,380000,253874,66.8,238889,62.9,14985,5.9
3106,January 1981,Virginia,3927000,2587701,65.9,2449589,62.4,138112,5.3
3107,January 1981,Washington,3095000,1999430,64.6,1827257,59.0,172173,8.6
3108,January 1981,West Virginia,1451000,789928,54.4,708003,48.8,81925,10.4
3109,January 1981,Wisconsin,3497000,2373837,67.9,2181421,62.4,192416,8.1
3110,January 1981,Wyoming,343000,244127,71.2,233499,68.1,10628,4.4
3111,February 1981,Alabama,2852000,1678207,58.8,1515111,53.1,163096,9.7
3112,February 1981,Alaska,269000,189649,70.5,172437,64.1,17212,9.1
3113,February 1981,Arizona,2030000,1252938,61.7,1178115,58.0,74823,6.0
3114,February 1981,Arkansas,1681000,1014248,60.3,929077,55.3,85171,8.4
3115,February 1981,California,17928000,11755767,65.6,10925117,60.9,830650,7.1
3116,February 1981,Colorado,2165000,1517779,70.1,1426473,65.9,91306,6.0
3117,February 1981,Connecticut,2387000,1591697,66.7,1494668,62.6,97029,6.1
3118,February 1981,Delaware,443000,286226,64.6,264072,59.6,22154,7.7
3119,February 1981,District of Columbia,489000,312721,64.0,285977,58.5,26744,8.6
3120,February 1981,Florida,7799000,4442632,57.0,4160211,53.3,282421,6.4
3121,February 1981,Georgia,3978000,2577426,64.8,2419329,60.8,158097,6.1
3122,February 1981,Hawaii,671000,447165,66.6,423755,63.2,23410,5.2
3123,February 1981,Idaho,666000,429449,64.5,399235,59.9,30214,7.0
3124,February 1981,Illinois,8510000,5595042,65.7,5108897,60.0,486145,8.7
3125,February 1981,Indiana,4028000,2625896,65.2,2379142,59.1,246754,9.4
3126,February 1981,Iowa,2158000,1426147,66.1,1338866,62.0,87281,6.1
3127,February 1981,Kansas,1749000,1189965,68.0,1137607,65.0,52358,4.4
3128,February 1981,Kentucky,2666000,1676153,62.9,1535023,57.6,141130,8.4
3129,February 1981,Louisiana,3021000,1844049,61.0,1699588,56.3,144461,7.8
3130,February 1981,Maine,832000,507769,61.0,469422,56.4,38347,7.6
3131,February 1981,Maryland,3177000,2166637,68.2,2019679,63.6,146958,6.8
3132,February 1981,Massachusetts,4403000,2912857,66.2,2743730,62.3,169127,5.8
3133,February 1981,Michigan,6781000,4308927,63.5,3782305,55.8,526622,12.2
3134,February 1981,Minnesota,3033000,2119052,69.9,1997943,65.9,121109,5.7
3135,February 1981,Mississippi,1786000,1059953,59.3,971776,54.4,88177,8.3
3136,February 1981,Missouri,3679000,2328244,63.3,2152344,58.5,175900,7.6
3137,February 1981,Montana,579000,383606,66.3,359274,62.1,24332,6.3
3138,February 1981,Nebraska,1155000,771806,66.8,741040,64.2,30766,4.0
3139,February 1981,Nevada,623000,450527,72.3,418789,67.2,31738,7.0
3140,February 1981,New Hampshire,692000,473825,68.5,450755,65.1,23070,4.9
3141,February 1981,New Jersey,5639000,3620082,64.2,3346703,59.3,273379,7.6
3142,February 1981,New Mexico,936000,575841,61.5,531905,56.8,43936,7.6
3143,February 1981,New York,13361000,8046249,60.2,7424294,55.6,621955,7.7
3144,February 1981,North Carolina,4340000,2896366,66.7,2710591,62.5,185775,6.4
3145,February 1981,North Dakota,471000,307597,65.3,292222,62.0,15375,5.0
3146,February 1981,Ohio,8021000,5109824,63.7,4654340,58.0,455484,8.9
3147,February 1981,Oklahoma,2250000,1414050,62.8,1362913,60.6,51137,3.6
3148,February 1981,Oregon,1991000,1327353,66.7,1206133,60.6,121220,9.1
3149,February 1981,Pennsylvania,9087000,5464031,60.1,5031513,55.4,432518,7.9
3150,February 1981,Rhode Island,724000,474320,65.5,440060,60.8,34260,7.2
3151,February 1981,South Carolina,2250000,1427338,63.4,1322211,58.8,105127,7.4
3152,February 1981,South Dakota,496000,335595,67.7,318306,64.2,17289,5.2
3153,February 1981,Tennessee,3427000,2109831,61.6,1929871,56.3,179960,8.5
3154,February 1981,Texas,10424000,6952803,66.7,6589945,63.2,362858,5.2
3155,February 1981,Utah,979000,638134,65.2,596696,60.9,41438,6.5
3156,February 1981,Vermont,380000,254611,67.0,239939,63.1,14672,5.8
3157,February 1981,Virginia,3933000,2596989,66.0,2454307,62.4,142682,5.5
3158,February 1981,Washington,3100000,2000693,64.5,1826495,58.9,174198,8.7
3159,February 1981,West Virginia,1452000,790643,54.5,706170,48.6,84473,10.7
3160,February 1981,Wisconsin,3500000,2378090,67.9,2188424,62.5,189666,8.0
3161,February 1981,Wyoming,344000,245400,71.3,234870,68.3,10530,4.3
3162,March 1981,Alabama,2855000,1677142,58.7,1512350,53.0,164792,9.8
3163,March 1981,Alaska,270000,190465,70.5,173415,64.2,17050,9.0
3164,March 1981,Arizona,2035000,1258809,61.9,1184832,58.2,73977,5.9
3165,March 1981,Arkansas,1682000,1018623,60.6,932234,55.4,86389,8.5
3166,March 1981,California,17960000,11783563,65.6,10951168,61.0,832395,7.1
3167,March 1981,Colorado,2170000,1523894,70.2,1433733,66.1,90161,5.9
3168,March 1981,Connecticut,2389000,1594100,66.7,1496681,62.6,97419,6.1
3169,March 1981,Delaware,443000,286538,64.7,264461,59.7,22077,7.7
3170,March 1981,District of Columbia,489000,311257,63.7,284475,58.2,26782,8.6
3171,March 1981,Florida,7824000,4475884,57.2,4190659,53.6,285225,6.4
3172,March 1981,Georgia,3985000,2587947,64.9,2427714,60.9,160233,6.2
3173,March 1981,Hawaii,672000,448121,66.7,424554,63.2,23567,5.3
3174,March 1981,Idaho,667000,430084,64.5,399759,59.9,30325,7.1
3175,March 1981,Illinois,8515000,5604814,65.8,5125962,60.2,478852,8.5
3176,March 1981,Indiana,4030000,2630001,65.3,2381811,59.1,248190,9.4
3177,March 1981,Iowa,2159000,1426846,66.1,1339787,62.1,87059,6.1
3178,March 1981,Kansas,1751000,1191503,68.0,1139983,65.1,51520,4.3
3179,March 1981,Kentucky,2668000,1673723,62.7,1534505,57.5,139218,8.3
3180,March 1981,Louisiana,3027000,1851267,61.2,1703708,56.3,147559,8.0
3181,March 1981,Maine,833000,508261,61.0,470609,56.5,37652,7.4
3182,March 1981,Maryland,3181000,2169199,68.2,2020926,63.5,148273,6.8
3183,March 1981,Massachusetts,4407000,2922971,66.3,2750614,62.4,172357,5.9
3184,March 1981,Michigan,6782000,4314992,63.6,3794327,55.9,520665,12.1
3185,March 1981,Minnesota,3036000,2119345,69.8,1999171,65.8,120174,5.7
3186,March 1981,Mississippi,1788000,1059180,59.2,971842,54.4,87338,8.2
3187,March 1981,Missouri,3681000,2331836,63.3,2157213,58.6,174623,7.5
3188,March 1981,Montana,580000,384265,66.3,359780,62.0,24485,6.4
3189,March 1981,Nebraska,1156000,772619,66.8,742059,64.2,30560,4.0
3190,March 1981,Nevada,626000,453137,72.4,421386,67.3,31751,7.0
3191,March 1981,New Hampshire,693000,474553,68.5,451443,65.1,23110,4.9
3192,March 1981,New Jersey,5645000,3625187,64.2,3352473,59.4,272714,7.5
3193,March 1981,New Mexico,938000,576821,61.5,533630,56.9,43191,7.5
3194,March 1981,New York,13368000,8065538,60.3,7441190,55.7,624348,7.7
3195,March 1981,North Carolina,4346000,2908060,66.9,2723978,62.7,184082,6.3
3196,March 1981,North Dakota,471000,307818,65.4,292664,62.1,15154,4.9
3197,March 1981,Ohio,8025000,5110909,63.7,4657956,58.0,452953,8.9
3198,March 1981,Oklahoma,2254000,1420621,63.0,1371735,60.9,48886,3.4
3199,March 1981,Oregon,1993000,1331142,66.8,1208330,60.6,122812,9.2
3200,March 1981,Pennsylvania,9092000,5476219,60.2,5039917,55.4,436302,8.0
3201,March 1981,Rhode Island,725000,474986,65.5,440413,60.7,34573,7.3
3202,March 1981,South Carolina,2254000,1430390,63.5,1323877,58.7,106513,7.4
3203,March 1981,South Dakota,496000,335390,67.6,318415,64.2,16975,5.1
3204,March 1981,Tennessee,3430000,2117736,61.7,1936632,56.5,181104,8.6
3205,March 1981,Texas,10451000,6986833,66.9,6622566,63.4,364267,5.2
3206,March 1981,Utah,982000,639467,65.1,598306,60.9,41161,6.4
3207,March 1981,Vermont,380000,255469,67.2,240967,63.4,14502,5.7
3208,March 1981,Virginia,3939000,2605167,66.1,2458117,62.4,147050,5.6
3209,March 1981,Washington,3106000,2001274,64.4,1824735,58.7,176539,8.8
3210,March 1981,West Virginia,1453000,790853,54.4,704063,48.5,86790,11.0
3211,March 1981,Wisconsin,3503000,2381328,68.0,2194348,62.6,186980,7.9
3212,March 1981,Wyoming,345000,246698,71.5,236326,68.5,10372,4.2
3213,April 1981,Alabama,2858000,1675015,58.6,1508922,52.8,166093,9.9
3214,April 1981,Alaska,271000,191509,70.7,174420,64.4,17089,8.9
3215,April 1981,Arizona,2039000,1264477,62.0,1190951,58.4,73526,5.8
3216,April 1981,Arkansas,1684000,1022383,60.7,934947,55.5,87436,8.6
3217,April 1981,California,17991000,11802894,65.6,10970837,61.0,832057,7.0
3218,April 1981,Colorado,2175000,1529691,70.3,1440865,66.2,88826,5.8
3219,April 1981,Connecticut,2392000,1596141,66.7,1498384,62.6,97757,6.1
3220,April 1981,Delaware,444000,286820,64.6,264850,59.7,21970,7.7
3221,April 1981,District of Columbia,489000,309521,63.3,282618,57.8,26903,8.7
3222,April 1981,Florida,7849000,4504086,57.4,4216609,53.7,287477,6.4
3223,April 1981,Georgia,3993000,2595269,65.0,2434849,61.0,160420,6.2
3224,April 1981,Hawaii,673000,448913,66.7,425227,63.2,23686,5.3
3225,April 1981,Idaho,668000,430409,64.4,399678,59.8,30731,7.1
3226,April 1981,Illinois,8520000,5609822,65.8,5138889,60.3,470933,8.4
3227,April 1981,Indiana,4031000,2630587,65.3,2381850,59.1,248737,9.5
3228,April 1981,Iowa,2159000,1427541,66.1,1340209,62.1,87332,6.1
3229,April 1981,Kansas,1752000,1192046,68.0,1141624,65.2,50422,4.2
3230,April 1981,Kentucky,2670000,1670298,62.6,1532567,57.4,137731,8.2
3231,April 1981,Louisiana,3032000,1856869,61.2,1706311,56.3,150558,8.1
3232,April 1981,Maine,834000,508770,61.0,471852,56.6,36918,7.3
3233,April 1981,Maryland,3186000,2170766,68.1,2021089,63.4,149677,6.9
3234,April 1981,Massachusetts,4410000,2932106,66.5,2755749,62.5,176357,6.0
3235,April 1981,Michigan,6783000,4316837,63.6,3802805,56.1,514032,11.9
3236,April 1981,Minnesota,3039000,2118529,69.7,1999916,65.8,118613,5.6
3237,April 1981,Mississippi,1790000,1058148,59.1,971624,54.3,86524,8.2
3238,April 1981,Missouri,3683000,2331986,63.3,2160029,58.6,171957,7.4
3239,April 1981,Montana,580000,384567,66.3,359845,62.0,24722,6.4
3240,April 1981,Nebraska,1156000,773468,66.9,742892,64.3,30576,4.0
3241,April 1981,Nevada,628000,455724,72.6,424216,67.6,31508,6.9
3242,April 1981,New Hampshire,694000,475169,68.5,452077,65.1,23092,4.9
3243,April 1981,New Jersey,5650000,3625814,64.2,3355259,59.4,270555,7.5
3244,April 1981,New Mexico,939000,577390,61.5,534902,57.0,42488,7.4
3245,April 1981,New York,13375000,8073028,60.4,7451699,55.7,621329,7.7
3246,April 1981,North Carolina,4353000,2914514,67.0,2734553,62.8,179961,6.2
3247,April 1981,North Dakota,472000,307992,65.3,293040,62.1,14952,4.9
3248,April 1981,Ohio,8028000,5108473,63.6,4659060,58.0,449413,8.8
3249,April 1981,Oklahoma,2258000,1427166,63.2,1379454,61.1,47712,3.3
3250,April 1981,Oregon,1996000,1333240,66.8,1209382,60.6,123858,9.3
3251,April 1981,Pennsylvania,9097000,5485539,60.3,5045750,55.5,439789,8.0
3252,April 1981,Rhode Island,725000,475482,65.6,440498,60.8,34984,7.4
3253,April 1981,South Carolina,2258000,1432604,63.4,1324934,58.7,107670,7.5
3254,April 1981,South Dakota,497000,335099,67.4,318466,64.1,16633,5.0
3255,April 1981,Tennessee,3434000,2122286,61.8,1941614,56.5,180672,8.5
3256,April 1981,Texas,10477000,7018173,67.0,6652082,63.5,366091,5.2
3257,April 1981,Utah,984000,641079,65.2,600013,61.0,41066,6.4
3258,April 1981,Vermont,381000,256388,67.3,241916,63.5,14472,5.6
3259,April 1981,Virginia,3945000,2610678,66.2,2460415,62.4,150263,5.8
3260,April 1981,Washington,3111000,2001385,64.3,1822143,58.6,179242,9.0
3261,April 1981,West Virginia,1454000,790425,54.4,702419,48.3,88006,11.1
3262,April 1981,Wisconsin,3506000,2382253,67.9,2198056,62.7,184197,7.7
3263,April 1981,Wyoming,346000,248013,71.7,237810,68.7,10203,4.1
3264,May 1981,Alabama,2861000,1672850,58.5,1505327,52.6,167523,10.0
3265,May 1981,Alaska,272000,192839,70.9,175478,64.5,17361,9.0
3266,May 1981,Arizona,2044000,1269131,62.1,1195613,58.5,73518,5.8
3267,May 1981,Arkansas,1685000,1025152,60.8,936910,55.6,88242,8.6
3268,May 1981,California,18022000,11812249,65.5,10980904,60.9,831345,7.0
3269,May 1981,Colorado,2180000,1534706,70.4,1447378,66.4,87328,5.7
3270,May 1981,Connecticut,2394000,1597300,66.7,1499395,62.6,97905,6.1
3271,May 1981,Delaware,444000,287086,64.7,265232,59.7,21854,7.6
3272,May 1981,District of Columbia,489000,307651,62.9,280568,57.4,27083,8.8
3273,May 1981,Florida,7874000,4524184,57.5,4234939,53.8,289245,6.4
3274,May 1981,Georgia,4001000,2598913,65.0,2439868,61.0,159045,6.1
3275,May 1981,Hawaii,674000,449564,66.7,425805,63.2,23759,5.3
3276,May 1981,Idaho,669000,430438,64.3,399080,59.7,31358,7.3
3277,May 1981,Illinois,8525000,5608659,65.8,5144243,60.3,464416,8.3
3278,May 1981,Indiana,4033000,2627438,65.1,2378844,59.0,248594,9.5
3279,May 1981,Iowa,2160000,1427675,66.1,1339562,62.0,88113,6.2
3280,May 1981,Kansas,1753000,1191385,68.0,1142104,65.2,49281,4.1
3281,May 1981,Kentucky,2672000,1665795,62.3,1529508,57.2,136287,8.2
3282,May 1981,Louisiana,3037000,1860028,61.2,1707033,56.2,152995,8.2
3283,May 1981,Maine,834000,509193,61.1,472916,56.7,36277,7.1
3284,May 1981,Maryland,3190000,2171362,68.1,2020178,63.3,151184,7.0
3285,May 1981,Massachusetts,4414000,2939240,66.6,2758330,62.5,180910,6.2
3286,May 1981,Michigan,6784000,4313329,63.6,3805420,56.1,507909,11.8
3287,May 1981,Minnesota,3042000,2117185,69.6,2000334,65.8,116851,5.5
3288,May 1981,Mississippi,1792000,1057149,59.0,970937,54.2,86212,8.2
3289,May 1981,Missouri,3685000,2328680,63.2,2159674,58.6,169006,7.3
3290,May 1981,Montana,581000,384652,66.2,359585,61.9,25067,6.5
3291,May 1981,Nebraska,1157000,774278,66.9,743415,64.3,30863,4.0
3292,May 1981,Nevada,630000,458348,72.8,427119,67.8,31229,6.8
3293,May 1981,New Hampshire,696000,475812,68.4,452708,65.0,23104,4.9
3294,May 1981,New Jersey,5656000,3621194,64.0,3354061,59.3,267133,7.4
3295,May 1981,New Mexico,941000,577546,61.4,535738,56.9,41808,7.2
3296,May 1981,New York,13381000,8065869,60.3,7452784,55.7,613085,7.6
3297,May 1981,North Carolina,4359000,2914216,66.9,2740285,62.9,173931,6.0
3298,May 1981,North Dakota,472000,308245,65.3,293441,62.2,14804,4.8
3299,May 1981,Ohio,8032000,5103083,63.5,4656242,58.0,446841,8.8
3300,May 1981,Oklahoma,2262000,1432983,63.4,1385586,61.3,47397,3.3
3301,May 1981,Oregon,1998000,1333864,66.8,1209248,60.5,124616,9.3
3302,May 1981,Pennsylvania,9102000,5489945,60.3,5047349,55.5,442596,8.1
3303,May 1981,Rhode Island,726000,475851,65.5,440375,60.7,35476,7.5
3304,May 1981,South Carolina,2261000,1434154,63.4,1325470,58.6,108684,7.6
3305,May 1981,South Dakota,497000,334797,67.4,318464,64.1,16333,4.9
3306,May 1981,Tennessee,3437000,2122053,61.7,1942446,56.5,179607,8.5
3307,May 1981,Texas,10504000,7044569,67.1,6676419,63.6,368150,5.2
3308,May 1981,Utah,986000,642935,65.2,601760,61.0,41175,6.4
3309,May 1981,Vermont,381000,257272,67.5,242725,63.7,14547,5.7
3310,May 1981,Virginia,3951000,2612572,66.1,2460443,62.3,152129,5.8
3311,May 1981,Washington,3117000,2000816,64.2,1818619,58.3,182197,9.1
3312,May 1981,West Virginia,1455000,789401,54.3,701687,48.2,87714,11.1
3313,May 1981,Wisconsin,3510000,2380629,67.8,2198840,62.6,181789,7.6
3314,May 1981,Wyoming,347000,249260,71.8,239208,68.9,10052,4.0
3315,June 1981,Alabama,2864000,1671571,58.4,1501932,52.4,169639,10.1
3316,June 1981,Alaska,272000,194487,71.5,176653,64.9,17834,9.2
3317,June 1981,Arizona,2049000,1272475,62.1,1198557,58.5,73918,5.8
3318,June 1981,Arkansas,1687000,1026941,60.9,938083,55.6,88858,8.7
3319,June 1981,California,18054000,11815527,65.4,10982132,60.8,833395,7.1
3320,June 1981,Colorado,2185000,1539179,70.4,1453271,66.5,85908,5.6
3321,June 1981,Connecticut,2397000,1597635,66.7,1499801,62.6,97834,6.1
3322,June 1981,Delaware,445000,287345,64.6,265550,59.7,21795,7.6
3323,June 1981,District of Columbia,488000,305863,62.7,278611,57.1,27252,8.9
3324,June 1981,Florida,7899000,4537022,57.4,4245616,53.7,291406,6.4
3325,June 1981,Georgia,4008000,2600132,64.9,2442713,60.9,157419,6.1
3326,June 1981,Hawaii,675000,450165,66.7,426279,63.2,23886,5.3
3327,June 1981,Idaho,670000,430254,64.2,398136,59.4,32118,7.5
3328,June 1981,Illinois,8530000,5602645,65.7,5142340,60.3,460305,8.2
3329,June 1981,Indiana,4035000,2621806,65.0,2373349,58.8,248457,9.5
3330,June 1981,Iowa,2161000,1427215,66.0,1337789,61.9,89426,6.3
3331,June 1981,Kansas,1755000,1189792,67.8,1141396,65.0,48396,4.1
3332,June 1981,Kentucky,2674000,1661115,62.1,1525862,57.1,135253,8.1
3333,June 1981,Louisiana,3043000,1860713,61.1,1706073,56.1,154640,8.3
3334,June 1981,Maine,835000,509580,61.0,473665,56.7,35915,7.0
3335,June 1981,Maryland,3195000,2171222,68.0,2018224,63.2,152998,7.0
3336,June 1981,Massachusetts,4418000,2944417,66.6,2758620,62.4,185797,6.3
3337,June 1981,Michigan,6786000,4305527,63.4,3801352,56.0,504175,11.7
3338,June 1981,Minnesota,3045000,2116302,69.5,2000483,65.7,115819,5.5
3339,June 1981,Mississippi,1794000,1056555,58.9,969978,54.1,86577,8.2
3340,June 1981,Missouri,3688000,2323564,63.0,2156426,58.5,167138,7.2
3341,June 1981,Montana,581000,384679,66.2,359137,61.8,25542,6.6
3342,June 1981,Nebraska,1158000,775014,66.9,743563,64.2,31451,4.1
3343,June 1981,Nevada,633000,461140,72.8,429928,67.9,31212,6.8
3344,June 1981,New Hampshire,697000,476578,68.4,453298,65.0,23280,4.9
3345,June 1981,New Jersey,5661000,3612361,63.8,3349586,59.2,262775,7.3
3346,June 1981,New Mexico,943000,577501,61.2,536284,56.9,41217,7.1
3347,June 1981,New York,13388000,8047169,60.1,7445355,55.6,601814,7.5
3348,June 1981,North Carolina,4365000,2908443,66.6,2741148,62.8,167295,5.8
3349,June 1981,North Dakota,473000,308674,65.3,293954,62.1,14720,4.8
3350,June 1981,Ohio,8035000,5097219,63.4,4649148,57.9,448071,8.8
3351,June 1981,Oklahoma,2266000,1437898,63.5,1390183,61.3,47715,3.3
3352,June 1981,Oregon,2000000,1333566,66.7,1208052,60.4,125514,9.4
3353,June 1981,Pennsylvania,9107000,5489504,60.3,5044192,55.4,445312,8.1
3354,June 1981,Rhode Island,726000,476120,65.6,440096,60.6,36024,7.6
3355,June 1981,South Carolina,2265000,1435676,63.4,1325664,58.5,110012,7.7
3356,June 1981,South Dakota,497000,334548,67.3,318397,64.1,16151,4.8
3357,June 1981,Tennessee,3441000,2117756,61.5,1938594,56.3,179162,8.5
3358,June 1981,Texas,10530000,7065709,67.1,6695768,63.6,369941,5.2
3359,June 1981,Utah,989000,645022,65.2,603563,61.0,41459,6.4
3360,June 1981,Vermont,382000,258018,67.5,243345,63.7,14673,5.7
3361,June 1981,Virginia,3957000,2611629,66.0,2458490,62.1,153139,5.9
3362,June 1981,Washington,3122000,1999571,64.0,1814175,58.1,185396,9.3
3363,June 1981,West Virginia,1456000,787965,54.1,702029,48.2,85936,10.9
3364,June 1981,Wisconsin,3513000,2377774,67.7,2197028,62.5,180746,7.6
3365,June 1981,Wyoming,348000,250361,71.9,240414,69.1,9947,4.0
3366,July 1981,Alabama,2867000,1671841,58.3,1498870,52.3,172971,10.3
3367,July 1981,Alaska,273000,196408,71.9,177994,65.2,18414,9.4
3368,July 1981,Arizona,2054000,1274735,62.1,1199700,58.4,75035,5.9
3369,July 1981,Arkansas,1688000,1027891,60.9,938496,55.6,89395,8.7
3370,July 1981,California,18085000,11819958,65.4,10976711,60.7,843247,7.1
3371,July 1981,Colorado,2190000,1543378,70.5,1458368,66.6,85010,5.5
3372,July 1981,Connecticut,2399000,1597529,66.6,1499732,62.5,97797,6.1
3373,July 1981,Delaware,445000,287627,64.6,265753,59.7,21874,7.6
3374,July 1981,District of Columbia,488000,304349,62.4,276974,56.8,27375,9.0
3375,July 1981,Florida,7924000,4545626,57.4,4249835,53.6,295791,6.5
3376,July 1981,Georgia,4016000,2600845,64.8,2443375,60.8,157470,6.1
3377,July 1981,Hawaii,676000,450753,66.7,426652,63.1,24101,5.3
3378,July 1981,Idaho,671000,430010,64.1,397071,59.2,32939,7.7
3379,July 1981,Illinois,8535000,5594668,65.5,5134632,60.2,460036,8.2
3380,July 1981,Indiana,4037000,2615743,64.8,2365824,58.6,249919,9.6
3381,July 1981,Iowa,2162000,1426499,66.0,1335099,61.8,91400,6.4
3382,July 1981,Kansas,1756000,1187707,67.6,1139626,64.9,48081,4.0
3383,July 1981,Kentucky,2676000,1657847,62.0,1521900,56.9,135947,8.2
3384,July 1981,Louisiana,3048000,1859735,61.0,1703779,55.9,155956,8.4
3385,July 1981,Maine,836000,510029,61.0,474075,56.7,35954,7.0
3386,July 1981,Maryland,3199000,2171009,67.9,2015423,63.0,155586,7.2
3387,July 1981,Massachusetts,4422000,2948245,66.7,2757117,62.4,191128,6.5
3388,July 1981,Michigan,6787000,4297270,63.3,3790878,55.9,506392,11.8
3389,July 1981,Minnesota,3048000,2116976,69.5,2000420,65.6,116556,5.5
3390,July 1981,Mississippi,1796000,1056658,58.8,968967,54.0,87691,8.3
3391,July 1981,Missouri,3690000,2318620,62.8,2150785,58.3,167835,7.2
3392,July 1981,Montana,582000,384865,66.1,358710,61.6,26155,6.8
3393,July 1981,Nebraska,1159000,775696,66.9,743377,64.1,32319,4.2
3394,July 1981,Nevada,635000,464157,73.1,432491,68.1,31666,6.8
3395,July 1981,New Hampshire,698000,477502,68.4,453792,65.0,23710,5.0
3396,July 1981,New Jersey,5667000,3601692,63.6,3342830,59.0,258862,7.2
3397,July 1981,New Mexico,945000,577534,61.1,536733,56.8,40801,7.1
3398,July 1981,New York,13395000,8023540,59.9,7431197,55.5,592343,7.4
3399,July 1981,North Carolina,4371000,2900431,66.4,2738070,62.6,162361,5.6
3400,July 1981,North Dakota,473000,309310,65.4,294626,62.3,14684,4.7
3401,July 1981,Ohio,8039000,5094120,63.4,4637601,57.7,456519,9.0
3402,July 1981,Oklahoma,2270000,1442138,63.5,1393451,61.4,48687,3.4
3403,July 1981,Oregon,2002000,1333268,66.6,1205917,60.2,127351,9.6
3404,July 1981,Pennsylvania,9112000,5486149,60.2,5036483,55.3,449666,8.2
3405,July 1981,Rhode Island,727000,476392,65.5,439718,60.5,36674,7.7
3406,July 1981,South Carolina,2269000,1438271,63.4,1325618,58.4,112653,7.8
3407,July 1981,South Dakota,497000,334365,67.3,318249,64.0,16116,4.8
3408,July 1981,Tennessee,3444000,2111560,61.3,1930590,56.1,180970,8.6
3409,July 1981,Texas,10557000,7083018,67.1,6710972,63.6,372046,5.3
3410,July 1981,Utah,991000,647305,65.3,605438,61.1,41867,6.5
3411,July 1981,Vermont,382000,258577,67.7,243761,63.8,14816,5.7
3412,July 1981,Virginia,3963000,2609567,65.8,2454984,61.9,154583,5.9
3413,July 1981,Washington,3128000,1997629,63.9,1808523,57.8,189106,9.5
3414,July 1981,West Virginia,1457000,786308,54.0,703099,48.3,83209,10.6
3415,July 1981,Wisconsin,3516000,2375329,67.6,2193278,62.4,182051,7.7
3416,July 1981,Wyoming,349000,251298,72.0,241391,69.2,9907,3.9
3417,August 1981,Alabama,2869000,1673850,58.3,1495841,52.1,178009,10.6
3418,August 1981,Alaska,275000,198436,72.2,179459,65.3,18977,9.6
3419,August 1981,Arizona,2060000,1276661,62.0,1199382,58.2,77279,6.1
3420,August 1981,Arkansas,1689000,1028092,60.9,937972,55.5,90120,8.8
3421,August 1981,California,18116000,11830962,65.3,10967452,60.5,863510,7.3
3422,August 1981,Colorado,2196000,1547326,70.5,1462438,66.6,84888,5.5
3423,August 1981,Connecticut,2401000,1597375,66.5,1499327,62.4,98048,6.1
3424,August 1981,Delaware,446000,288005,64.6,265844,59.6,22161,7.7
3425,August 1981,District of Columbia,488000,303200,62.1,275750,56.5,27450,9.1
3426,August 1981,Florida,7944000,4552729,57.3,4250198,53.5,302531,6.6
3427,August 1981,Georgia,4022000,2603125,64.7,2442089,60.7,161036,6.2
3428,August 1981,Hawaii,677000,451320,66.7,426925,63.1,24395,5.4
3429,August 1981,Idaho,672000,429867,64.0,396016,58.9,33851,7.9
3430,August 1981,Illinois,8537000,5587195,65.4,5123127,60.0,464068,8.3
3431,August 1981,Indiana,4038000,2610970,64.7,2356634,58.4,254336,9.7
3432,August 1981,Iowa,2162000,1425968,66.0,1331778,61.6,94190,6.6
3433,August 1981,Kansas,1757000,1185571,67.5,1137020,64.7,48551,4.1
3434,August 1981,Kentucky,2678000,1656657,61.9,1517798,56.7,138859,8.4
3435,August 1981,Louisiana,3053000,1857927,60.9,1700474,55.7,157453,8.5
3436,August 1981,Maine,837000,510537,61.0,474191,56.7,36346,7.1
3437,August 1981,Maryland,3202000,2171180,67.8,2012109,62.8,159071,7.3
3438,August 1981,Massachusetts,4424000,2951512,66.7,2754619,62.3,196893,6.7
3439,August 1981,Michigan,6784000,4291716,63.3,3775017,55.6,516699,12.0
3440,August 1981,Minnesota,3050000,2119387,69.5,2000167,65.6,119220,5.6
3441,August 1981,Mississippi,1798000,1057478,58.8,968051,53.8,89427,8.5
3442,August 1981,Missouri,3691000,2315111,62.7,2143634,58.1,171477,7.4
3443,August 1981,Montana,583000,385237,66.1,358395,61.5,26842,7.0
3444,August 1981,Nebraska,1159000,776358,67.0,742980,64.1,33378,4.3
3445,August 1981,Nevada,637000,467365,73.4,434744,68.2,32621,7.0
3446,August 1981,New Hampshire,699000,478527,68.5,454123,65.0,24404,5.1
3447,August 1981,New Jersey,5671000,3591959,63.3,3335009,58.8,256950,7.2
3448,August 1981,New Mexico,947000,577888,61.0,537222,56.7,40666,7.0
3449,August 1981,New York,13401000,8001955,59.7,7413239,55.3,588716,7.4
3450,August 1981,North Carolina,4377000,2892899,66.1,2732204,62.4,160695,5.6
3451,August 1981,North Dakota,474000,310099,65.4,295405,62.3,14694,4.7
3452,August 1981,Ohio,8040000,5094454,63.4,4622209,57.5,472245,9.3
3453,August 1981,Oklahoma,2277000,1446232,63.5,1395828,61.3,50404,3.5
3454,August 1981,Oregon,2002000,1333543,66.6,1202984,60.1,130559,9.8
3455,August 1981,Pennsylvania,9115000,5481468,60.1,5024386,55.1,457082,8.3
3456,August 1981,Rhode Island,727000,476686,65.6,439212,60.4,37474,7.9
3457,August 1981,South Carolina,2272000,1442346,63.5,1325306,58.3,117040,8.1
3458,August 1981,South Dakota,497000,334161,67.2,317986,64.0,16175,4.8
3459,August 1981,Tennessee,3447000,2105282,61.1,1919974,55.7,185308,8.8
3460,August 1981,Texas,10593000,7098212,67.0,6723539,63.5,374673,5.3
3461,August 1981,Utah,993000,649701,65.4,607339,61.2,42362,6.5
3462,August 1981,Vermont,382000,258953,67.8,243972,63.9,14981,5.8
3463,August 1981,Virginia,3968000,2607863,65.7,2450582,61.8,157281,6.0
3464,August 1981,Washington,3131000,1995409,63.7,1801718,57.5,193691,9.7
3465,August 1981,West Virginia,1458000,784571,53.8,704149,48.3,80422,10.3
3466,August 1981,Wisconsin,3518000,2374335,67.5,2188501,62.2,185834,7.8
3467,August 1981,Wyoming,350000,252053,72.0,242123,69.2,9930,3.9
3468,September 1981,Alabama,2871000,1677086,58.4,1492621,52.0,184465,11.0
3469,September 1981,Alaska,276000,200361,72.6,180938,65.6,19423,9.7
3470,September 1981,Arizona,2065000,1279101,61.9,1198501,58.0,80600,6.3
3471,September 1981,Arkansas,1690000,1027595,60.8,936349,55.4,91246,8.9
3472,September 1981,California,18146000,11850437,65.3,10957820,60.4,892617,7.5
3473,September 1981,Colorado,2202000,1550975,70.4,1465458,66.6,85517,5.5
3474,September 1981,Connecticut,2402000,1597600,66.5,1498891,62.4,98709,6.2
3475,September 1981,Delaware,446000,288579,64.7,265895,59.6,22684,7.9
3476,September 1981,District of Columbia,487000,302464,62.1,274941,56.5,27523,9.1
3477,September 1981,Florida,7965000,4561017,57.3,4250202,53.4,310815,6.8
3478,September 1981,Georgia,4028000,2607562,64.7,2439821,60.6,167741,6.4
3479,September 1981,Hawaii,678000,451860,66.6,427062,63.0,24798,5.5
3480,September 1981,Idaho,673000,430040,63.9,395025,58.7,35015,8.1
3481,September 1981,Illinois,8539000,5581621,65.4,5110122,59.8,471499,8.4
3482,September 1981,Indiana,4039000,2607870,64.6,2346305,58.1,261565,10.0
3483,September 1981,Iowa,2161000,1425894,66.0,1328327,61.5,97567,6.8
3484,September 1981,Kansas,1759000,1183654,67.3,1133878,64.5,49776,4.2
3485,September 1981,Kentucky,2680000,1657389,61.8,1513783,56.5,143606,8.7
3486,September 1981,Louisiana,3059000,1856341,60.7,1696746,55.5,159595,8.6
3487,September 1981,Maine,837000,511096,61.1,474099,56.6,36997,7.2
3488,September 1981,Maryland,3204000,2171929,67.8,2008675,62.7,163254,7.5
3489,September 1981,Massachusetts,4426000,2954963,66.8,2752172,62.2,202791,6.9
3490,September 1981,Michigan,6782000,4289576,63.2,3755842,55.4,533734,12.4
3491,September 1981,Minnesota,3052000,2122914,69.6,1999730,65.5,123184,5.8
3492,September 1981,Mississippi,1799000,1059014,58.9,967330,53.8,91684,8.7
3493,September 1981,Missouri,3692000,2313582,62.7,2136244,57.9,177338,7.7
3494,September 1981,Montana,583000,385690,66.2,358140,61.4,27550,7.1
3495,September 1981,Nebraska,1160000,777039,67.0,742545,64.0,34494,4.4
3496,September 1981,Nevada,639000,470672,73.7,436661,68.3,34011,7.2
3497,September 1981,New Hampshire,700000,479574,68.5,454244,64.9,25330,5.3
3498,September 1981,New Jersey,5675000,3586165,63.2,3327394,58.6,258771,7.2
3499,September 1981,New Mexico,949000,578708,61.0,537811,56.7,40897,7.1
3500,September 1981,New York,13407000,7986251,59.6,7395151,55.2,591100,7.4
3501,September 1981,North Carolina,4383000,2887097,65.9,2724976,62.2,162121,5.6
3502,September 1981,North Dakota,474000,310936,65.6,296202,62.5,14734,4.7
3503,September 1981,Ohio,8041000,5097369,63.4,4604683,57.3,492686,9.7
3504,September 1981,Oklahoma,2284000,1450822,63.5,1397910,61.2,52912,3.6
3505,September 1981,Oregon,2002000,1334242,66.6,1199506,59.9,134736,10.1
3506,September 1981,Pennsylvania,9118000,5477651,60.1,5009005,54.9,468646,8.6
3507,September 1981,Rhode Island,728000,476885,65.5,438497,60.2,38388,8.0
3508,September 1981,South Carolina,2276000,1447448,63.6,1324675,58.2,122773,8.5
3509,September 1981,South Dakota,497000,333813,67.2,317583,63.9,16230,4.9
3510,September 1981,Tennessee,3450000,2100305,60.9,1908839,55.3,191466,9.1
3511,September 1981,Texas,10629000,7113539,66.9,6735583,63.4,377956,5.3
3512,September 1981,Utah,995000,652219,65.5,609203,61.2,43016,6.6
3513,September 1981,Vermont,383000,259173,67.7,243993,63.7,15180,5.9
3514,September 1981,Virginia,3973000,2607510,65.6,2446256,61.6,161254,6.2
3515,September 1981,Washington,3133000,1993816,63.6,1794338,57.3,199478,10.0
3516,September 1981,West Virginia,1458000,782930,53.7,704370,48.3,78560,10.0
3517,September 1981,Wisconsin,3520000,2375078,67.5,2183797,62.0,191281,8.1
3518,September 1981,Wyoming,351000,252638,72.0,242627,69.1,10011,4.0
3519,October 1981,Alabama,2873000,1680936,58.5,1489212,51.8,191724,11.4
3520,October 1981,Alaska,278000,202021,72.7,182304,65.6,19717,9.8
3521,October 1981,Arizona,2071000,1282772,61.9,1197844,57.8,84928,6.6
3522,October 1981,Arkansas,1690000,1026531,60.7,933749,55.3,92782,9.0
3523,October 1981,California,18177000,11878918,65.4,10950543,60.2,928375,7.8
3524,October 1981,Colorado,2207000,1554417,70.4,1467451,66.5,86966,5.6
3525,October 1981,Connecticut,2404000,1598472,66.5,1498602,62.3,99870,6.2
3526,October 1981,Delaware,447000,289413,64.7,266035,59.5,23378,8.1
3527,October 1981,District of Columbia,487000,302183,62.0,274490,56.4,27693,9.2
3528,October 1981,Florida,7985000,4572837,57.3,4252585,53.3,320252,7.0
3529,October 1981,Georgia,4034000,2613700,64.8,2437841,60.4,175859,6.7
3530,October 1981,Hawaii,679000,452382,66.6,427010,62.9,25372,5.6
3531,October 1981,Idaho,673000,430638,64.0,394161,58.6,36477,8.5
3532,October 1981,Illinois,8541000,5578844,65.3,5097157,59.7,481687,8.6
3533,October 1981,Indiana,4040000,2606383,64.5,2335431,57.8,270952,10.4
3534,October 1981,Iowa,2161000,1426210,66.0,1324964,61.3,101246,7.1
3535,October 1981,Kansas,1760000,1182182,67.2,1130557,64.2,51625,4.4
3536,October 1981,Kentucky,2681000,1659397,61.9,1509940,56.3,149457,9.0
3537,October 1981,Louisiana,3064000,1856121,60.6,1693316,55.3,162805,8.8
3538,October 1981,Maine,838000,511747,61.1,473878,56.5,37869,7.4
3539,October 1981,Maryland,3207000,2173402,67.8,2005434,62.5,167968,7.7
3540,October 1981,Massachusetts,4427000,2959062,66.8,2750491,62.1,208571,7.0
3541,October 1981,Michigan,6779000,4290734,63.3,3735580,55.1,555154,12.9
3542,October 1981,Minnesota,3054000,2126921,69.6,1999119,65.5,127802,6.0
3543,October 1981,Mississippi,1801000,1061190,58.9,966928,53.7,94262,8.9
3544,October 1981,Missouri,3693000,2314213,62.7,2129745,57.7,184468,8.0
3545,October 1981,Montana,584000,386155,66.1,357858,61.3,28297,7.3
3546,October 1981,Nebraska,1160000,777788,67.1,742185,64.0,35603,4.6
3547,October 1981,Nevada,641000,473885,73.9,438230,68.4,35655,7.5
3548,October 1981,New Hampshire,701000,480635,68.6,454229,64.8,26406,5.5
3549,October 1981,New Jersey,5679000,3586212,63.1,3320750,58.5,265462,7.4
3550,October 1981,New Mexico,951000,579957,61.0,538495,56.6,41462,7.1
3551,October 1981,New York,13413000,7978150,59.5,7379824,55.0,598326,7.5
3552,October 1981,North Carolina,4388000,2933640,66.9,2717519,61.9,216121,7.4
3553,October 1981,North Dakota,475000,311705,65.6,296936,62.5,14769,4.7
3554,October 1981,Ohio,8041000,5102884,63.5,4586749,57.0,516135,10.1
3555,October 1981,Oklahoma,2291000,1456267,63.6,1400123,61.1,56144,3.9
3556,October 1981,Oregon,2002000,1334974,66.7,1195656,59.7,139318,10.4
3557,October 1981,Pennsylvania,9121000,5476482,60.0,4991906,54.7,484576,8.8
3558,October 1981,Rhode Island,728000,476899,65.5,437550,60.1,39349,8.3
3559,October 1981,South Carolina,2279000,1452772,63.7,1323745,58.1,129027,8.9
3560,October 1981,South Dakota,497000,333310,67.1,317077,63.8,16233,4.9
3561,October 1981,Tennessee,3453000,2097969,60.8,1898871,55.0,199098,9.5
3562,October 1981,Texas,10665000,7131325,66.9,6748482,63.3,382843,5.4
3563,October 1981,Utah,997000,654832,65.7,610961,61.3,43871,6.7
3564,October 1981,Vermont,383000,259311,67.7,243910,63.7,15401,5.9
3565,October 1981,Virginia,3978000,2609243,65.6,2442725,61.4,166518,6.4
3566,October 1981,Washington,3136000,1993449,63.6,1787201,57.0,206248,10.3
3567,October 1981,West Virginia,1459000,781603,53.6,703166,48.2,78437,10.0
3568,October 1981,Wisconsin,3522000,2377145,67.5,2180176,61.9,196969,8.3
3569,October 1981,Wyoming,351000,253051,72.1,242959,69.2,10092,4.0
3570,November 1981,Alabama,2875000,1684875,58.6,1485690,51.7,199185,11.8
3571,November 1981,Alaska,279000,203338,72.9,183450,65.8,19888,9.8
3572,November 1981,Arizona,2076000,1287452,62.0,1197343,57.7,90109,7.0
3573,November 1981,Arkansas,1691000,1024988,60.6,930337,55.0,94651,9.2
3574,November 1981,California,18208000,11912986,65.4,10944658,60.1,968328,8.1
3575,November 1981,Colorado,2213000,1557569,70.4,1468285,66.3,89284,5.7
3576,November 1981,Connecticut,2405000,1599785,66.5,1498255,62.3,101530,6.3
3577,November 1981,Delaware,447000,290494,65.0,266369,59.6,24125,8.3
3578,November 1981,District of Columbia,487000,302274,62.1,274231,56.3,28043,9.3
3579,November 1981,Florida,8005000,4587058,57.3,4256573,53.2,330485,7.2
3580,November 1981,Georgia,4040000,2620446,64.9,2436351,60.3,184095,7.0
3581,November 1981,Hawaii,681000,452833,66.5,426732,62.7,26101,5.8
3582,November 1981,Idaho,674000,431626,64.0,393478,58.4,38148,8.8
3583,November 1981,Illinois,8543000,5577876,65.3,5083402,59.5,494474,8.9
3584,November 1981,Indiana,4041000,2605506,64.5,2324126,57.5,281380,10.8
3585,November 1981,Iowa,2161000,1426490,66.0,1321330,61.1,105160,7.4
3586,November 1981,Kansas,1761000,1181148,67.1,1127257,64.0,53891,4.6
3587,November 1981,Kentucky,2683000,1661849,61.9,1506271,56.1,155578,9.4
3588,November 1981,Louisiana,3069000,1857119,60.5,1690199,55.1,166920,9.0
3589,November 1981,Maine,838000,512454,61.2,473539,56.5,38915,7.6
3590,November 1981,Maryland,3209000,2175332,67.8,2002392,62.4,172940,8.0
3591,November 1981,Massachusetts,4429000,2963182,66.9,2749245,62.1,213937,7.2
3592,November 1981,Michigan,6776000,4292698,63.4,3714184,54.8,578514,13.5
3593,November 1981,Minnesota,3056000,2130693,69.7,1998117,65.4,132576,6.2
3594,November 1981,Mississippi,1803000,1063451,59.0,966397,53.6,97054,9.1
3595,November 1981,Missouri,3694000,2315399,62.7,2124132,57.5,191267,8.3
3596,November 1981,Montana,584000,386553,66.2,357425,61.2,29128,7.5
3597,November 1981,Nebraska,1161000,778530,67.1,741873,63.9,36657,4.7
3598,November 1981,Nevada,643000,476738,74.1,439304,68.3,37434,7.9
3599,November 1981,New Hampshire,702000,481702,68.6,454100,64.7,27602,5.7
3600,November 1981,New Jersey,5683000,3590243,63.2,3314187,58.3,276056,7.7
3601,November 1981,New Mexico,953000,581431,61.0,539143,56.6,42288,7.3
3602,November 1981,New York,13419000,7975144,59.4,7365850,54.9,609294,7.6
3603,November 1981,North Carolina,4394000,2945809,67.0,2709304,61.7,236505,8.0
3604,November 1981,North Dakota,475000,312320,65.8,297479,62.6,14841,4.8
3605,November 1981,Ohio,8042000,5109721,63.5,4568619,56.8,541102,10.6
3606,November 1981,Oklahoma,2298000,1462102,63.6,1402314,61.0,59788,4.1
3607,November 1981,Oregon,2002000,1335216,66.7,1191299,59.5,143917,10.8
3608,November 1981,Pennsylvania,9124000,5477530,60.0,4974067,54.5,503463,9.2
3609,November 1981,Rhode Island,729000,476721,65.4,436365,59.9,40356,8.5
3610,November 1981,South Carolina,2283000,1457677,63.8,1322586,57.9,135091,9.3
3611,November 1981,South Dakota,497000,332761,67.0,316519,63.7,16242,4.9
3612,November 1981,Tennessee,3456000,2097860,60.7,1890065,54.7,207795,9.9
3613,November 1981,Texas,10701000,7151260,66.8,6761143,63.2,390117,5.5
3614,November 1981,Utah,1000000,657417,65.7,612516,61.3,44901,6.8
3615,November 1981,Vermont,384000,259498,67.6,243785,63.5,15713,6.1
3616,November 1981,Virginia,3983000,2612396,65.6,2439634,61.3,172762,6.6
3617,November 1981,Washington,3139000,1994113,63.5,1780767,56.7,213346,10.7
3618,November 1981,West Virginia,1459000,780674,53.5,700792,48.0,79882,10.2
3619,November 1981,Wisconsin,3524000,2380172,67.5,2177440,61.8,202732,8.5
3620,November 1981,Wyoming,352000,253329,72.0,243173,69.1,10156,4.0
3621,December 1981,Alabama,2877000,1688747,58.7,1482607,51.5,206140,12.2
3622,December 1981,Alaska,281000,204382,72.7,184377,65.6,20005,9.8
3623,December 1981,Arizona,2082000,1292880,62.1,1197008,57.5,95872,7.4
3624,December 1981,Arkansas,1692000,1023165,60.5,926552,54.8,96613,9.4
3625,December 1981,California,18238000,11949861,65.5,10940402,60.0,1009459,8.4
3626,December 1981,Colorado,2219000,1560750,70.3,1468509,66.2,92241,5.9
3627,December 1981,Connecticut,2407000,1601229,66.5,1497862,62.2,103367,6.5
3628,December 1981,Delaware,448000,291729,65.1,266950,59.6,24779,8.5
3629,December 1981,District of Columbia,486000,302641,62.3,274041,56.4,28600,9.5
3630,December 1981,Florida,8025000,4602989,57.4,4261667,53.1,341322,7.4
3631,December 1981,Georgia,4046000,2626960,64.9,2435741,60.2,191219,7.3
3632,December 1981,Hawaii,682000,453182,66.4,426286,62.5,26896,5.9
3633,December 1981,Idaho,675000,432974,64.1,393063,58.2,39911,9.2
3634,December 1981,Illinois,8545000,5578264,65.3,5068972,59.3,509292,9.1
3635,December 1981,Indiana,4042000,2604457,64.4,2313359,57.2,291098,11.2
3636,December 1981,Iowa,2160000,1426449,66.0,1317405,61.0,109044,7.6
3637,December 1981,Kansas,1763000,1180580,67.0,1124260,63.8,56320,4.8
3638,December 1981,Kentucky,2685000,1664396,62.0,1503220,56.0,161176,9.7
3639,December 1981,Louisiana,3075000,1858988,60.5,1687532,54.9,171456,9.2
3640,December 1981,Maine,839000,513261,61.2,473215,56.4,40046,7.8
3641,December 1981,Maryland,3212000,2177302,67.8,1999643,62.3,177659,8.2
3642,December 1981,Massachusetts,4431000,2967253,67.0,2748489,62.0,218764,7.4
3643,December 1981,Michigan,6773000,4293563,63.4,3692659,54.5,600904,14.0
3644,December 1981,Minnesota,3058000,2133925,69.8,1996665,65.3,137260,6.4
3645,December 1981,Mississippi,1804000,1065387,59.1,965202,53.5,100185,9.4
3646,December 1981,Missouri,3695000,2315844,62.7,2119743,57.4,196101,8.5
3647,December 1981,Montana,585000,386825,66.1,356831,61.0,29994,7.8
3648,December 1981,Nebraska,1161000,779234,67.1,741552,63.9,37682,4.8
3649,December 1981,Nevada,645000,479009,74.3,439737,68.2,39272,8.2
3650,December 1981,New Hampshire,703000,482705,68.7,453823,64.6,28882,6.0
3651,December 1981,New Jersey,5687000,3596134,63.2,3307600,58.2,288534,8.0
3652,December 1981,New Mexico,955000,583030,61.1,539610,56.5,43420,7.4
3653,December 1981,New York,13425000,7974771,59.4,7352769,54.8,622002,7.8
3654,December 1981,North Carolina,4400000,2946993,67.0,2700438,61.4,246555,8.4
3655,December 1981,North Dakota,476000,312784,65.7,297752,62.6,15032,4.8
3656,December 1981,Ohio,8043000,5116666,63.6,4551217,56.6,565449,11.1
3657,December 1981,Oklahoma,2305000,1467781,63.7,1404440,60.9,63341,4.3
3658,December 1981,Oregon,2002000,1334651,66.7,1186643,59.3,148008,11.1
3659,December 1981,Pennsylvania,9127000,5480580,60.0,4957706,54.3,522874,9.5
3660,December 1981,Rhode Island,729000,476469,65.4,435005,59.7,41464,8.7
3661,December 1981,South Carolina,2286000,1462205,64.0,1321358,57.8,140847,9.6
3662,December 1981,South Dakota,497000,332278,66.9,315985,63.6,16293,4.9
3663,December 1981,Tennessee,3459000,2099187,60.7,1882546,54.4,216641,10.3
3664,December 1981,Texas,10737000,7173437,66.8,6773572,63.1,399865,5.6
3665,December 1981,Utah,1002000,660007,65.9,613925,61.3,46082,7.0
3666,December 1981,Vermont,384000,259876,67.7,243704,63.5,16172,6.2
3667,December 1981,Virginia,3988000,2616411,65.6,2437326,61.1,179085,6.8
3668,December 1981,Washington,3141000,1995627,63.5,1775557,56.5,220070,11.0
3669,December 1981,West Virginia,1460000,780291,53.4,698401,47.8,81890,10.5
3670,December 1981,Wisconsin,3526000,2384693,67.6,2175353,61.7,209340,8.8
3671,December 1981,Wyoming,353000,253617,71.8,243328,68.9,10289,4.1
3672,January 1982,Alabama,2879000,1692641,58.8,1480603,51.4,212038,12.5
3673,January 1982,Alaska,282000,205311,72.8,185187,65.7,20124,9.8
3674,January 1982,Arizona,2087000,1299433,62.3,1197337,57.4,102096,7.9
3675,January 1982,Arkansas,1693000,1021363,60.3,923128,54.5,98235,9.6
3676,January 1982,California,18269000,11988148,65.6,10940606,59.9,1047542,8.7
3677,January 1982,Colorado,2225000,1564617,70.3,1469226,66.0,95391,6.1
3678,January 1982,Connecticut,2408000,1602933,66.6,1497846,62.2,105087,6.6
3679,January 1982,Delaware,448000,292984,65.4,267743,59.8,25241,8.6
3680,January 1982,District of Columbia,486000,303219,62.4,273897,56.4,29322,9.7
3681,January 1982,Florida,8046000,4621396,57.4,4269730,53.1,351666,7.6
3682,January 1982,Georgia,4052000,2633094,65.0,2437051,60.1,196043,7.4
3683,January 1982,Hawaii,683000,453501,66.4,425840,62.3,27661,6.1
3684,January 1982,Idaho,676000,434651,64.3,393071,58.1,41580,9.6
3685,January 1982,Illinois,8547000,5580562,65.3,5055467,59.1,525095,9.4
3686,January 1982,Indiana,4043000,2603253,64.4,2304930,57.0,298323,11.5
3687,January 1982,Iowa,2160000,1426117,66.0,1313650,60.8,112467,7.9
3688,January 1982,Kansas,1764000,1180794,66.9,1121991,63.6,58803,5.0
3689,January 1982,Kentucky,2687000,1666953,62.0,1501355,55.9,165598,9.9
3690,January 1982,Louisiana,3080000,1861712,60.4,1685914,54.7,175798,9.4
3691,January 1982,Maine,839000,514155,61.3,473134,56.4,41021,8.0
3692,January 1982,Maryland,3214000,2178888,67.8,1997554,62.2,181334,8.3
3693,January 1982,Massachusetts,4433000,2971809,67.0,2748885,62.0,222924,7.5
3694,January 1982,Michigan,6771000,4292224,63.4,3673778,54.3,618446,14.4
3695,January 1982,Minnesota,3060000,2136398,69.8,1995016,65.2,141382,6.6
3696,January 1982,Mississippi,1806000,1066647,59.1,963180,53.3,103467,9.7
3697,January 1982,Missouri,3695000,2316002,62.7,2117621,57.3,198381,8.6
3698,January 1982,Montana,585000,387002,66.2,356153,60.9,30849,8.0
3699,January 1982,Nebraska,1161000,779938,67.2,741166,63.8,38772,5.0
3700,January 1982,Nevada,647000,480636,74.3,439579,67.9,41057,8.5
3701,January 1982,New Hampshire,704000,483553,68.7,453435,64.4,30118,6.2
3702,January 1982,New Jersey,5690000,3602975,63.3,3302787,58.0,300188,8.3
3703,January 1982,New Mexico,957000,584710,61.1,539829,56.4,44881,7.7
3704,January 1982,New York,13430000,7976631,59.4,7343565,54.7,633066,7.9
3705,January 1982,North Carolina,4406000,2944406,66.8,2692400,61.1,252006,8.6
3706,January 1982,North Dakota,476000,313163,65.8,297824,62.6,15339,4.9
3707,January 1982,Ohio,8044000,5122760,63.7,4536704,56.4,586056,11.4
3708,January 1982,Oklahoma,2312000,1473082,63.7,1406806,60.8,66276,4.5
3709,January 1982,Oregon,2002000,1333328,66.6,1182275,59.1,151053,11.3
3710,January 1982,Pennsylvania,9130000,5484564,60.1,4944708,54.2,539856,9.8
3711,January 1982,Rhode Island,729000,476311,65.3,433637,59.5,42674,9.0
3712,January 1982,South Carolina,2289000,1466288,64.1,1320182,57.7,146106,10.0
3713,January 1982,South Dakota,497000,331923,66.8,315534,63.5,16389,4.9
3714,January 1982,Tennessee,3461000,2101834,60.7,1877577,54.2,224257,10.7
3715,January 1982,Texas,10773000,7198777,66.8,6787708,63.0,411069,5.7
3716,January 1982,Utah,1004000,662553,66.0,615299,61.3,47254,7.1
3717,January 1982,Vermont,384000,260484,67.8,243764,63.5,16720,6.4
3718,January 1982,Virginia,3992000,2621438,65.7,2437163,61.1,184275,7.0
3719,January 1982,Washington,3144000,1997927,63.5,1772078,56.4,225849,11.3
3720,January 1982,West Virginia,1460000,780544,53.5,696510,47.7,84034,10.8
3721,January 1982,Wisconsin,3527000,2390989,67.8,2174343,61.6,216646,9.1
3722,January 1982,Wyoming,354000,254007,71.8,243459,68.8,10548,4.2
3723,February 1982,Alabama,2881000,1696798,58.9,1479601,51.4,217197,12.8
3724,February 1982,Alaska,284000,206292,72.6,186026,65.5,20266,9.8
3725,February 1982,Arizona,2093000,1307327,62.5,1198547,57.3,108780,8.3
3726,February 1982,Arkansas,1693000,1019880,60.2,920630,54.4,99250,9.7
3727,February 1982,California,18300000,12027553,65.7,10945387,59.8,1082166,9.0
3728,February 1982,Colorado,2230000,1569426,70.4,1470844,66.0,98582,6.3
3729,February 1982,Connecticut,2410000,1605041,66.6,1498349,62.2,106692,6.6
3730,February 1982,Delaware,449000,294061,65.5,268596,59.8,25465,8.7
3731,February 1982,District of Columbia,486000,303965,62.5,273826,56.3,30139,9.9
3732,February 1982,Florida,8066000,4642574,57.6,4281331,53.1,361243,7.8
3733,February 1982,Georgia,4059000,2639037,65.0,2440364,60.1,198673,7.5
3734,February 1982,Hawaii,684000,453913,66.4,425566,62.2,28347,6.2
3735,February 1982,Idaho,676000,436464,64.6,393579,58.2,42885,9.8
3736,February 1982,Illinois,8549000,5585896,65.3,5042708,59.0,543188,9.7
3737,February 1982,Indiana,4044000,2602154,64.3,2299445,56.9,302709,11.6
3738,February 1982,Iowa,2160000,1425573,66.0,1310219,60.7,115354,8.1
3739,February 1982,Kansas,1765000,1181933,67.0,1120484,63.5,61449,5.2
3740,February 1982,Kentucky,2689000,1669907,62.1,1500761,55.8,169146,10.1
3741,February 1982,Louisiana,3085000,1864877,60.4,1685356,54.6,179521,9.6
3742,February 1982,Maine,840000,515136,61.3,473296,56.3,41840,8.1
3743,February 1982,Maryland,3217000,2179772,67.8,1996269,62.1,183503,8.4
3744,February 1982,Massachusetts,4434000,2976886,67.1,2750485,62.0,226401,7.6
3745,February 1982,Michigan,6768000,4288986,63.4,3659276,54.1,629710,14.7
3746,February 1982,Minnesota,3062000,2138618,69.8,1993296,65.1,145322,6.8
3747,February 1982,Mississippi,1808000,1067010,59.0,960266,53.1,106744,10.0
3748,February 1982,Missouri,3696000,2317147,62.7,2117948,57.3,199199,8.6
3749,February 1982,Montana,586000,387157,66.1,355497,60.7,31660,8.2
3750,February 1982,Nebraska,1162000,780685,67.2,740669,63.7,40016,5.1
3751,February 1982,Nevada,650000,481713,74.1,438991,67.5,42722,8.9
3752,February 1982,New Hampshire,705000,484262,68.7,453007,64.3,31255,6.5
3753,February 1982,New Jersey,5694000,3609963,63.4,3300879,58.0,309084,8.6
3754,February 1982,New Mexico,959000,586530,61.2,539845,56.3,46685,8.0
3755,February 1982,New York,13436000,7980422,59.4,7339090,54.6,641332,8.0
3756,February 1982,North Carolina,4412000,2941209,66.7,2685993,60.9,255216,8.7
3757,February 1982,North Dakota,477000,313552,65.7,297827,62.4,15725,5.0
3758,February 1982,Ohio,8045000,5127637,63.7,4525632,56.3,602005,11.7
3759,February 1982,Oklahoma,2320000,1477968,63.7,1409189,60.7,68779,4.7
3760,February 1982,Oregon,2003000,1331411,66.5,1178742,58.8,152669,11.5
3761,February 1982,Pennsylvania,9133000,5488154,60.1,4934535,54.0,553619,10.1
3762,February 1982,Rhode Island,730000,476338,65.3,432460,59.2,43878,9.2
3763,February 1982,South Carolina,2293000,1469949,64.1,1319031,57.5,150918,10.3
3764,February 1982,South Dakota,498000,331705,66.6,315142,63.3,16563,5.0
3765,February 1982,Tennessee,3464000,2106209,60.8,1875747,54.1,230462,10.9
3766,February 1982,Texas,10810000,7228118,66.9,6804090,62.9,424028,5.9
3767,February 1982,Utah,1006000,664950,66.1,616596,61.3,48354,7.3
3768,February 1982,Vermont,385000,261262,67.9,243975,63.4,17287,6.6
3769,February 1982,Virginia,3997000,2627283,65.7,2439291,61.0,187992,7.2
3770,February 1982,Washington,3147000,2000845,63.6,1770281,56.3,230564,11.5
3771,February 1982,West Virginia,1461000,781558,53.5,694879,47.6,86679,11.1
3772,February 1982,Wisconsin,3529000,2398850,68.0,2174315,61.6,224535,9.4
3773,February 1982,Wyoming,355000,254530,71.7,243527,68.6,11003,4.3
3774,March 1982,Alabama,2883000,1701300,59.0,1478951,51.3,222349,13.1
3775,March 1982,Alaska,286000,207437,72.5,187013,65.4,20424,9.8
3776,March 1982,Arizona,2098000,1316056,62.7,1200373,57.2,115683,8.8
3777,March 1982,Arkansas,1694000,1018884,60.1,919150,54.3,99734,9.8
3778,March 1982,California,18330000,12066168,65.8,10951665,59.7,1114503,9.2
3779,March 1982,Colorado,2236000,1574902,70.4,1472976,65.9,101926,6.5
3780,March 1982,Connecticut,2412000,1607109,66.6,1499002,62.1,108107,6.7
3781,March 1982,Delaware,449000,294758,65.6,269308,60.0,25450,8.6
3782,March 1982,District of Columbia,485000,304849,62.9,273906,56.5,30943,10.2
3783,March 1982,Florida,8086000,4665084,57.7,4294860,53.1,370224,7.9
3784,March 1982,Georgia,4065000,2644085,65.0,2444511,60.1,199574,7.5
3785,March 1982,Hawaii,685000,454504,66.4,425580,62.1,28924,6.4
3786,March 1982,Idaho,677000,438175,64.7,394501,58.3,43674,10.0
3787,March 1982,Illinois,8551000,5593258,65.4,5028883,58.8,564375,10.1
3788,March 1982,Indiana,4045000,2600687,64.3,2295951,56.8,304736,11.7
3789,March 1982,Iowa,2159000,1424700,66.0,1307061,60.5,117639,8.3
3790,March 1982,Kansas,1767000,1183823,67.0,1119332,63.3,64491,5.4
3791,March 1982,Kentucky,2691000,1673196,62.2,1501087,55.8,172109,10.3
3792,March 1982,Louisiana,3091000,1867615,60.4,1685146,54.5,182469,9.8
3793,March 1982,Maine,841000,516143,61.4,473526,56.3,42617,8.3
3794,March 1982,Maryland,3219000,2179731,67.7,1995532,62.0,184199,8.5
3795,March 1982,Massachusetts,4436000,2981766,67.2,2752584,62.1,229182,7.7
3796,March 1982,Michigan,6765000,4284658,63.3,3649341,53.9,635317,14.8
3797,March 1982,Minnesota,3064000,2141510,69.9,1991359,65.0,150151,7.0
3798,March 1982,Mississippi,1809000,1066378,58.9,956464,52.9,109914,10.3
3799,March 1982,Missouri,3697000,2319543,62.7,2119654,57.3,199889,8.6
3800,March 1982,Montana,586000,387357,66.1,354991,60.6,32366,8.4
3801,March 1982,Nebraska,1162000,781505,67.3,740119,63.7,41386,5.3
3802,March 1982,Nevada,652000,482313,74.0,438077,67.2,44236,9.2
3803,March 1982,New Hampshire,706000,484921,68.7,452662,64.1,32259,6.7
3804,March 1982,New Jersey,5698000,3615569,63.5,3301613,57.9,313956,8.7
3805,March 1982,New Mexico,961000,588582,61.2,539755,56.2,48827,8.3
3806,March 1982,New York,13442000,7984128,59.4,7336760,54.6,647368,8.1
3807,March 1982,North Carolina,4418000,2938740,66.5,2680874,60.7,257866,8.8
3808,March 1982,North Dakota,477000,314018,65.8,297859,62.4,16159,5.1
3809,March 1982,Ohio,8046000,5130334,63.8,4516492,56.1,613842,12.0
3810,March 1982,Oklahoma,2327000,1482149,63.7,1410834,60.6,71315,4.8
3811,March 1982,Oregon,2003000,1329133,66.4,1176205,58.7,152928,11.5
3812,March 1982,Pennsylvania,9136000,5489999,60.1,4924879,53.9,565120,10.3
3813,March 1982,Rhode Island,730000,476596,65.3,431633,59.1,44963,9.4
3814,March 1982,South Carolina,2296000,1473524,64.2,1317937,57.4,155587,10.6
3815,March 1982,South Dakota,498000,331554,66.6,314736,63.2,16818,5.1
3816,March 1982,Tennessee,3467000,2111975,60.9,1876378,54.1,235597,11.2
3817,March 1982,Texas,10846000,7260392,66.9,6821426,62.9,438966,6.0
3818,March 1982,Utah,1008000,667197,66.2,617744,61.3,49453,7.4
3819,March 1982,Vermont,385000,262114,68.1,244290,63.5,17824,6.8
3820,March 1982,Virginia,4002000,2632792,65.8,2442350,61.0,190442,7.2
3821,March 1982,Washington,3149000,2004122,63.6,1769749,56.2,234373,11.7
3822,March 1982,West Virginia,1461000,783326,53.6,693195,47.4,90131,11.5
3823,March 1982,Wisconsin,3531000,2407290,68.2,2174345,61.6,232945,9.7
3824,March 1982,Wyoming,356000,255207,71.7,243449,68.4,11758,4.6
3825,April 1982,Alabama,2885000,1705980,59.1,1478289,51.2,227691,13.3
3826,April 1982,Alaska,287000,208832,72.8,188247,65.6,20585,9.9
3827,April 1982,Arizona,2104000,1325441,63.0,1202775,57.2,122666,9.3
3828,April 1982,Arkansas,1695000,1018649,60.1,918777,54.2,99872,9.8
3829,April 1982,California,18361000,12103095,65.9,10958324,59.7,1144771,9.5
3830,April 1982,Colorado,2242000,1580754,70.5,1475259,65.8,105495,6.7
3831,April 1982,Connecticut,2413000,1608699,66.7,1499552,62.1,109147,6.8
3832,April 1982,Delaware,450000,295016,65.6,269765,59.9,25251,8.6
3833,April 1982,District of Columbia,485000,305803,63.1,274194,56.5,31609,10.3
3834,April 1982,Florida,8106000,4688572,57.8,4310056,53.2,378516,8.1
3835,April 1982,Georgia,4071000,2647913,65.0,2448735,60.2,199178,7.5
3836,April 1982,Hawaii,686000,455326,66.4,425956,62.1,29370,6.5
3837,April 1982,Idaho,678000,439708,64.9,395796,58.4,43912,10.0
3838,April 1982,Illinois,8553000,5602371,65.5,5014575,58.6,587796,10.5
3839,April 1982,Indiana,4046000,2599029,64.2,2293752,56.7,305277,11.7
3840,April 1982,Iowa,2159000,1423740,65.9,1304531,60.4,119209,8.4
3841,April 1982,Kansas,1768000,1186552,67.1,1118444,63.3,68108,5.7
3842,April 1982,Kentucky,2692000,1676683,62.3,1501903,55.8,174780,10.4
3843,April 1982,Louisiana,3096000,1869812,60.4,1684929,54.4,184883,9.9
3844,April 1982,Maine,841000,517117,61.5,473890,56.3,43227,8.4
3845,April 1982,Maryland,3222000,2178744,67.6,1995087,61.9,183657,8.4
3846,April 1982,Massachusetts,4438000,2986216,67.3,2754878,62.1,231338,7.7
3847,April 1982,Michigan,6762000,4280563,63.3,3643885,53.9,636678,14.9
3848,April 1982,Minnesota,3066000,2145306,70.0,1989106,64.9,156200,7.3
3849,April 1982,Mississippi,1811000,1065161,58.8,952331,52.6,112830,10.6
3850,April 1982,Missouri,3698000,2323259,62.8,2122019,57.4,201240,8.7
3851,April 1982,Montana,587000,387601,66.0,354725,60.4,32876,8.5
3852,April 1982,Nebraska,1163000,782409,67.3,739671,63.6,42738,5.5
3853,April 1982,Nevada,654000,482537,73.8,436965,66.8,45572,9.4
3854,April 1982,New Hampshire,707000,485628,68.7,452595,64.0,33033,6.8
3855,April 1982,New Jersey,5702000,3619562,63.5,3304904,58.0,314658,8.7
3856,April 1982,New Mexico,963000,590906,61.4,539707,56.0,51199,8.7
3857,April 1982,New York,13448000,7987010,59.4,7334993,54.5,652017,8.2
3858,April 1982,North Carolina,4423000,2937786,66.4,2677426,60.5,260360,8.9
3859,April 1982,North Dakota,478000,314603,65.8,298011,62.3,16592,5.3
3860,April 1982,Ohio,8046000,5131297,63.8,4508312,56.0,622985,12.1
3861,April 1982,Oklahoma,2334000,1485744,63.7,1411511,60.5,74233,5.0
3862,April 1982,Oregon,2003000,1326952,66.2,1174655,58.6,152297,11.5
3863,April 1982,Pennsylvania,9139000,5490662,60.1,4915300,53.8,575362,10.5
3864,April 1982,Rhode Island,731000,477082,65.3,431226,59.0,45856,9.6
3865,April 1982,South Carolina,2300000,1476820,64.2,1316813,57.3,160007,10.8
3866,April 1982,South Dakota,498000,331398,66.5,314265,63.1,17133,5.2
3867,April 1982,Tennessee,3470000,2118851,61.1,1879139,54.2,239712,11.3
3868,April 1982,Texas,10882000,7294863,67.0,6839478,62.9,455385,6.2
3869,April 1982,Utah,1010000,669406,66.3,618728,61.3,50678,7.6
3870,April 1982,Vermont,386000,262951,68.1,244691,63.4,18260,6.9
3871,April 1982,Virginia,4007000,2637700,65.8,2445880,61.0,191820,7.3
3872,April 1982,Washington,3152000,2007908,63.7,1770431,56.2,237477,11.8
3873,April 1982,West Virginia,1462000,785669,53.7,691301,47.3,94368,12.0
3874,April 1982,Wisconsin,3533000,2415728,68.4,2174149,61.5,241579,10.0
3875,April 1982,Wyoming,356000,255965,71.9,243168,68.3,12797,5.0
3876,May 1982,Alabama,2887000,1710306,59.2,1477288,51.2,233018,13.6
3877,May 1982,Alaska,289000,210433,72.8,189695,65.6,20738,9.9
3878,May 1982,Arizona,2109000,1335090,63.3,1205500,57.2,129590,9.7
3879,May 1982,Arkansas,1696000,1019378,60.1,919497,54.2,99881,9.8
3880,May 1982,California,18392000,12136639,66.0,10963984,59.6,1172655,9.7
3881,May 1982,Colorado,2248000,1586554,70.6,1477143,65.7,109411,6.9
3882,May 1982,Connecticut,2415000,1609683,66.7,1499797,62.1,109886,6.8
3883,May 1982,Delaware,450000,294927,65.5,269972,60.0,24955,8.5
3884,May 1982,District of Columbia,485000,306702,63.2,274634,56.6,32068,10.5
3885,May 1982,Florida,8127000,4711937,58.0,4326136,53.2,385801,8.2
3886,May 1982,Georgia,4077000,2650355,65.0,2452359,60.2,197996,7.5
3887,May 1982,Hawaii,688000,456360,66.3,426723,62.0,29637,6.5
3888,May 1982,Idaho,679000,441085,65.0,397341,58.5,43744,9.9
3889,May 1982,Illinois,8555000,5612012,65.6,5000438,58.5,611574,10.9
3890,May 1982,Indiana,4047000,2597511,64.2,2292323,56.6,305188,11.7
3891,May 1982,Iowa,2159000,1422975,65.9,1302836,60.3,120139,8.4
3892,May 1982,Kansas,1769000,1189986,67.3,1117900,63.2,72086,6.1
3893,May 1982,Kentucky,2694000,1680223,62.4,1502774,55.8,177449,10.6
3894,May 1982,Louisiana,3101000,1871323,60.3,1684154,54.3,187169,10.0
3895,May 1982,Maine,842000,517974,61.5,474389,56.3,43585,8.4
3896,May 1982,Maryland,3224000,2176972,67.5,1994746,61.9,182226,8.4
3897,May 1982,Massachusetts,4440000,2989876,67.3,2757151,62.1,232725,7.8
3898,May 1982,Michigan,6760000,4277647,63.3,3641044,53.9,636603,14.9
3899,May 1982,Minnesota,3068000,2149558,70.1,1986619,64.8,162939,7.6
3900,May 1982,Mississippi,1813000,1063721,58.7,948428,52.3,115293,10.8
3901,May 1982,Missouri,3699000,2327343,62.9,2123934,57.4,203409,8.7
3902,May 1982,Montana,587000,387871,66.1,354715,60.4,33156,8.5
3903,May 1982,Nebraska,1163000,783379,67.4,739468,63.6,43911,5.6
3904,May 1982,Nevada,656000,482509,73.6,435801,66.4,46708,9.7
3905,May 1982,New Hampshire,708000,486427,68.7,452886,64.0,33541,6.9
3906,May 1982,New Jersey,5706000,3622340,63.5,3309826,58.0,312514,8.6
3907,May 1982,New Mexico,965000,593418,61.5,539849,55.9,53569,9.0
3908,May 1982,New York,13454000,7988116,59.4,7331849,54.5,656267,8.2
3909,May 1982,North Carolina,4429000,2938167,66.3,2675379,60.4,262788,8.9
3910,May 1982,North Dakota,478000,315274,66.0,298268,62.4,17006,5.4
3911,May 1982,Ohio,8047000,5130647,63.8,4500022,55.9,630625,12.3
3912,May 1982,Oklahoma,2341000,1489102,63.6,1411189,60.3,77913,5.2
3913,May 1982,Oregon,2003000,1325224,66.2,1173879,58.6,151345,11.4
3914,May 1982,Pennsylvania,9142000,5490950,60.1,4905594,53.7,585356,10.7
3915,May 1982,Rhode Island,731000,477610,65.3,431101,59.0,46509,9.7
3916,May 1982,South Carolina,2303000,1479281,64.2,1315518,57.1,163763,11.1
3917,May 1982,South Dakota,498000,331279,66.5,313758,63.0,17521,5.3
3918,May 1982,Tennessee,3473000,2126008,61.2,1883337,54.2,242671,11.4
3919,May 1982,Texas,10918000,7330460,67.1,6857570,62.8,472890,6.5
3920,May 1982,Utah,1013000,671537,66.3,619486,61.2,52051,7.8
3921,May 1982,Vermont,386000,263666,68.3,245127,63.5,18539,7.0
3922,May 1982,Virginia,4012000,2642248,65.9,2449658,61.1,192590,7.3
3923,May 1982,Washington,3155000,2012485,63.8,1772413,56.2,240072,11.9
3924,May 1982,West Virginia,1462000,788429,53.9,689123,47.1,99306,12.6
3925,May 1982,Wisconsin,3535000,2423317,68.6,2173712,61.5,249605,10.3
3926,May 1982,Wyoming,357000,256717,71.9,242674,68.0,14043,5.5
3927,June 1982,Alabama,2889000,1714197,59.3,1475716,51.1,238481,13.9
3928,June 1982,Alaska,290000,212106,73.1,191210,65.9,20896,9.9
3929,June 1982,Arizona,2115000,1344035,63.5,1207864,57.1,136171,10.1
3930,June 1982,Arkansas,1696000,1020955,60.2,920963,54.3,99992,9.8
3931,June 1982,California,18422000,12164067,66.0,10965076,59.5,1198991,9.9
3932,June 1982,Colorado,2253000,1591901,70.7,1478035,65.6,113866,7.2
3933,June 1982,Connecticut,2416000,1609977,66.6,1499527,62.1,110450,6.9
3934,June 1982,Delaware,451000,294661,65.3,270008,59.9,24653,8.4
3935,June 1982,District of Columbia,484000,307450,63.5,275112,56.8,32338,10.5
3936,June 1982,Florida,8147000,4732809,58.1,4340368,53.3,392441,8.3
3937,June 1982,Georgia,4083000,2651646,64.9,2454302,60.1,197344,7.4
3938,June 1982,Hawaii,689000,457503,66.4,427861,62.1,29642,6.5
3939,June 1982,Idaho,679000,442388,65.2,398904,58.7,43484,9.8
3940,June 1982,Illinois,8557000,5619553,65.7,4985310,58.3,634243,11.3
3941,June 1982,Indiana,4048000,2596473,64.1,2290597,56.6,305876,11.8
3942,June 1982,Iowa,2158000,1422548,65.9,1301787,60.3,120761,8.5
3943,June 1982,Kansas,1771000,1193609,67.4,1117616,63.1,75993,6.4
3944,June 1982,Kentucky,2696000,1683084,62.4,1503236,55.8,179848,10.7
3945,June 1982,Louisiana,3107000,1871570,60.2,1681998,54.1,189572,10.1
3946,June 1982,Maine,842000,518601,61.6,474867,56.4,43734,8.4
3947,June 1982,Maryland,3227000,2174754,67.4,1994291,61.8,180463,8.3
3948,June 1982,Massachusetts,4441000,2992029,67.4,2758733,62.1,233296,7.8
3949,June 1982,Michigan,6757000,4276299,63.3,3637144,53.8,639155,14.9
3950,June 1982,Minnesota,3070000,2153826,70.2,1984023,64.6,169803,7.9
3951,June 1982,Mississippi,1814000,1062267,58.6,944963,52.1,117304,11.0
3952,June 1982,Missouri,3700000,2330058,63.0,2123479,57.4,206579,8.9
3953,June 1982,Montana,588000,388161,66.0,354899,60.4,33262,8.6
3954,June 1982,Nebraska,1164000,784383,67.4,739588,63.5,44795,5.7
3955,June 1982,Nevada,658000,482286,73.3,434605,66.0,47681,9.9
3956,June 1982,New Hampshire,709000,487250,68.7,453437,64.0,33813,6.9
3957,June 1982,New Jersey,5710000,3624630,63.5,3314402,58.0,310228,8.6
3958,June 1982,New Mexico,967000,595839,61.6,540179,55.9,55660,9.3
3959,June 1982,New York,13460000,7985785,59.3,7324164,54.4,661621,8.3
3960,June 1982,North Carolina,4435000,2938471,66.3,2672854,60.3,265617,9.0
3961,June 1982,North Dakota,479000,315942,66.0,298519,62.3,17423,5.5
3962,June 1982,Ohio,8048000,5128175,63.7,4489819,55.8,638356,12.4
3963,June 1982,Oklahoma,2348000,1492295,63.6,1409621,60.0,82674,5.5
3964,June 1982,Oregon,2003000,1324234,66.1,1173505,58.6,150729,11.4
3965,June 1982,Pennsylvania,9145000,5490407,60.0,4893887,53.5,596520,10.9
3966,June 1982,Rhode Island,732000,477860,65.3,430949,58.9,46911,9.8
3967,June 1982,South Carolina,2307000,1480578,64.2,1314096,57.0,166482,11.2
3968,June 1982,South Dakota,498000,331259,66.5,313298,62.9,17961,5.4
3969,June 1982,Tennessee,3476000,2132039,61.3,1887073,54.3,244966,11.5
3970,June 1982,Texas,10954000,7364774,67.2,6873473,62.7,491301,6.7
3971,June 1982,Utah,1015000,673501,66.4,619898,61.1,53603,8.0
3972,June 1982,Vermont,387000,264160,68.3,245487,63.4,18673,7.1
3973,June 1982,Virginia,4017000,2646195,65.9,2452855,61.1,193340,7.3
3974,June 1982,Washington,3157000,2017893,63.9,1775529,56.2,242364,12.0
3975,June 1982,West Virginia,1463000,791495,54.1,686641,46.9,104854,13.2
3976,June 1982,Wisconsin,3537000,2428534,68.7,2172618,61.4,255916,10.5
3977,June 1982,Wyoming,358000,257393,71.9,242014,67.6,15379,6.0
3978,July 1982,Alabama,2891000,1718140,59.4,1473584,51.0,244556,14.2
3979,July 1982,Alaska,292000,213721,73.2,192647,66.0,21074,9.9
3980,July 1982,Arizona,2120000,1351611,63.8,1209419,57.0,142192,10.5
3981,July 1982,Arkansas,1697000,1023201,60.3,922731,54.4,100470,9.8
3982,July 1982,California,18453000,12186035,66.0,10960279,59.4,1225756,10.1
3983,July 1982,Colorado,2259000,1597137,70.7,1478225,65.4,118912,7.4
3984,July 1982,Connecticut,2418000,1609823,66.6,1498868,62.0,110955,6.9
3985,July 1982,Delaware,451000,294398,65.3,269983,59.9,24415,8.3
3986,July 1982,District of Columbia,484000,308079,63.7,275594,56.9,32485,10.5
3987,July 1982,Florida,8167000,4750574,58.2,4351124,53.3,399450,8.4
3988,July 1982,Georgia,4089000,2653480,64.9,2454350,60.0,199130,7.5
3989,July 1982,Hawaii,690000,458736,66.5,429301,62.2,29435,6.4
3990,July 1982,Idaho,680000,443689,65.2,400280,58.9,43409,9.8
3991,July 1982,Illinois,8559000,5624942,65.7,4969292,58.1,655650,11.7
3992,July 1982,Indiana,4049000,2596540,64.1,2288204,56.5,308336,11.9
3993,July 1982,Iowa,2158000,1422664,65.9,1301266,60.3,121398,8.5
3994,July 1982,Kansas,1772000,1197074,67.6,1117607,63.1,79467,6.6
3995,July 1982,Kentucky,2698000,1685109,62.5,1503203,55.7,181906,10.8
3996,July 1982,Louisiana,3112000,1870447,60.1,1678282,53.9,192165,10.3
3997,July 1982,Maine,843000,518996,61.6,475246,56.4,43750,8.4
3998,July 1982,Maryland,3229000,2172501,67.3,1993596,61.7,178905,8.2
3999,July 1982,Massachusetts,4443000,2992893,67.4,2759529,62.1,233364,7.8
4000,July 1982,Michigan,6754000,4277464,63.3,3630208,53.7,647256,15.1
4001,July 1982,Minnesota,3072000,2157753,70.2,1981394,64.5,176359,8.2
4002,July 1982,Mississippi,1816000,1061246,58.4,942172,51.9,119074,11.2
4003,July 1982,Missouri,3701000,2331250,63.0,2119916,57.3,211334,9.1
4004,July 1982,Montana,588000,388514,66.1,355208,60.4,33306,8.6
4005,July 1982,Nebraska,1164000,785348,67.5,740003,63.6,45345,5.8
4006,July 1982,Nevada,660000,481986,73.0,433425,65.7,48561,10.1
4007,July 1982,New Hampshire,710000,487985,68.7,454074,64.0,33911,6.9
4008,July 1982,New Jersey,5714000,3627527,63.5,3317267,58.1,310260,8.6
4009,July 1982,New Mexico,969000,597899,61.7,540600,55.8,57299,9.6
4010,July 1982,New York,13466000,7980868,59.3,7311302,54.3,669566,8.4
4011,July 1982,North Carolina,4441000,2937911,66.2,2668673,60.1,269238,9.2
4012,July 1982,North Dakota,479000,316525,66.1,298686,62.4,17839,5.6
4013,July 1982,Ohio,8049000,5125306,63.7,4476785,55.6,648521,12.7
4014,July 1982,Oklahoma,2355000,1495597,63.5,1406928,59.7,88669,5.9
4015,July 1982,Oregon,2003000,1324228,66.1,1173279,58.6,150949,11.4
4016,July 1982,Pennsylvania,9148000,5490229,60.0,4879645,53.3,610584,11.1
4017,July 1982,Rhode Island,732000,477561,65.2,430457,58.8,47104,9.9
4018,July 1982,South Carolina,2310000,1480840,64.1,1312716,56.8,168124,11.4
4019,July 1982,South Dakota,498000,331353,66.5,312950,62.8,18403,5.6
4020,July 1982,Tennessee,3479000,2137127,61.4,1889109,54.3,248018,11.6
4021,July 1982,Texas,10990000,7397371,67.3,6886244,62.7,511127,6.9
4022,July 1982,Utah,1017000,675269,66.4,619868,61.0,55401,8.2
4023,July 1982,Vermont,387000,264384,68.3,245675,63.5,18709,7.1
4024,July 1982,Virginia,4022000,2650308,65.9,2455370,61.0,194938,7.4
4025,July 1982,Washington,3160000,2024338,64.1,1779697,56.3,244641,12.1
4026,July 1982,West Virginia,1463000,794853,54.3,684036,46.8,110817,13.9
4027,July 1982,Wisconsin,3539000,2431204,68.7,2170562,61.3,260642,10.7
4028,July 1982,Wyoming,359000,257924,71.8,241243,67.2,16681,6.5
4029,August 1982,Alabama,2893000,1722430,59.5,1471357,50.9,251073,14.6
4030,August 1982,Alaska,295000,215210,73.0,193923,65.7,21287,9.9
4031,August 1982,Arizona,2126000,1357541,63.9,1210096,56.9,147445,10.9
4032,August 1982,Arkansas,1699000,1025855,60.4,924440,54.4,101415,9.9
4033,August 1982,California,18475000,12204727,66.1,10950739,59.3,1253988,10.3
4034,August 1982,Colorado,2264000,1602990,70.8,1478674,65.3,124316,7.8
4035,August 1982,Connecticut,2419000,1609755,66.5,1498144,61.9,111611,6.9
4036,August 1982,Delaware,451000,294226,65.2,269985,59.9,24241,8.2
4037,August 1982,District of Columbia,484000,308695,63.8,276076,57.0,32619,10.6
4038,August 1982,Florida,8187000,4765999,58.2,4357862,53.2,408137,8.6
4039,August 1982,Georgia,4094000,2657029,64.9,2453027,59.9,204002,7.7
4040,August 1982,Hawaii,692000,460100,66.5,430979,62.3,29121,6.3
4041,August 1982,Idaho,681000,444992,65.3,401328,58.9,43664,9.8
4042,August 1982,Illinois,8561000,5628996,65.8,4953377,57.9,675619,12.0
4043,August 1982,Indiana,4049000,2597794,64.2,2285328,56.4,312466,12.0
4044,August 1982,Iowa,2158000,1423308,66.0,1300981,60.3,122327,8.6
4045,August 1982,Kansas,1773000,1200093,67.7,1117899,63.1,82194,6.8
4046,August 1982,Kentucky,2700000,1687194,62.5,1502746,55.7,184448,10.9
4047,August 1982,Louisiana,3117000,1868535,59.9,1673548,53.7,194987,10.4
4048,August 1982,Maine,844000,519351,61.5,475590,56.3,43761,8.4
4049,August 1982,Maryland,3230000,2170837,67.2,1992906,61.7,177931,8.2
4050,August 1982,Massachusetts,4445000,2992836,67.3,2759797,62.1,233039,7.8
4051,August 1982,Michigan,6750000,4281878,63.4,3620537,53.6,661341,15.4
4052,August 1982,Minnesota,3073000,2161173,70.3,1978977,64.4,182196,8.4
4053,August 1982,Mississippi,1817000,1061004,58.4,940147,51.7,120857,11.4
4054,August 1982,Missouri,3703000,2331408,63.0,2113765,57.1,217643,9.3
4055,August 1982,Montana,589000,389014,66.0,355609,60.4,33405,8.6
4056,August 1982,Nebraska,1165000,786327,67.5,740588,63.6,45739,5.8
4057,August 1982,Nevada,661000,481786,72.9,432368,65.4,49418,10.3
4058,August 1982,New Hampshire,711000,488519,68.7,454619,63.9,33900,6.9
4059,August 1982,New Jersey,5720000,3631460,63.5,3318042,58.0,313418,8.6
4060,August 1982,New Mexico,971000,599426,61.7,540950,55.7,58476,9.8
4061,August 1982,New York,13473000,7975605,59.2,7294904,54.1,680701,8.5
4062,August 1982,North Carolina,4445000,2936547,66.1,2662886,59.9,273661,9.3
4063,August 1982,North Dakota,480000,316979,66.0,298760,62.2,18219,5.7
4064,August 1982,Ohio,8047000,5124030,63.7,4461415,55.4,662615,12.9
4065,August 1982,Oklahoma,2361000,1499068,63.5,1403502,59.4,95566,6.4
4066,August 1982,Oregon,2003000,1325490,66.2,1173248,58.6,152242,11.5
4067,August 1982,Pennsylvania,9151000,5491942,60.0,4863763,53.2,628179,11.4
4068,August 1982,Rhode Island,732000,476758,65.1,429535,58.7,47223,9.9
4069,August 1982,South Carolina,2313000,1480837,64.0,1311593,56.7,169244,11.4
4070,August 1982,South Dakota,499000,331591,66.5,312761,62.7,18830,5.7
4071,August 1982,Tennessee,3481000,2142214,61.5,1889090,54.3,253124,11.8
4072,August 1982,Texas,11017000,7429213,67.4,6896037,62.6,533176,7.2
4073,August 1982,Utah,1020000,676843,66.4,619441,60.7,57402,8.5
4074,August 1982,Vermont,387000,264362,68.3,245644,63.5,18718,7.1
4075,August 1982,Virginia,4027000,2655900,66.0,2457737,61.0,198163,7.5
4076,August 1982,Washington,3162000,2031524,64.2,1784591,56.4,246933,12.2
4077,August 1982,West Virginia,1464000,798536,54.5,681620,46.6,116916,14.6
4078,August 1982,Wisconsin,3539000,2432396,68.7,2167366,61.2,265030,10.9
4079,August 1982,Wyoming,359000,258366,72.0,240464,67.0,17902,6.9
4080,September 1982,Alabama,2894000,1727334,59.7,1469558,50.8,257776,14.9
4081,September 1982,Alaska,297000,216603,72.9,195034,65.7,21569,10.0
4082,September 1982,Arizona,2132000,1361931,63.9,1209996,56.8,151935,11.2
4083,September 1982,Arkansas,1701000,1028474,60.5,925771,54.4,102703,10.0
4084,September 1982,California,18497000,12221164,66.1,10937985,59.1,1283179,10.5
4085,September 1982,Colorado,2269000,1609769,70.9,1480290,65.2,129479,8.0
4086,September 1982,Connecticut,2420000,1610056,66.5,1497524,61.9,112532,7.0
4087,September 1982,Delaware,452000,294138,65.1,270055,59.7,24083,8.2
4088,September 1982,District of Columbia,484000,309338,63.9,276488,57.1,32850,10.6
4089,September 1982,Florida,8207000,4779399,58.2,4360268,53.1,419131,8.8
4090,September 1982,Georgia,4099000,2662323,65.0,2450923,59.8,211400,7.9
4091,September 1982,Hawaii,693000,461613,66.6,432790,62.5,28823,6.2
4092,September 1982,Idaho,682000,446210,65.4,402043,59.0,44167,9.9
4093,September 1982,Illinois,8562000,5631690,65.8,4937858,57.7,693832,12.3
4094,September 1982,Indiana,4050000,2599810,64.2,2281968,56.3,317842,12.2
4095,September 1982,Iowa,2158000,1424194,66.0,1300464,60.3,123730,8.7
4096,September 1982,Kansas,1774000,1202277,67.8,1118295,63.0,83982,7.0
4097,September 1982,Kentucky,2702000,1690034,62.5,1501885,55.6,188149,11.1
4098,September 1982,Louisiana,3122000,1866665,59.8,1668477,53.4,198188,10.6
4099,September 1982,Maine,845000,519964,61.5,476046,56.3,43918,8.4
4100,September 1982,Maryland,3232000,2170163,67.1,1992609,61.7,177554,8.2
4101,September 1982,Massachusetts,4448000,2991885,67.3,2759600,62.0,232285,7.8
4102,September 1982,Michigan,6746000,4288618,63.6,3609417,53.5,679201,15.8
4103,September 1982,Minnesota,3074000,2164078,70.4,1977077,64.3,187001,8.6
4104,September 1982,Mississippi,1818000,1061474,58.4,938594,51.6,122880,11.6
4105,September 1982,Missouri,3706000,2330672,62.9,2106027,56.8,224645,9.6
4106,September 1982,Montana,590000,389701,66.1,356084,60.4,33617,8.6
4107,September 1982,Nebraska,1166000,787412,67.5,741156,63.6,46256,5.9
4108,September 1982,Nevada,662000,481801,72.8,431507,65.2,50294,10.4
4109,September 1982,New Hampshire,712000,488804,68.7,454970,63.9,33834,6.9
4110,September 1982,New Jersey,5726000,3635633,63.5,3316916,57.9,318717,8.8
4111,September 1982,New Mexico,973000,600486,61.7,541104,55.6,59382,9.9
4112,September 1982,New York,13480000,7972315,59.1,7277046,54.0,695269,8.7
4113,September 1982,North Carolina,4449000,2934547,66.0,2655620,59.7,278927,9.5
4114,September 1982,North Dakota,481000,317336,66.0,298764,62.1,18572,5.9
4115,September 1982,Ohio,8046000,5124723,63.7,4444807,55.2,679916,13.3
4116,September 1982,Oklahoma,2367000,1502626,63.5,1399727,59.1,102899,6.8
4117,September 1982,Oregon,2004000,1328303,66.3,1173727,58.6,154576,11.6
4118,September 1982,Pennsylvania,9153000,5494500,60.0,4846702,53.0,647798,11.8
4119,September 1982,Rhode Island,733000,475722,64.9,428334,58.4,47388,10.0
4120,September 1982,South Carolina,2315000,1481367,64.0,1310890,56.6,170477,11.5
4121,September 1982,South Dakota,499000,331975,66.5,312758,62.7,19217,5.8
4122,September 1982,Tennessee,3483000,2147564,61.7,1887245,54.2,260319,12.1
4123,September 1982,Texas,11043000,7460493,67.6,6903169,62.5,557324,7.5
4124,September 1982,Utah,1023000,678173,66.3,618774,60.5,59399,8.8
4125,September 1982,Vermont,388000,264212,68.1,245423,63.3,18789,7.1
4126,September 1982,Virginia,4032000,2663275,66.1,2460428,61.0,202847,7.6
4127,September 1982,Washington,3164000,2038194,64.4,1789466,56.6,248728,12.2
4128,September 1982,West Virginia,1465000,802578,54.8,679655,46.4,122923,15.3
4129,September 1982,Wisconsin,3539000,2433159,68.8,2162882,61.1,270277,11.1
4130,September 1982,Wyoming,360000,258834,71.9,239809,66.6,19025,7.4
4131,October 1982,Alabama,2896000,1732345,59.8,1468440,50.7,263905,15.2
4132,October 1982,Alaska,300000,218001,72.7,196066,65.4,21935,10.1
4133,October 1982,Arizona,2138000,1364954,63.8,1209541,56.6,155413,11.4
4134,October 1982,Arkansas,1702000,1030451,60.5,926303,54.4,104148,10.1
4135,October 1982,California,18518000,12234615,66.1,10923944,59.0,1310671,10.7
4136,October 1982,Colorado,2274000,1617248,71.1,1483618,65.2,133630,8.3
4137,October 1982,Connecticut,2421000,1610596,66.5,1497112,61.8,113484,7.0
4138,October 1982,Delaware,452000,294104,65.1,270162,59.8,23942,8.1
4139,October 1982,District of Columbia,484000,309953,64.0,276766,57.2,33187,10.7
4140,October 1982,Florida,8227000,4790414,58.2,4359011,53.0,431403,9.0
4141,October 1982,Georgia,4104000,2668703,65.0,2448721,59.7,219982,8.2
4142,October 1982,Hawaii,695000,463267,66.7,434563,62.5,28704,6.2
4143,October 1982,Idaho,682000,447297,65.6,402497,59.0,44800,10.0
4144,October 1982,Illinois,8564000,5632545,65.8,4922745,57.5,709800,12.6
4145,October 1982,Indiana,4050000,2601369,64.2,2278257,56.3,323112,12.4
4146,October 1982,Iowa,2158000,1424986,66.0,1299492,60.2,125494,8.8
4147,October 1982,Kansas,1775000,1203256,67.8,1118494,63.0,84762,7.0
4148,October 1982,Kentucky,2704000,1693789,62.6,1500814,55.5,192975,11.4
4149,October 1982,Louisiana,3126000,1865699,59.7,1663650,53.2,202049,10.8
4150,October 1982,Maine,846000,521017,61.6,476741,56.4,44276,8.5
4151,October 1982,Maryland,3233000,2170587,67.1,1993068,61.6,177519,8.2
4152,October 1982,Massachusetts,4450000,2990275,67.2,2759041,62.0,231234,7.7
4153,October 1982,Michigan,6743000,4294571,63.7,3598537,53.4,696034,16.2
4154,October 1982,Minnesota,3075000,2166328,70.4,1975800,64.3,190528,8.8
4155,October 1982,Mississippi,1818000,1062237,58.4,936956,51.5,125281,11.8
4156,October 1982,Missouri,3708000,2329435,62.8,2098105,56.6,231330,9.9
4157,October 1982,Montana,590000,390526,66.2,356611,60.4,33915,8.7
4158,October 1982,Nebraska,1166000,788568,67.6,741529,63.6,47039,6.0
4159,October 1982,Nevada,663000,482090,72.7,430901,65.0,51189,10.6
4160,October 1982,New Hampshire,713000,488876,68.6,455135,63.8,33741,6.9
4161,October 1982,New Jersey,5731000,3639280,63.5,3314678,57.8,324602,8.9
4162,October 1982,New Mexico,975000,601370,61.7,541047,55.5,60323,10.0
4163,October 1982,New York,13487000,7971774,59.1,7260021,53.8,711753,8.9
4164,October 1982,North Carolina,4453000,2931554,65.8,2647232,59.4,284322,9.7
4165,October 1982,North Dakota,481000,317675,66.0,298732,62.1,18943,6.0
4166,October 1982,Ohio,8044000,5125812,63.7,4428764,55.1,697048,13.6
4167,October 1982,Oklahoma,2373000,1506349,63.5,1395998,58.8,110351,7.3
4168,October 1982,Oregon,2004000,1332164,66.5,1175053,58.6,157111,11.8
4169,October 1982,Pennsylvania,9156000,5495926,60.0,4829084,52.7,666842,12.1
4170,October 1982,Rhode Island,733000,474683,64.8,427154,58.3,47529,10.0
4171,October 1982,South Carolina,2318000,1482788,64.0,1310643,56.5,172145,11.6
4172,October 1982,South Dakota,500000,332425,66.5,312908,62.6,19517,5.9
4173,October 1982,Tennessee,3485000,2152457,61.8,1884464,54.1,267993,12.5
4174,October 1982,Texas,11070000,7490775,67.7,6908614,62.4,582161,7.8
4175,October 1982,Utah,1025000,679286,66.3,618086,60.3,61200,9.0
4176,October 1982,Vermont,388000,264049,68.1,245094,63.2,18955,7.2
4177,October 1982,Virginia,4037000,2671586,66.2,2463901,61.0,207685,7.8
4178,October 1982,Washington,3166000,2043306,64.5,1793716,56.7,249590,12.2
4179,October 1982,West Virginia,1465000,766204,52.3,637489,43.5,128715,16.8
4180,October 1982,Wisconsin,3539000,2434039,68.8,2157244,61.0,276795,11.4
4181,October 1982,Wyoming,360000,259486,72.1,239396,66.5,20090,7.7
4182,November 1982,Alabama,2898000,1736510,59.9,1468381,50.7,268129,15.4
4183,November 1982,Alaska,302000,219505,72.7,197166,65.3,22339,10.2
4184,November 1982,Arizona,2144000,1366976,63.8,1209718,56.4,157258,11.5
4185,November 1982,Arkansas,1704000,1031319,60.5,925927,54.3,105392,10.2
4186,November 1982,California,18540000,12244117,66.0,10912044,58.9,1332073,10.9
4187,November 1982,Colorado,2279000,1625129,71.3,1488723,65.3,136406,8.4
4188,November 1982,Connecticut,2423000,1611273,66.5,1497092,61.8,114181,7.1
4189,November 1982,Delaware,453000,294097,64.9,270254,59.7,23843,8.1
4190,November 1982,District of Columbia,484000,310631,64.2,277001,57.2,33630,10.8
4191,November 1982,Florida,8247000,4799330,58.2,4356458,52.8,442872,9.2
4192,November 1982,Georgia,4109000,2674640,65.1,2447327,59.6,227313,8.5
4193,November 1982,Hawaii,696000,464976,66.8,436108,62.7,28868,6.2
4194,November 1982,Idaho,683000,448262,65.6,402866,59.0,45396,10.1
4195,November 1982,Illinois,8565000,5631608,65.8,4909014,57.3,722594,12.8
4196,November 1982,Indiana,4051000,2600766,64.2,2274443,56.1,326323,12.5
4197,November 1982,Iowa,2158000,1425405,66.1,1298174,60.2,127231,8.9
4198,November 1982,Kansas,1776000,1202823,67.7,1118263,63.0,84560,7.0
4199,November 1982,Kentucky,2706000,1697734,62.7,1499712,55.4,198022,11.7
4200,November 1982,Louisiana,3131000,1866528,59.6,1659832,53.0,206696,11.1
4201,November 1982,Maine,847000,522553,61.7,477784,56.4,44769,8.6
4202,November 1982,Maryland,3235000,2171980,67.1,1994658,61.7,177322,8.2
4203,November 1982,Massachusetts,4453000,2988264,67.1,2758373,61.9,229891,7.7
4204,November 1982,Michigan,6739000,4297412,63.8,3590505,53.3,706907,16.4
4205,November 1982,Minnesota,3076000,2167871,70.5,1975301,64.2,192570,8.9
4206,November 1982,Mississippi,1819000,1063010,58.4,934970,51.4,128040,12.0
4207,November 1982,Missouri,3710000,2328802,62.8,2091659,56.4,237143,10.2
4208,November 1982,Montana,591000,391410,66.2,357183,60.4,34227,8.7
4209,November 1982,Nebraska,1167000,789720,67.7,741660,63.6,48060,6.1
4210,November 1982,Nevada,664000,482655,72.7,430711,64.9,51944,10.8
4211,November 1982,New Hampshire,714000,488920,68.5,455333,63.8,33587,6.9
4212,November 1982,New Jersey,5737000,3642034,63.5,3312721,57.7,329313,9.0
4213,November 1982,New Mexico,977000,602256,61.6,540841,55.4,61415,10.2
4214,November 1982,New York,13494000,7973878,59.1,7247062,53.7,726816,9.1
4215,November 1982,North Carolina,4457000,2928046,65.7,2639035,59.2,289011,9.9
4216,November 1982,North Dakota,482000,318069,66.0,298741,62.0,19328,6.1
4217,November 1982,Ohio,8042000,5125879,63.7,4415705,54.9,710174,13.9
4218,November 1982,Oklahoma,2379000,1510293,63.5,1392904,58.5,117389,7.8
4219,November 1982,Oregon,2004000,1336193,66.7,1177433,58.8,158760,11.9
4220,November 1982,Pennsylvania,9158000,5495364,60.0,4812391,52.5,682973,12.4
4221,November 1982,Rhode Island,733000,473854,64.6,426414,58.2,47440,10.0
4222,November 1982,South Carolina,2321000,1484881,64.0,1310831,56.5,174050,11.7
4223,November 1982,South Dakota,500000,332824,66.6,313143,62.6,19681,5.9
4224,November 1982,Tennessee,3488000,2156499,61.8,1882207,54.0,274292,12.7
4225,November 1982,Texas,11096000,7519583,67.8,6914130,62.3,605453,8.1
4226,November 1982,Utah,1028000,680293,66.2,617582,60.1,62711,9.2
4227,November 1982,Vermont,389000,263915,67.8,244789,62.9,19126,7.2
4228,November 1982,Virginia,4042000,2680003,66.3,2468732,61.1,211271,7.9
4229,November 1982,Washington,3169000,2046432,64.6,1797105,56.7,249327,12.2
4230,November 1982,West Virginia,1466000,758488,51.7,624428,42.6,134060,17.7
4231,November 1982,Wisconsin,3539000,2434560,68.8,2151230,60.8,283330,11.6
4232,November 1982,Wyoming,361000,260422,72.1,239214,66.3,21208,8.1
4233,December 1982,Alabama,2899000,1738907,60.0,1469436,50.7,269471,15.5
4234,December 1982,Alaska,305000,221153,72.5,198453,65.1,22700,10.3
4235,December 1982,Arizona,2150000,1368048,63.6,1210987,56.3,157061,11.5
4236,December 1982,Arkansas,1706000,1030870,60.4,924710,54.2,106160,10.3
4237,December 1982,California,18562000,12245885,66.0,10903060,58.7,1342825,11.0
4238,December 1982,Colorado,2284000,1632599,71.5,1494818,65.4,137781,8.4
4239,December 1982,Connecticut,2424000,1611513,66.5,1497298,61.8,114215,7.1
4240,December 1982,Delaware,453000,294078,64.9,270286,59.7,23792,8.1
4241,December 1982,District of Columbia,484000,311467,64.4,277320,57.3,34147,11.0
4242,December 1982,Florida,8267000,4804475,58.1,4353657,52.7,450818,9.4
4243,December 1982,Georgia,4114000,2677813,65.1,2446593,59.5,231220,8.6
4244,December 1982,Hawaii,698000,466542,66.8,437238,62.6,29304,6.3
4245,December 1982,Idaho,684000,448941,65.6,403313,59.0,45628,10.2
4246,December 1982,Illinois,8567000,5626818,65.7,4896003,57.1,730815,13.0
4247,December 1982,Indiana,4051000,2595787,64.1,2269807,56.0,325980,12.6
4248,December 1982,Iowa,2158000,1424928,66.0,1296362,60.1,128566,9.0
4249,December 1982,Kansas,1777000,1200779,67.6,1117320,62.9,83459,7.0
4250,December 1982,Kentucky,2708000,1700192,62.8,1498297,55.3,201895,11.9
4251,December 1982,Louisiana,3136000,1869020,59.6,1657142,52.8,211878,11.3
4252,December 1982,Maine,848000,524473,61.8,479114,56.5,45359,8.6
4253,December 1982,Maryland,3236000,2173689,67.2,1997366,61.7,176323,8.1
4254,December 1982,Massachusetts,4455000,2985076,67.0,2757157,61.9,227919,7.6
4255,December 1982,Michigan,6735000,4295103,63.8,3586225,53.2,708878,16.5
4256,December 1982,Minnesota,3077000,2168631,70.5,1975558,64.2,193073,8.9
4257,December 1982,Mississippi,1820000,1063189,58.4,932435,51.2,130754,12.3
4258,December 1982,Missouri,3713000,2328723,62.7,2087086,56.2,241637,10.4
4259,December 1982,Montana,592000,392232,66.3,357742,60.4,34490,8.8
4260,December 1982,Nebraska,1168000,790679,67.7,741588,63.5,49091,6.2
4261,December 1982,Nevada,665000,483360,72.7,430987,64.8,52373,10.8
4262,December 1982,New Hampshire,715000,489191,68.4,455905,63.8,33286,6.8
4263,December 1982,New Jersey,5743000,3641983,63.4,3311259,57.7,330724,9.1
4264,December 1982,New Mexico,979000,603119,61.6,540621,55.2,62498,10.4
4265,December 1982,New York,13501000,7975272,59.1,7238089,53.6,737183,9.2
4266,December 1982,North Carolina,4461000,2923572,65.5,2631397,59.0,292175,10.0
4267,December 1982,North Dakota,483000,318480,65.9,298828,61.9,19652,6.2
4268,December 1982,Ohio,8041000,5122541,63.7,4406230,54.8,716311,14.0
4269,December 1982,Oklahoma,2385000,1514114,63.5,1390621,58.3,123493,8.2
4270,December 1982,Oregon,2004000,1339362,66.8,1180510,58.9,158852,11.9
4271,December 1982,Pennsylvania,9161000,5490855,59.9,4797120,52.4,693735,12.6
4272,December 1982,Rhode Island,733000,473376,64.6,426422,58.2,46954,9.9
4273,December 1982,South Carolina,2323000,1486711,64.0,1311403,56.5,175308,11.8
4274,December 1982,South Dakota,501000,333086,66.5,313372,62.5,19714,5.9
4275,December 1982,Tennessee,3490000,2158595,61.9,1880911,53.9,277684,12.9
4276,December 1982,Texas,11123000,7543336,67.8,6919409,62.2,623927,8.3
4277,December 1982,Utah,1031000,681172,66.1,617292,59.9,63880,9.4
4278,December 1982,Vermont,389000,263818,67.8,244603,62.9,19215,7.3
4279,December 1982,Virginia,4047000,2686503,66.4,2474205,61.1,212298,7.9
4280,December 1982,Washington,3171000,2047070,64.6,1799360,56.7,247710,12.1
4281,December 1982,West Virginia,1467000,758901,51.7,620349,42.3,138552,18.3
4282,December 1982,Wisconsin,3539000,2432867,68.7,2145378,60.6,287489,11.8
4283,December 1982,Wyoming,361000,261460,72.4,239100,66.2,22360,8.6
4284,January 1983,Alabama,2901000,1739659,60.0,1471782,50.7,267877,15.4
4285,January 1983,Alaska,307000,222970,72.6,200033,65.2,22937,10.3
4286,January 1983,Arizona,2156000,1368306,63.5,1213496,56.3,154810,11.3
4287,January 1983,Arkansas,1708000,1029367,60.3,923004,54.0,106363,10.3
4288,January 1983,California,18584000,12240776,65.9,10898047,58.6,1342729,11.0
4289,January 1983,Colorado,2289000,1639050,71.6,1501103,65.6,137947,8.4
4290,January 1983,Connecticut,2425000,1610953,66.4,1497699,61.8,113254,7.0
4291,January 1983,Delaware,453000,294034,64.9,270255,59.7,23779,8.1
4292,January 1983,District of Columbia,484000,312470,64.6,277799,57.4,34671,11.1
4293,January 1983,Florida,8286000,4806797,58.0,4352322,52.5,454475,9.5
4294,January 1983,Georgia,4119000,2677278,65.0,2446265,59.4,231013,8.6
4295,January 1983,Hawaii,699000,467731,66.9,437871,62.6,29860,6.4
4296,January 1983,Idaho,685000,449324,65.6,404026,59.0,45298,10.1
4297,January 1983,Illinois,8568000,5618866,65.6,4884183,57.0,734683,13.1
4298,January 1983,Indiana,4051000,2586314,63.8,2264195,55.9,322119,12.5
4299,January 1983,Iowa,2158000,1423309,66.0,1294251,60.0,129058,9.1
4300,January 1983,Kansas,1778000,1197373,67.3,1115719,62.8,81654,6.8
4301,January 1983,Kentucky,2710000,1700816,62.8,1496580,55.2,204236,12.0
4302,January 1983,Louisiana,3141000,1872974,59.6,1655596,52.7,217378,11.6
4303,January 1983,Maine,848000,526547,62.1,480569,56.7,45978,8.7
4304,January 1983,Maryland,3237000,2175594,67.2,2001177,61.8,174417,8.0
4305,January 1983,Massachusetts,4457000,2980912,66.9,2755581,61.8,225331,7.6
4306,January 1983,Michigan,6731000,4289101,63.7,3586193,53.3,702908,16.4
4307,January 1983,Minnesota,3078000,2169076,70.5,1976498,64.2,192578,8.9
4308,January 1983,Mississippi,1821000,1062844,58.4,929534,51.0,133310,12.5
4309,January 1983,Missouri,3715000,2329296,62.7,2084532,56.1,244764,10.5
4310,January 1983,Montana,593000,392881,66.3,358248,60.4,34633,8.8
4311,January 1983,Nebraska,1169000,791232,67.7,741460,63.4,49772,6.3
4312,January 1983,Nevada,665000,484050,72.8,431650,64.9,52400,10.8
4313,January 1983,New Hampshire,715000,489872,68.5,457089,63.9,32783,6.7
4314,January 1983,New Jersey,5749000,3638955,63.3,3310366,57.6,328589,9.0
4315,January 1983,New Mexico,981000,603937,61.6,540609,55.1,63328,10.5
4316,January 1983,New York,13508000,7975079,59.0,7232729,53.5,742350,9.3
4317,January 1983,North Carolina,4464000,2918516,65.4,2624923,58.8,293593,10.1
4318,January 1983,North Dakota,484000,318838,65.9,298995,61.8,19843,6.2
4319,January 1983,Ohio,8039000,5115824,63.6,4400187,54.7,715637,14.0
4320,January 1983,Oklahoma,2391000,1517884,63.5,1389288,58.1,128596,8.5
4321,January 1983,Oregon,2005000,1340994,66.9,1183865,59.0,157129,11.7
4322,January 1983,Pennsylvania,9163000,5483364,59.8,4784973,52.2,698391,12.7
4323,January 1983,Rhode Island,734000,473304,64.5,427247,58.2,46057,9.7
4324,January 1983,South Carolina,2326000,1487706,64.0,1312483,56.4,175223,11.8
4325,January 1983,South Dakota,501000,333170,66.5,313542,62.6,19628,5.9
4326,January 1983,Tennessee,3492000,2158636,61.8,1880606,53.9,278030,12.9
4327,January 1983,Texas,11149000,7560844,67.8,6924652,62.1,636192,8.4
4328,January 1983,Utah,1034000,682025,66.0,617215,59.7,64810,9.5
4329,January 1983,Vermont,389000,263783,67.8,244573,62.9,19210,7.3
4330,January 1983,Virginia,4052000,2690087,66.4,2479873,61.2,210214,7.8
4331,January 1983,Washington,3173000,2045662,64.5,1800701,56.8,244961,12.0
4332,January 1983,West Virginia,1468000,760955,51.8,619237,42.2,141718,18.6
4333,January 1983,Wisconsin,3539000,2428275,68.6,2140458,60.5,287817,11.9
4334,January 1983,Wyoming,361000,262367,72.7,238920,66.2,23447,8.9
4335,February 1983,Alabama,2903000,1739908,59.9,1476061,50.8,263847,15.2
4336,February 1983,Alaska,310000,224904,72.5,201905,65.1,22999,10.2
4337,February 1983,Arizona,2163000,1368580,63.3,1217823,56.3,150757,11.0
4338,February 1983,Arkansas,1709000,1027484,60.1,921532,53.9,105952,10.3
4339,February 1983,California,18606000,12233629,65.8,10902095,58.6,1331534,10.9
4340,February 1983,Colorado,2295000,1644532,71.7,1507559,65.7,136973,8.3
4341,February 1983,Connecticut,2426000,1610068,66.4,1498844,61.8,111224,6.9
4342,February 1983,Delaware,454000,293997,64.8,270226,59.5,23771,8.1
4343,February 1983,District of Columbia,483000,313615,64.9,278500,57.7,35115,11.2
4344,February 1983,Florida,8306000,4811180,57.9,4357241,52.5,453939,9.4
4345,February 1983,Georgia,4124000,2674326,64.8,2447222,59.3,227104,8.5
4346,February 1983,Hawaii,701000,468499,66.8,438196,62.5,30303,6.5
4347,February 1983,Idaho,686000,449604,65.5,405146,59.1,44458,9.9
4348,February 1983,Illinois,8570000,5610337,65.5,4877115,56.9,733222,13.1
4349,February 1983,Indiana,4052000,2574814,63.5,2259483,55.8,315331,12.2
4350,February 1983,Iowa,2159000,1420898,65.8,1292835,59.9,128063,9.0
4351,February 1983,Kansas,1780000,1193572,67.1,1114157,62.6,79415,6.7
4352,February 1983,Kentucky,2713000,1700021,62.7,1495184,55.1,204837,12.0
4353,February 1983,Louisiana,3146000,1878630,59.7,1655971,52.6,222659,11.9
4354,February 1983,Maine,849000,528599,62.3,482121,56.8,46478,8.8
4355,February 1983,Maryland,3239000,2177888,67.2,2006182,61.9,171706,7.9
4356,February 1983,Massachusetts,4460000,2977257,66.8,2755279,61.8,221978,7.5
4357,February 1983,Michigan,6727000,4282617,63.7,3592243,53.4,690374,16.1
4358,February 1983,Minnesota,3080000,2169708,70.4,1978461,64.2,191247,8.8
4359,February 1983,Mississippi,1822000,1062567,58.3,927178,50.9,135389,12.7
4360,February 1983,Missouri,3717000,2331375,62.7,2084823,56.1,246552,10.6
4361,February 1983,Montana,593000,393418,66.3,358755,60.5,34663,8.8
4362,February 1983,Nebraska,1170000,791270,67.6,741480,63.4,49790,6.3
4363,February 1983,Nevada,666000,484632,72.8,432647,65.0,51985,10.7
4364,February 1983,New Hampshire,716000,490976,68.6,458972,64.1,32004,6.5
4365,February 1983,New Jersey,5754000,3635797,63.2,3312234,57.6,323563,8.9
4366,February 1983,New Mexico,984000,604812,61.5,541125,55.0,63687,10.5
4367,February 1983,New York,13516000,7976511,59.0,7234185,53.5,742326,9.3
4368,February 1983,North Carolina,4468000,2914754,65.2,2622065,58.7,292689,10.0
4369,February 1983,North Dakota,484000,319114,65.9,299268,61.8,19846,6.2
4370,February 1983,Ohio,8037000,5107749,63.6,4399171,54.7,708578,13.9
4371,February 1983,Oklahoma,2397000,1522172,63.5,1389713,58.0,132459,8.7
4372,February 1983,Oregon,2005000,1341156,66.9,1187207,59.2,153949,11.5
4373,February 1983,Pennsylvania,9166000,5476306,59.7,4779674,52.1,696632,12.7
4374,February 1983,Rhode Island,734000,473682,64.5,428766,58.4,44916,9.5
4375,February 1983,South Carolina,2329000,1487637,63.9,1314447,56.4,173190,11.6
4376,February 1983,South Dakota,502000,333104,66.4,313705,62.5,19399,5.8
4377,February 1983,Tennessee,3494000,2157691,61.8,1882262,53.9,275429,12.8
4378,February 1983,Texas,11176000,7574330,67.8,6932802,62.0,641528,8.5
4379,February 1983,Utah,1037000,682974,65.9,617517,59.5,65457,9.6
4380,February 1983,Vermont,390000,263803,67.6,244748,62.8,19055,7.2
4381,February 1983,Virginia,4058000,2692004,66.3,2487087,61.3,204917,7.6
4382,February 1983,Washington,3175000,2043675,64.4,1802183,56.8,241492,11.8
4383,February 1983,West Virginia,1468000,762675,52.0,619482,42.2,143193,18.8
4384,February 1983,Wisconsin,3538000,2421729,68.4,2138107,60.4,283622,11.7
4385,February 1983,Wyoming,362000,262896,72.6,238618,65.9,24278,9.2
4386,March 1983,Alabama,2904000,1741024,60.0,1482610,51.1,258414,14.8
4387,March 1983,Alaska,313000,226848,72.5,203940,65.2,22908,10.1
4388,March 1983,Arizona,2169000,1369809,63.2,1224360,56.4,145449,10.6
4389,March 1983,Arkansas,1711000,1025785,60.0,920802,53.8,104983,10.2
4390,March 1983,California,18628000,12229197,65.6,10918657,58.6,1310540,10.7
4391,March 1983,Colorado,2300000,1649261,71.7,1514401,65.8,134860,8.2
4392,March 1983,Connecticut,2427000,1609636,66.3,1501265,61.9,108371,6.7
4393,March 1983,Delaware,454000,294006,64.8,270289,59.5,23717,8.1
4394,March 1983,District of Columbia,483000,314788,65.2,279333,57.8,35455,11.3
4395,March 1983,Florida,8326000,4822130,57.9,4372088,52.5,450042,9.3
4396,March 1983,Georgia,4129000,2671425,64.7,2450128,59.3,221297,8.3
4397,March 1983,Hawaii,703000,469048,66.7,438590,62.4,30458,6.5
4398,March 1983,Idaho,687000,449996,65.5,406611,59.2,43385,9.6
4399,March 1983,Illinois,8571000,5603485,65.4,4877393,56.9,726092,13.0
4400,March 1983,Indiana,4052000,2564967,63.3,2257782,55.7,307185,12.0
4401,March 1983,Iowa,2159000,1418800,65.7,1292941,59.9,125859,8.9
4402,March 1983,Kansas,1781000,1190222,66.8,1113378,62.5,76844,6.5
4403,March 1983,Kentucky,2715000,1698523,62.6,1494459,55.0,204064,12.0
4404,March 1983,Louisiana,3151000,1885756,59.8,1658595,52.6,227161,12.0
4405,March 1983,Maine,850000,530586,62.4,483827,56.9,46759,8.8
4406,March 1983,Maryland,3240000,2180379,67.3,2012068,62.1,168311,7.7
4407,March 1983,Massachusetts,4462000,2975305,66.7,2757568,61.8,217737,7.3
4408,March 1983,Michigan,6723000,4278098,63.6,3604206,53.6,673892,15.8
4409,March 1983,Minnesota,3081000,2170531,70.4,1981752,64.3,188779,8.7
4410,March 1983,Mississippi,1823000,1062597,58.3,926143,50.8,136454,12.8
4411,March 1983,Missouri,3720000,2335107,62.8,2087997,56.1,247110,10.6
4412,March 1983,Montana,594000,393922,66.3,359266,60.5,34656,8.8
4413,March 1983,Nebraska,1171000,790777,67.5,741749,63.3,49028,6.2
4414,March 1983,Nevada,667000,485044,72.7,433885,65.1,51159,10.5
4415,March 1983,New Hampshire,717000,492336,68.7,461386,64.3,30950,6.3
4416,March 1983,New Jersey,5760000,3636016,63.1,3318941,57.6,317075,8.7
4417,March 1983,New Mexico,986000,605812,61.4,542343,55.0,63469,10.5
4418,March 1983,New York,13523000,7982910,59.0,7244713,53.6,738197,9.2
4419,March 1983,North Carolina,4472000,2913697,65.2,2624599,58.7,289098,9.9
4420,March 1983,North Dakota,485000,319290,65.8,299659,61.8,19631,6.1
4421,March 1983,Ohio,8036000,5100351,63.5,4404167,54.8,696184,13.6
4422,March 1983,Oklahoma,2403000,1527235,63.6,1392377,57.9,134858,8.8
4423,March 1983,Oregon,2005000,1340305,66.8,1190056,59.4,150249,11.2
4424,March 1983,Pennsylvania,9169000,5471531,59.7,4782781,52.2,688750,12.6
4425,March 1983,Rhode Island,734000,474384,64.6,430673,58.7,43711,9.2
4426,March 1983,South Carolina,2331000,1486243,63.8,1317462,56.5,168781,11.4
4427,March 1983,South Dakota,502000,333012,66.3,313959,62.5,19053,5.7
4428,March 1983,Tennessee,3496000,2157173,61.7,1886497,54.0,270676,12.5
4429,March 1983,Texas,11203000,7586596,67.7,6946093,62.0,640503,8.4
4430,March 1983,Utah,1040000,683938,65.8,618317,59.5,65621,9.6
4431,March 1983,Vermont,390000,263845,67.7,245126,62.9,18719,7.1
4432,March 1983,Virginia,4063000,2694133,66.3,2496871,61.5,197262,7.3
4433,March 1983,Washington,3177000,2042482,64.3,1804645,56.8,237837,11.6
4434,March 1983,West Virginia,1469000,763804,52.0,620621,42.2,143183,18.7
4435,March 1983,Wisconsin,3538000,2414961,68.3,2139322,60.5,275639,11.4
4436,March 1983,Wyoming,362000,262796,72.6,238185,65.8,24611,9.4
4437,April 1983,Alabama,2906000,1744212,60.0,1491185,51.3,253027,14.5
4438,April 1983,Alaska,315000,228709,72.6,205971,65.4,22738,9.9
4439,April 1983,Arizona,2175000,1372593,63.1,1233163,56.7,139430,10.2
4440,April 1983,Arkansas,1713000,1024824,59.8,921064,53.8,103760,10.1
4441,April 1983,California,18649000,12233450,65.6,10949144,58.7,1284306,10.5
4442,April 1983,Colorado,2305000,1653847,71.8,1522058,66.0,131789,8.0
4443,April 1983,Connecticut,2428000,1610408,66.3,1505322,62.0,105086,6.5
4444,April 1983,Delaware,455000,294110,64.6,270519,59.5,23591,8.0
4445,April 1983,District of Columbia,483000,315903,65.4,280192,58.0,35711,11.3
4446,April 1983,Florida,8346000,4842860,58.0,4398475,52.7,444385,9.2
4447,April 1983,Georgia,4134000,2671476,64.6,2455442,59.4,216034,8.1
4448,April 1983,Hawaii,704000,469639,66.7,439346,62.4,30293,6.5
4449,April 1983,Idaho,687000,450628,65.6,408268,59.4,42360,9.4
4450,April 1983,Illinois,8573000,5601070,65.3,4886331,57.0,714739,12.8
4451,April 1983,Indiana,4053000,2560487,63.2,2260626,55.8,299861,11.7
4452,April 1983,Iowa,2159000,1418045,65.7,1295007,60.0,123038,8.7
4453,April 1983,Kansas,1782000,1187842,66.7,1113806,62.5,74036,6.2
4454,April 1983,Kentucky,2717000,1697668,62.5,1494858,55.0,202810,11.9
4455,April 1983,Louisiana,3155000,1894126,60.0,1663577,52.7,230549,12.2
4456,April 1983,Maine,851000,532554,62.6,485713,57.1,46841,8.8
4457,April 1983,Maryland,3242000,2183333,67.3,2018841,62.3,164492,7.5
4458,April 1983,Massachusetts,4465000,2976282,66.7,2763236,61.9,213046,7.2
4459,April 1983,Michigan,6720000,4278830,63.7,3621244,53.9,657586,15.4
4460,April 1983,Minnesota,3082000,2171677,70.5,1986269,64.4,185408,8.5
4461,April 1983,Mississippi,1823000,1063118,58.3,926818,50.8,136300,12.8
4462,April 1983,Missouri,3722000,2340785,62.9,2094103,56.3,246682,10.5
4463,April 1983,Montana,595000,394571,66.3,359910,60.5,34661,8.8
4464,April 1983,Nebraska,1171000,789909,67.5,742301,63.4,47608,6.0
4465,April 1983,Nevada,668000,485282,72.6,435244,65.2,50038,10.3
4466,April 1983,New Hampshire,718000,493791,68.8,464071,64.6,29720,6.0
4467,April 1983,New Jersey,5766000,3642813,63.2,3331704,57.8,311109,8.5
4468,April 1983,New Mexico,988000,606926,61.4,544215,55.1,62711,10.3
4469,April 1983,New York,13530000,7997761,59.1,7265240,53.7,732521,9.2
4470,April 1983,North Carolina,4476000,2917105,65.2,2633181,58.8,283924,9.7
4471,April 1983,North Dakota,486000,319389,65.7,300155,61.8,19234,6.0
4472,April 1983,Ohio,8034000,5096177,63.4,4415335,55.0,680842,13.4
4473,April 1983,Oklahoma,2409000,1533032,63.6,1397102,58.0,135930,8.9
4474,April 1983,Oregon,2005000,1338945,66.8,1192038,59.5,146907,11.0
4475,April 1983,Pennsylvania,9171000,5470596,59.7,4794101,52.3,676495,12.4
4476,April 1983,Rhode Island,734000,475246,64.7,432692,58.9,42554,9.0
4477,April 1983,South Carolina,2334000,1484178,63.6,1321718,56.6,162460,10.9
4478,April 1983,South Dakota,503000,333037,66.2,314423,62.5,18614,5.6
4479,April 1983,Tennessee,3498000,2159233,61.7,1893724,54.1,265509,12.3
4480,April 1983,Texas,11229000,7601840,67.7,6966048,62.0,635792,8.4
4481,April 1983,Utah,1042000,684901,65.7,619697,59.5,65204,9.5
4482,April 1983,Vermont,391000,263897,67.5,245662,62.8,18235,6.9
4483,April 1983,Virginia,4068000,2698497,66.3,2509506,61.7,188991,7.0
4484,April 1983,Washington,3179000,2043447,64.3,1808751,56.9,234696,11.5
4485,April 1983,West Virginia,1470000,764709,52.0,622474,42.3,142235,18.6
4486,April 1983,Wisconsin,3538000,2409894,68.1,2144181,60.6,265713,11.0
4487,April 1983,Wyoming,363000,262080,72.2,237715,65.5,24365,9.3
4488,May 1983,Alabama,2908000,1749695,60.2,1501086,51.6,248609,14.2
4489,May 1983,Alaska,318000,230426,72.5,207838,65.4,22588,9.8
4490,May 1983,Arizona,2181000,1376961,63.1,1243872,57.0,133089,9.7
4491,May 1983,Arkansas,1715000,1024917,59.8,922231,53.8,102686,10.0
4492,May 1983,California,18671000,12248058,65.6,10992202,58.9,1255856,10.3
4493,May 1983,Colorado,2310000,1658779,71.8,1530935,66.3,127844,7.7
4494,May 1983,Connecticut,2430000,1612517,66.4,1510921,62.2,101596,6.3
4495,May 1983,Delaware,455000,294374,64.7,270954,59.6,23420,8.0
4496,May 1983,District of Columbia,483000,316908,65.6,281011,58.2,35897,11.3
4497,May 1983,Florida,8366000,4873123,58.2,4435089,53.0,438034,9.0
4498,May 1983,Georgia,4139000,2675766,64.6,2463213,59.5,212553,7.9
4499,May 1983,Hawaii,706000,470431,66.6,440556,62.4,29875,6.4
4500,May 1983,Idaho,688000,451519,65.6,410011,59.6,41508,9.2
4501,May 1983,Illinois,8574000,5602934,65.3,4902836,57.2,700098,12.5
4502,May 1983,Indiana,4053000,2562821,63.2,2268296,56.0,294525,11.5
4503,May 1983,Iowa,2159000,1418937,65.7,1299030,60.2,119907,8.5
4504,May 1983,Kansas,1783000,1186643,66.6,1115376,62.6,71267,6.0
4505,May 1983,Kentucky,2719000,1698288,62.5,1496714,55.0,201574,11.9
4506,May 1983,Louisiana,3160000,1903256,60.2,1670936,52.9,232320,12.2
4507,May 1983,Maine,852000,534423,62.7,487757,57.2,46666,8.7
4508,May 1983,Maryland,3243000,2187338,67.4,2026742,62.5,160596,7.3
4509,May 1983,Massachusetts,4467000,2980657,66.7,2772163,62.1,208494,7.0
4510,May 1983,Michigan,6716000,4285474,63.8,3642130,54.2,643344,15.0
4511,May 1983,Minnesota,3083000,2173207,70.5,1991654,64.6,181553,8.4
4512,May 1983,Mississippi,1824000,1063974,58.3,929011,50.9,134963,12.7
4513,May 1983,Missouri,3724000,2347924,63.0,2102799,56.5,245125,10.4
4514,May 1983,Montana,596000,395475,66.4,360796,60.5,34679,8.8
4515,May 1983,Nebraska,1172000,788844,67.3,743076,63.4,45768,5.8
4516,May 1983,Nevada,669000,485403,72.6,436638,65.3,48765,10.0
4517,May 1983,New Hampshire,719000,495316,68.9,466877,64.9,28439,5.7
4518,May 1983,New Jersey,5772000,3656527,63.3,3350272,58.0,306255,8.4
4519,May 1983,New Mexico,990000,608054,61.4,546506,55.2,61548,10.1
4520,May 1983,New York,13537000,8019832,59.2,7293924,53.9,725908,9.1
4521,May 1983,North Carolina,4480000,2925204,65.3,2647154,59.1,278050,9.5
4522,May 1983,North Dakota,487000,319476,65.6,300765,61.8,18711,5.9
4523,May 1983,Ohio,8032000,5096167,63.4,4431858,55.2,664309,13.0
4524,May 1983,Oklahoma,2415000,1538972,63.7,1403257,58.1,135715,8.8
4525,May 1983,Oregon,2006000,1337524,66.7,1192903,59.5,144621,10.8
4526,May 1983,Pennsylvania,9174000,5474083,59.7,4812224,52.5,661859,12.1
4527,May 1983,Rhode Island,735000,476178,64.8,434662,59.1,41516,8.7
4528,May 1983,South Carolina,2337000,1482396,63.4,1327200,56.8,155196,10.5
4529,May 1983,South Dakota,503000,333262,66.3,315162,62.7,18100,5.4
4530,May 1983,Tennessee,3501000,2164866,61.8,1903837,54.4,261029,12.1
4531,May 1983,Texas,11256000,7621730,67.7,6992199,62.1,629531,8.3
4532,May 1983,Utah,1045000,685948,65.6,621727,59.5,64221,9.4
4533,May 1983,Vermont,391000,263964,67.5,246292,63.0,17672,6.7
4534,May 1983,Virginia,4073000,2705882,66.4,2524294,62.0,181588,6.7
4535,May 1983,Washington,3182000,2047099,64.3,1814753,57.0,232346,11.4
4536,May 1983,West Virginia,1471000,765584,52.0,624826,42.5,140758,18.4
4537,May 1983,Wisconsin,3538000,2407715,68.1,2151861,60.8,255854,10.6
4538,May 1983,Wyoming,363000,260953,71.9,237376,65.4,23577,9.0
4539,June 1983,Alabama,2909000,1756511,60.4,1511392,52.0,245119,14.0
4540,June 1983,Alaska,320000,231971,72.5,209442,65.5,22529,9.7
4541,June 1983,Arizona,2187000,1382566,63.2,1255822,57.4,126744,9.2
4542,June 1983,Arkansas,1716000,1026092,59.8,924233,53.9,101859,9.9
4543,June 1983,California,18693000,12270288,65.6,11044547,59.1,1225741,10.0
4544,June 1983,Colorado,2315000,1664075,71.9,1541146,66.6,122929,7.4
4545,June 1983,Connecticut,2431000,1615653,66.5,1517527,62.4,98126,6.1
4546,June 1983,Delaware,456000,294858,64.7,271636,59.6,23222,7.9
4547,June 1983,District of Columbia,483000,317706,65.8,281695,58.3,36011,11.3
4548,June 1983,Florida,8386000,4909574,58.5,4478643,53.4,430931,8.8
4549,June 1983,Georgia,4144000,2683779,64.8,2473159,59.7,210620,7.8
4550,June 1983,Hawaii,707000,471446,66.7,442079,62.5,29367,6.2
4551,June 1983,Idaho,689000,452651,65.7,411856,59.8,40795,9.0
4552,June 1983,Illinois,8576000,5606672,65.4,4924334,57.4,682338,12.2
4553,June 1983,Indiana,4054000,2570934,63.4,2280036,56.2,290898,11.3
4554,June 1983,Iowa,2159000,1421169,65.8,1304437,60.4,116732,8.2
4555,June 1983,Kansas,1784000,1186520,66.5,1117692,62.7,68828,5.8
4556,June 1983,Kentucky,2721000,1700404,62.5,1500098,55.1,200306,11.8
4557,June 1983,Louisiana,3165000,1912254,60.4,1680368,53.1,231886,12.1
4558,June 1983,Maine,853000,536114,62.9,489976,57.4,46138,8.6
4559,June 1983,Maryland,3245000,2192543,67.6,2035869,62.7,156674,7.1
4560,June 1983,Massachusetts,4470000,2987874,66.8,2783585,62.3,204289,6.8
4561,June 1983,Michigan,6712000,4294733,64.0,3665121,54.6,629612,14.7
4562,June 1983,Minnesota,3084000,2174739,70.5,1997511,64.8,177228,8.1
4563,June 1983,Mississippi,1825000,1064665,58.3,932073,51.1,132592,12.5
4564,June 1983,Missouri,3727000,2355634,63.2,2113558,56.7,242076,10.3
4565,June 1983,Montana,596000,396556,66.5,361887,60.7,34669,8.7
4566,June 1983,Nebraska,1173000,787727,67.2,743926,63.4,43801,5.6
4567,June 1983,Nevada,670000,485521,72.5,438080,65.4,47441,9.8
4568,June 1983,New Hampshire,720000,496963,69.0,469734,65.2,27229,5.5
4569,June 1983,New Jersey,5777000,3674751,63.6,3373109,58.4,301642,8.2
4570,June 1983,New Mexico,992000,609094,61.4,548925,55.3,60169,9.9
4571,June 1983,New York,13544000,8044373,59.4,7327161,54.1,717212,8.9
4572,June 1983,North Carolina,4484000,2936591,65.5,2664988,59.4,271603,9.2
4573,June 1983,North Dakota,487000,319625,65.6,301495,61.9,18130,5.7
4574,June 1983,Ohio,8031000,5099119,63.5,4452208,55.4,646911,12.7
4575,June 1983,Oklahoma,2421000,1544430,63.8,1410107,58.2,134323,8.7
4576,June 1983,Oregon,2006000,1336113,66.6,1192679,59.5,143434,10.7
4577,June 1983,Pennsylvania,9176000,5480522,59.7,4834952,52.7,645570,11.8
4578,June 1983,Rhode Island,735000,477103,64.9,436533,59.4,40570,8.5
4579,June 1983,South Carolina,2339000,1481344,63.3,1333508,57.0,147836,10.0
4580,June 1983,South Dakota,504000,333689,66.2,316139,62.7,17550,5.3
4581,June 1983,Tennessee,3503000,2173538,62.0,1916398,54.7,257140,11.8
4582,June 1983,Texas,11282000,7644471,67.8,7022295,62.2,622176,8.1
4583,June 1983,Utah,1048000,687113,65.6,624429,59.6,62684,9.1
4584,June 1983,Vermont,392000,264053,67.4,246968,63.0,17085,6.5
4585,June 1983,Virginia,4078000,2715738,66.6,2540120,62.3,175618,6.5
4586,June 1983,Washington,3184000,2052818,64.5,1822378,57.2,230440,11.2
4587,June 1983,West Virginia,1471000,766432,52.1,627437,42.7,138995,18.1
4588,June 1983,Wisconsin,3538000,2408733,68.1,2161177,61.1,247556,10.3
4589,June 1983,Wyoming,364000,259677,71.3,237319,65.2,22358,8.6
4590,July 1983,Alabama,2911000,1763142,60.6,1521360,52.3,241782,13.7
4591,July 1983,Alaska,323000,233307,72.2,210722,65.2,22585,9.7
4592,July 1983,Arizona,2193000,1388626,63.3,1268448,57.8,120178,8.7
4593,July 1983,Arkansas,1718000,1028323,59.9,927141,54.0,101182,9.8
4594,July 1983,California,18715000,12295709,65.7,11101896,59.3,1193813,9.7
4595,July 1983,Colorado,2320000,1669571,72.0,1552358,66.9,117213,7.0
4596,July 1983,Connecticut,2432000,1619408,66.6,1524556,62.7,94852,5.9
4597,July 1983,Delaware,456000,295595,64.8,272592,59.8,23003,7.8
4598,July 1983,District of Columbia,483000,318192,65.9,282140,58.4,36052,11.3
4599,July 1983,Florida,8406000,4947630,58.9,4525209,53.8,422421,8.5
4600,July 1983,Georgia,4149000,2693532,64.9,2484725,59.9,208807,7.8
4601,July 1983,Hawaii,709000,472579,66.7,443668,62.6,28911,6.1
4602,July 1983,Idaho,690000,454012,65.8,413819,60.0,40193,8.9
4603,July 1983,Illinois,8577000,5609314,65.4,4948113,57.7,661201,11.8
4604,July 1983,Indiana,4054000,2581882,63.7,2294177,56.6,287705,11.1
4605,July 1983,Iowa,2159000,1423998,66.0,1310281,60.7,113717,8.0
4606,July 1983,Kansas,1785000,1187049,66.5,1120206,62.8,66843,5.6
4607,July 1983,Kentucky,2723000,1703144,62.5,1504875,55.3,198269,11.6
4608,July 1983,Louisiana,3170000,1920047,60.6,1691024,53.3,229023,11.9
4609,July 1983,Maine,854000,537600,63.0,492301,57.6,45299,8.4
4610,July 1983,Maryland,3246000,2198745,67.7,2046056,63.0,152689,6.9
4611,July 1983,Massachusetts,4472000,2996797,67.0,2796519,62.5,200278,6.7
4612,July 1983,Michigan,6708000,4302628,64.1,3688354,55.0,614274,14.3
4613,July 1983,Minnesota,3085000,2175942,70.5,2003426,64.9,172516,7.9
4614,July 1983,Mississippi,1826000,1064513,58.3,935080,51.2,129433,12.2
4615,July 1983,Missouri,3729000,2363021,63.4,2125921,57.0,237100,10.0
4616,July 1983,Montana,597000,397664,66.6,363068,60.8,34596,8.7
4617,July 1983,Nebraska,1174000,786743,67.0,744688,63.4,42055,5.3
4618,July 1983,Nevada,671000,485705,72.4,439608,65.5,46097,9.5
4619,July 1983,New Hampshire,721000,498717,69.2,472516,65.5,26201,5.3
4620,July 1983,New Jersey,5783000,3694485,63.9,3398252,58.8,296233,8.0
4621,July 1983,New Mexico,994000,609936,61.4,551198,55.5,58738,9.6
4622,July 1983,New York,13551000,8066458,59.5,7361277,54.3,705181,8.7
4623,July 1983,North Carolina,4488000,2949195,65.7,2684649,59.8,264546,9.0
4624,July 1983,North Dakota,488000,319909,65.6,302303,61.9,17606,5.5
4625,July 1983,Ohio,8029000,5102172,63.5,4474433,55.7,627739,12.3
4626,July 1983,Oklahoma,2427000,1548828,63.8,1416871,58.4,131957,8.5
4627,July 1983,Oregon,2006000,1334428,66.5,1191726,59.4,142702,10.7
4628,July 1983,Pennsylvania,9179000,5486829,59.8,4859078,52.9,627751,11.4
4629,July 1983,Rhode Island,735000,477858,65.0,438303,59.6,39555,8.3
4630,July 1983,South Carolina,2342000,1481174,63.2,1340167,57.2,141007,9.5
4631,July 1983,South Dakota,504000,334296,66.3,317257,62.9,17039,5.1
4632,July 1983,Tennessee,3505000,2183562,62.3,1930749,55.1,252813,11.6
4633,July 1983,Texas,11309000,7666775,67.8,7053672,62.4,613103,8.0
4634,July 1983,Utah,1051000,688410,65.5,627739,59.7,60671,8.8
4635,July 1983,Vermont,392000,264178,67.4,247643,63.2,16535,6.3
4636,July 1983,Virginia,4083000,2726388,66.8,2555775,62.6,170613,6.3
4637,July 1983,Washington,3186000,2059392,64.6,1831121,57.5,228271,11.1
4638,July 1983,West Virginia,1472000,767200,52.1,630124,42.8,137076,17.9
4639,July 1983,Wisconsin,3538000,2412109,68.2,2171047,61.4,241062,10.0
4640,July 1983,Wyoming,364000,258571,71.0,237613,65.3,20958,8.1
4641,August 1983,Alabama,2913000,1768126,60.7,1530233,52.5,237893,13.5
4642,August 1983,Alaska,324000,234437,72.4,211664,65.3,22773,9.7
4643,August 1983,Arizona,2200000,1394073,63.4,1280973,58.2,113100,8.1
4644,August 1983,Arkansas,1719000,1031350,60.0,930794,54.1,100556,9.7
4645,August 1983,California,18754000,12319495,65.7,11158314,59.5,1161181,9.4
4646,August 1983,Colorado,2323000,1674946,72.1,1563625,67.3,111321,6.6
4647,August 1983,Connecticut,2434000,1623161,66.7,1531304,62.9,91857,5.7
4648,August 1983,Delaware,457000,296565,64.9,273785,59.9,22780,7.7
4649,August 1983,District of Columbia,483000,318302,65.9,282284,58.4,36018,11.3
4650,August 1983,Florida,8428000,4981875,59.1,4569638,54.2,412237,8.3
4651,August 1983,Georgia,4157000,2702786,65.0,2496612,60.1,206174,7.6
4652,August 1983,Hawaii,710000,473539,66.7,445010,62.7,28529,6.0
4653,August 1983,Idaho,691000,455482,65.9,415893,60.2,39589,8.7
4654,August 1983,Illinois,8580000,5608591,65.4,4970550,57.9,638041,11.4
4655,August 1983,Indiana,4056000,2592368,63.9,2308231,56.9,284137,11.0
4656,August 1983,Iowa,2159000,1426314,66.1,1315456,60.9,110858,7.8
4657,August 1983,Kansas,1786000,1187649,66.5,1122257,62.8,65392,5.5
4658,August 1983,Kentucky,2724000,1705360,62.6,1510520,55.5,194840,11.4
4659,August 1983,Louisiana,3171000,1925503,60.7,1701497,53.7,224006,11.6
4660,August 1983,Maine,855000,538819,63.0,494569,57.8,44250,8.2
4661,August 1983,Maryland,3250000,2205051,67.8,2056385,63.3,148666,6.7
4662,August 1983,Massachusetts,4476000,3005808,67.2,2809374,62.8,196434,6.5
4663,August 1983,Michigan,6711000,4305561,64.2,3709064,55.3,596497,13.9
4664,August 1983,Minnesota,3087000,2176892,70.5,2009001,65.1,167891,7.7
4665,August 1983,Mississippi,1827000,1062926,58.2,937073,51.3,125853,11.8
4666,August 1983,Missouri,3732000,2369173,63.5,2138476,57.3,230697,9.7
4667,August 1983,Montana,597000,398605,66.8,364158,61.0,34447,8.6
4668,August 1983,Nebraska,1175000,786028,66.9,745262,63.4,40766,5.2
4669,August 1983,Nevada,673000,485979,72.2,441237,65.6,44742,9.2
4670,August 1983,New Hampshire,722000,500537,69.3,475132,65.8,25405,5.1
4671,August 1983,New Jersey,5788000,3712831,64.1,3423070,59.1,289761,7.8
4672,August 1983,New Mexico,996000,610501,61.3,553177,55.5,57324,9.4
4673,August 1983,New York,13558000,8080773,59.6,7390869,54.5,689904,8.5
4674,August 1983,North Carolina,4495000,2960610,65.9,2703511,60.1,257099,8.7
4675,August 1983,North Dakota,488000,320335,65.6,303116,62.1,17219,5.4
4676,August 1983,Ohio,8030000,5102508,63.5,4495460,56.0,607048,11.9
4677,August 1983,Oklahoma,2427000,1551776,63.9,1422606,58.6,129170,8.3
4678,August 1983,Oregon,2008000,1332353,66.4,1190358,59.3,141995,10.7
4679,August 1983,Pennsylvania,9181000,5490159,59.8,4880861,53.2,609298,11.1
4680,August 1983,Rhode Island,736000,478306,65.0,439991,59.8,38315,8.0
4681,August 1983,South Carolina,2345000,1481802,63.2,1346651,57.4,135151,9.1
4682,August 1983,South Dakota,504000,334988,66.5,318380,63.2,16608,5.0
4683,August 1983,Tennessee,3508000,2192681,62.5,1945288,55.5,247393,11.3
4684,August 1983,Texas,11328000,7684526,67.8,7082471,62.5,602055,7.8
4685,August 1983,Utah,1051000,689748,65.6,631344,60.1,58404,8.5
4686,August 1983,Vermont,392000,264345,67.4,248275,63.3,16070,6.1
4687,August 1983,Virginia,4089000,2735602,66.9,2569801,62.8,165801,6.1
4688,August 1983,Washington,3190000,2065344,64.7,1839735,57.7,225609,10.9
4689,August 1983,West Virginia,1472000,767684,52.2,632680,43.0,135004,17.6
4690,August 1983,Wisconsin,3540000,2415714,68.2,2180270,61.6,235444,9.7
4691,August 1983,Wyoming,364000,257843,70.8,238189,65.4,19654,7.6
4692,September 1983,Alabama,2916000,1770630,60.7,1537640,52.7,232990,13.2
4693,September 1983,Alaska,325000,235411,72.4,212343,65.3,23068,9.8
4694,September 1983,Arizona,2206000,1398261,63.4,1292727,58.6,105534,7.5
4695,September 1983,Arkansas,1721000,1034896,60.1,935105,54.3,99791,9.6
4696,September 1983,California,18792000,12338962,65.7,11210014,59.7,1128948,9.1
4697,September 1983,Colorado,2326000,1680008,72.2,1574097,67.7,105911,6.3
4698,September 1983,Connecticut,2435000,1626512,66.8,1537364,63.1,89148,5.5
4699,September 1983,Delaware,457000,297677,65.1,275155,60.2,22522,7.6
4700,September 1983,District of Columbia,483000,318118,65.9,282232,58.4,35886,11.3
4701,September 1983,Florida,8449000,5008601,59.3,4608320,54.5,400281,8.0
4702,September 1983,Georgia,4164000,2709872,65.1,2507725,60.2,202147,7.5
4703,September 1983,Hawaii,711000,474061,66.7,445870,62.7,28191,5.9
4704,September 1983,Idaho,692000,456908,66.0,418075,60.4,38833,8.5
4705,September 1983,Illinois,8584000,5604274,65.3,4989517,58.1,614757,11.0
4706,September 1983,Indiana,4058000,2599759,64.1,2320651,57.2,279108,10.7
4707,September 1983,Iowa,2160000,1427216,66.1,1319125,61.1,108091,7.6
4708,September 1983,Kansas,1787000,1187931,66.5,1123563,62.9,64368,5.4
4709,September 1983,Kentucky,2724000,1706376,62.6,1516539,55.7,189837,11.1
4710,September 1983,Louisiana,3173000,1927959,60.8,1710733,53.9,217226,11.3
4711,September 1983,Maine,856000,539733,63.1,496698,58.0,43035,8.0
4712,September 1983,Maryland,3253000,2210256,67.9,2065869,63.5,144387,6.5
4713,September 1983,Massachusetts,4479000,3013543,67.3,2820908,63.0,192635,6.4
4714,September 1983,Michigan,6714000,4302409,64.1,3725615,55.5,576794,13.4
4715,September 1983,Minnesota,3089000,2177871,70.5,2014150,65.2,163721,7.5
4716,September 1983,Mississippi,1828000,1059952,58.0,937754,51.3,122198,11.5
4717,September 1983,Missouri,3734000,2373984,63.6,2150064,57.6,223920,9.4
4718,September 1983,Montana,598000,399219,66.8,365052,61.0,34167,8.6
4719,September 1983,Nebraska,1175000,785558,66.9,745671,63.5,39887,5.1
4720,September 1983,Nevada,674000,486412,72.2,443015,65.7,43397,8.9
4721,September 1983,New Hampshire,724000,502377,69.4,477603,66.0,24774,4.9
4722,September 1983,New Jersey,5793000,3727732,64.3,3445738,59.5,281994,7.6
4723,September 1983,New Mexico,997000,610821,61.3,554948,55.7,55873,9.1
4724,September 1983,New York,13565000,8084502,59.6,7412353,54.6,672149,8.3
4725,September 1983,North Carolina,4502000,2968916,65.9,2720080,60.4,248836,8.4
4726,September 1983,North Dakota,488000,320840,65.7,303874,62.3,16966,5.3
4727,September 1983,Ohio,8030000,5098442,63.5,4513153,56.2,585289,11.5
4728,September 1983,Oklahoma,2427000,1553154,64.0,1426904,58.8,126250,8.1
4729,September 1983,Oregon,2009000,1329849,66.2,1189098,59.2,140751,10.6
4730,September 1983,Pennsylvania,9182000,5489585,59.8,4898415,53.3,591170,10.8
4731,September 1983,Rhode Island,736000,478523,65.0,441673,60.0,36850,7.7
4732,September 1983,South Carolina,2348000,1483051,63.2,1352733,57.6,130318,8.8
4733,September 1983,South Dakota,505000,335649,66.5,319403,63.2,16246,4.8
4734,September 1983,Tennessee,3511000,2199154,62.6,1958634,55.8,240520,10.9
4735,September 1983,Texas,11347000,7694426,67.8,7106089,62.6,588337,7.6
4736,September 1983,Utah,1051000,690966,65.7,634859,60.4,56107,8.1
4737,September 1983,Vermont,393000,264525,67.3,248842,63.3,15683,5.9
4738,September 1983,Virginia,4096000,2742486,67.0,2581689,63.0,160797,5.9
4739,September 1983,Washington,3193000,2069654,64.8,1847109,57.8,222545,10.8
4740,September 1983,West Virginia,1471000,767575,52.2,635028,43.2,132547,17.3
4741,September 1983,Wisconsin,3541000,2417544,68.3,2188076,61.8,229468,9.5
4742,September 1983,Wyoming,364000,257467,70.7,238853,65.6,18614,7.2
4743,October 1983,Alabama,2918000,1770977,60.7,1543879,52.9,227098,12.8
4744,October 1983,Alaska,326000,236312,72.5,212893,65.3,23419,9.9
4745,October 1983,Arizona,2213000,1401248,63.3,1303358,58.9,97890,7.0
4746,October 1983,Arkansas,1722000,1038727,60.3,940052,54.6,98675,9.5
4747,October 1983,California,18831000,12354670,65.6,11256541,59.8,1098129,8.9
4748,October 1983,Colorado,2329000,1684607,72.3,1583321,68.0,101286,6.0
4749,October 1983,Connecticut,2437000,1629496,66.9,1542786,63.3,86710,5.3
4750,October 1983,Delaware,458000,298804,65.2,276645,60.4,22159,7.4
4751,October 1983,District of Columbia,483000,317798,65.8,282169,58.4,35629,11.2
4752,October 1983,Florida,8471000,5027166,59.3,4640444,54.8,386722,7.7
4753,October 1983,Georgia,4172000,2714055,65.1,2517653,60.3,196402,7.2
4754,October 1983,Hawaii,712000,474046,66.6,446200,62.7,27846,5.9
4755,October 1983,Idaho,693000,458131,66.1,420313,60.7,37818,8.3
4756,October 1983,Illinois,8587000,5597655,65.2,5004881,58.3,592774,10.6
4757,October 1983,Indiana,4060000,2603147,64.1,2331035,57.4,272112,10.5
4758,October 1983,Iowa,2160000,1426356,66.0,1320953,61.2,105403,7.4
4759,October 1983,Kansas,1788000,1187769,66.4,1124300,62.9,63469,5.3
4760,October 1983,Kentucky,2725000,1706109,62.6,1522525,55.9,183584,10.8
4761,October 1983,Louisiana,3174000,1927558,60.7,1718332,54.1,209226,10.9
4762,October 1983,Maine,857000,540480,63.1,498755,58.2,41725,7.7
4763,October 1983,Maryland,3257000,2213549,68.0,2073984,63.7,139565,6.3
4764,October 1983,Massachusetts,4483000,3019157,67.3,2830725,63.1,188432,6.2
4765,October 1983,Michigan,6716000,4295595,64.0,3738932,55.7,556663,13.0
4766,October 1983,Minnesota,3090000,2179168,70.5,2019135,65.3,160033,7.3
4767,October 1983,Mississippi,1829000,1056389,57.8,937595,51.3,118794,11.2
4768,October 1983,Missouri,3737000,2377682,63.6,2160352,57.8,217330,9.1
4769,October 1983,Montana,598000,399468,66.8,365765,61.2,33703,8.4
4770,October 1983,Nebraska,1176000,785279,66.8,746067,63.4,39212,5.0
4771,October 1983,Nevada,676000,487071,72.1,444991,65.8,42080,8.6
4772,October 1983,New Hampshire,725000,504187,69.5,479998,66.2,24189,4.8
4773,October 1983,New Jersey,5797000,3739051,64.5,3465864,59.8,273187,7.3
4774,October 1983,New Mexico,999000,611046,61.2,556735,55.7,54311,8.9
4775,October 1983,New York,13572000,8078782,59.5,7425886,54.7,652896,8.1
4776,October 1983,North Carolina,4509000,2973935,66.0,2734592,60.6,239343,8.0
4777,October 1983,North Dakota,488000,321351,65.9,304569,62.4,16782,5.2
4778,October 1983,Ohio,8031000,5090556,63.4,4527151,56.4,563405,11.1
4779,October 1983,Oklahoma,2427000,1553049,64.0,1430029,58.9,123020,7.9
4780,October 1983,Oregon,2011000,1327215,66.0,1188672,59.1,138543,10.4
4781,October 1983,Pennsylvania,9184000,5485769,59.7,4912018,53.5,573751,10.5
4782,October 1983,Rhode Island,737000,478743,65.0,443459,60.2,35284,7.4
4783,October 1983,South Carolina,2351000,1484522,63.1,1358504,57.8,126018,8.5
4784,October 1983,South Dakota,505000,336197,66.6,320289,63.4,15908,4.7
4785,October 1983,Tennessee,3514000,2202381,62.7,1970167,56.1,232214,10.5
4786,October 1983,Texas,11366000,7695977,67.7,7124533,62.7,571444,7.4
4787,October 1983,Utah,1050000,691994,65.9,638015,60.8,53979,7.8
4788,October 1983,Vermont,393000,264747,67.4,249358,63.4,15389,5.8
4789,October 1983,Virginia,4102000,2747448,67.0,2592060,63.2,155388,5.7
4790,October 1983,Washington,3197000,2071678,64.8,1852757,58.0,218921,10.6
4791,October 1983,West Virginia,1471000,766752,52.1,637205,43.3,129547,16.9
4792,October 1983,Wisconsin,3543000,2416512,68.2,2194401,61.9,222111,9.2
4793,October 1983,Wyoming,364000,257263,70.7,239384,65.8,17879,6.9
4794,November 1983,Alabama,2921000,1770548,60.6,1549445,53.0,221103,12.5
4795,November 1983,Alaska,328000,237223,72.3,213451,65.1,23772,10.0
4796,November 1983,Arizona,2219000,1403535,63.3,1312542,59.2,90993,6.5
4797,November 1983,Arkansas,1724000,1042446,60.5,945177,54.8,97269,9.3
4798,November 1983,California,18869000,12370076,65.6,11298898,59.9,1071178,8.7
4799,November 1983,Colorado,2332000,1688556,72.4,1591133,68.2,97423,5.8
4800,November 1983,Connecticut,2439000,1632223,66.9,1547744,63.5,84479,5.2
4801,November 1983,Delaware,458000,299844,65.5,278200,60.7,21644,7.2
4802,November 1983,District of Columbia,483000,317389,65.7,282202,58.4,35187,11.1
4803,November 1983,Florida,8493000,5039641,59.3,4666724,54.9,372917,7.4
4804,November 1983,Georgia,4180000,2716048,65.0,2526436,60.4,189612,7.0
4805,November 1983,Hawaii,713000,473654,66.4,446142,62.6,27512,5.8
4806,November 1983,Idaho,694000,459010,66.1,422437,60.9,36573,8.0
4807,November 1983,Illinois,8591000,5591246,65.1,5016965,58.4,574281,10.3
4808,November 1983,Indiana,4062000,2603826,64.1,2339828,57.6,263998,10.1
4809,November 1983,Iowa,2160000,1423915,65.9,1321094,61.2,102821,7.2
4810,November 1983,Kansas,1789000,1187458,66.4,1124847,62.9,62611,5.3
4811,November 1983,Kentucky,2726000,1705424,62.6,1528108,56.1,177316,10.4
4812,November 1983,Louisiana,3175000,1925477,60.6,1724323,54.3,201154,10.4
4813,November 1983,Maine,858000,541249,63.1,500824,58.4,40425,7.5
4814,November 1983,Maryland,3260000,2214914,67.9,2080479,63.8,134435,6.1
4815,November 1983,Massachusetts,4486000,3022719,67.4,2838914,63.3,183805,6.1
4816,November 1983,Michigan,6719000,4289109,63.8,3750784,55.8,538325,12.6
4817,November 1983,Minnesota,3092000,2181306,70.5,2024359,65.5,156947,7.2
4818,November 1983,Mississippi,1830000,1053405,57.6,937422,51.2,115983,11.0
4819,November 1983,Missouri,3739000,2380480,63.7,2169106,58.0,211374,8.9
4820,November 1983,Montana,599000,399469,66.7,366356,61.2,33113,8.3
4821,November 1983,Nebraska,1176000,785180,66.8,746544,63.5,38636,4.9
4822,November 1983,Nevada,678000,487951,72.0,447095,65.9,40856,8.4
4823,November 1983,New Hampshire,727000,505957,69.6,482413,66.4,23544,4.7
4824,November 1983,New Jersey,5802000,3748490,64.6,3483849,60.0,264641,7.1
4825,November 1983,New Mexico,1000000,611497,61.1,558778,55.9,52719,8.6
4826,November 1983,New York,13579000,8067726,59.4,7433476,54.7,634250,7.9
4827,November 1983,North Carolina,4516000,2976909,65.9,2747800,60.8,229109,7.7
4828,November 1983,North Dakota,489000,321835,65.8,305233,62.4,16602,5.2
4829,November 1983,Ohio,8032000,5081358,63.3,4537774,56.5,543584,10.7
4830,November 1983,Oklahoma,2426000,1552119,64.0,1432364,59.0,119755,7.7
4831,November 1983,Oregon,2013000,1325116,65.8,1189575,59.1,135541,10.2
4832,November 1983,Pennsylvania,9185000,5480148,59.7,4922353,53.6,557795,10.2
4833,November 1983,Rhode Island,737000,479145,65.0,445369,60.4,33776,7.0
4834,November 1983,South Carolina,2354000,1485925,63.1,1364055,57.9,121870,8.2
4835,November 1983,South Dakota,505000,336645,66.7,321082,63.6,15563,4.6
4836,November 1983,Tennessee,3517000,2203024,62.6,1979604,56.3,223420,10.1
4837,November 1983,Texas,11385000,7692297,67.6,7139315,62.7,552982,7.2
4838,November 1983,Utah,1050000,692797,66.0,640708,61.0,52089,7.5
4839,November 1983,Vermont,393000,265046,67.4,249854,63.6,15192,5.7
4840,November 1983,Virginia,4108000,2751534,67.0,2601729,63.3,149805,5.4
4841,November 1983,Washington,3201000,2071483,64.7,1856634,58.0,214849,10.4
4842,November 1983,West Virginia,1471000,765467,52.0,639246,43.5,126221,16.5
4843,November 1983,Wisconsin,3544000,2412883,68.1,2199485,62.1,213398,8.8
4844,November 1983,Wyoming,363000,256972,70.8,239646,66.0,17326,6.7
4845,December 1983,Alabama,2923000,1770630,60.6,1554955,53.2,215675,12.2
4846,December 1983,Alaska,329000,238218,72.4,214128,65.1,24090,10.1
4847,December 1983,Arizona,2226000,1405824,63.2,1320468,59.3,85356,6.1
4848,December 1983,Arkansas,1725000,1045712,60.6,949870,55.1,95842,9.2
4849,December 1983,California,18908000,12390658,65.5,11340747,60.0,1049911,8.5
4850,December 1983,Colorado,2335000,1692143,72.5,1597834,68.4,94309,5.6
4851,December 1983,Connecticut,2440000,1635203,67.0,1552661,63.6,82542,5.0
4852,December 1983,Delaware,459000,300781,65.5,279799,61.0,20982,7.0
4853,December 1983,District of Columbia,483000,316943,65.6,282434,58.5,34509,10.9
4854,December 1983,Florida,8514000,5050684,59.3,4690064,55.1,360620,7.1
4855,December 1983,Georgia,4187000,2717726,64.9,2534982,60.5,182744,6.7
4856,December 1983,Hawaii,714000,473238,66.3,446004,62.5,27234,5.8
4857,December 1983,Idaho,695000,459609,66.1,424265,61.0,35344,7.7
4858,December 1983,Illinois,8594000,5588584,65.0,5028028,58.5,560556,10.0
4859,December 1983,Indiana,4064000,2604679,64.1,2348636,57.8,256043,9.8
4860,December 1983,Iowa,2160000,1420944,65.8,1320307,61.1,100637,7.1
4861,December 1983,Kansas,1790000,1187735,66.4,1125825,62.9,61910,5.2
4862,December 1983,Kentucky,2726000,1705624,62.6,1533194,56.2,172430,10.1
4863,December 1983,Louisiana,3177000,1923918,60.6,1729452,54.4,194466,10.1
4864,December 1983,Maine,859000,542173,63.1,502990,58.6,39183,7.2
4865,December 1983,Maryland,3264000,2215318,67.9,2085621,63.9,129697,5.9
4866,December 1983,Massachusetts,4490000,3025251,67.4,2846466,63.4,178785,5.9
4867,December 1983,Michigan,6722000,4287170,63.8,3763449,56.0,523721,12.2
4868,December 1983,Minnesota,3094000,2184663,70.6,2030190,65.6,154473,7.1
4869,December 1983,Mississippi,1831000,1052182,57.5,938296,51.2,113886,10.8
4870,December 1983,Missouri,3742000,2382938,63.7,2176781,58.2,206157,8.7
4871,December 1983,Montana,599000,399415,66.7,366941,61.3,32474,8.1
4872,December 1983,Nebraska,1177000,785255,66.7,747161,63.5,38094,4.9
4873,December 1983,Nevada,679000,489057,72.0,449259,66.2,39798,8.1
4874,December 1983,New Hampshire,728000,507699,69.7,484843,66.6,22856,4.5
4875,December 1983,New Jersey,5807000,3759241,64.7,3501387,60.3,257854,6.9
4876,December 1983,New Mexico,1002000,612416,61.1,561180,56.0,51236,8.4
4877,December 1983,New York,13586000,8057585,59.3,7439623,54.8,617962,7.7
4878,December 1983,North Carolina,4523000,2980326,65.9,2761284,61.0,219042,7.3
4879,December 1983,North Dakota,489000,322363,65.9,305922,62.6,16441,5.1
4880,December 1983,Ohio,8032000,5074636,63.2,4546696,56.6,527940,10.4
4881,December 1983,Oklahoma,2426000,1551352,63.9,1434509,59.1,116843,7.5
4882,December 1983,Oregon,2014000,1324326,65.8,1191923,59.2,132403,10.0
4883,December 1983,Pennsylvania,9187000,5475329,59.6,4931102,53.7,544227,9.9
4884,December 1983,Rhode Island,738000,479814,65.0,447365,60.6,32449,6.8
4885,December 1983,South Carolina,2357000,1487170,63.1,1369412,58.1,117758,7.9
4886,December 1983,South Dakota,506000,337085,66.6,321867,63.6,15218,4.5
4887,December 1983,Tennessee,3520000,2202763,62.6,1987569,56.5,215194,9.8
4888,December 1983,Texas,11404000,7688988,67.4,7153561,62.7,535427,7.0
4889,December 1983,Utah,1050000,693532,66.1,643078,61.2,50454,7.3
4890,December 1983,Vermont,394000,265428,67.4,250376,63.5,15052,5.7
4891,December 1983,Virginia,4114000,2756905,67.0,2611981,63.5,144924,5.3
4892,December 1983,Washington,3204000,2070142,64.6,1859260,58.0,210882,10.2
4893,December 1983,West Virginia,1470000,764297,52.0,641272,43.6,123025,16.1
4894,December 1983,Wisconsin,3546000,2408473,67.9,2203892,62.2,204581,8.5
4895,December 1983,Wyoming,363000,256491,70.7,239616,66.0,16875,6.6
4896,January 1984,Alabama,2925000,1771946,60.6,1561134,53.4,210812,11.9
4897,January 1984,Alaska,330000,239323,72.5,214983,65.1,24340,10.2
4898,January 1984,Arizona,2232000,1408788,63.1,1327887,59.5,80901,5.7
4899,January 1984,Arkansas,1726000,1048350,60.7,953758,55.3,94592,9.0
4900,January 1984,California,18946000,12419719,65.6,11387443,60.1,1032276,8.3
4901,January 1984,Colorado,2338000,1696023,72.5,1604104,68.6,91919,5.4
4902,January 1984,Connecticut,2442000,1638879,67.1,1558075,63.8,80804,4.9
4903,January 1984,Delaware,459000,301673,65.7,281412,61.3,20261,6.7
4904,January 1984,District of Columbia,483000,316629,65.6,283042,58.6,33587,10.6
4905,January 1984,Florida,8536000,5064473,59.3,4714506,55.2,349967,6.9
4906,January 1984,Georgia,4195000,2720990,64.9,2544726,60.7,176264,6.5
4907,January 1984,Hawaii,714000,473143,66.3,446102,62.5,27041,5.7
4908,January 1984,Idaho,695000,460044,66.2,425694,61.3,34350,7.5
4909,January 1984,Illinois,8597000,5590739,65.0,5041504,58.6,549235,9.8
4910,January 1984,Indiana,4066000,2607658,64.1,2359294,58.0,248364,9.5
4911,January 1984,Iowa,2161000,1418703,65.7,1319554,61.1,99149,7.0
4912,January 1984,Kansas,1791000,1189135,66.4,1127846,63.0,61289,5.2
4913,January 1984,Kentucky,2727000,1706834,62.6,1537796,56.4,169038,9.9
4914,January 1984,Louisiana,3178000,1924655,60.6,1734897,54.6,189758,9.9
4915,January 1984,Maine,860000,543335,63.2,505345,58.8,37990,7.0
4916,January 1984,Maryland,3267000,2215898,67.8,2090166,64.0,125732,5.7
4917,January 1984,Massachusetts,4493000,3027792,67.4,2854744,63.5,173048,5.7
4918,January 1984,Michigan,6725000,4292047,63.8,3779300,56.2,512747,11.9
4919,January 1984,Minnesota,3096000,2188766,70.7,2036704,65.8,152062,6.9
4920,January 1984,Mississippi,1832000,1053376,57.5,941095,51.4,112281,10.7
4921,January 1984,Missouri,3744000,2385344,63.7,2184650,58.4,200694,8.4
4922,January 1984,Montana,599000,399519,66.7,367658,61.4,31861,8.0
4923,January 1984,Nebraska,1177000,785457,66.7,747980,63.5,37477,4.8
4924,January 1984,Nevada,681000,490402,72.0,451453,66.3,38949,7.9
4925,January 1984,New Hampshire,729000,509443,69.9,487201,66.8,22242,4.4
4926,January 1984,New Jersey,5812000,3773106,64.9,3520535,60.6,252571,6.7
4927,January 1984,New Mexico,1003000,613828,61.2,563966,56.2,49862,8.1
4928,January 1984,New York,13593000,8053218,59.2,7449882,54.8,603336,7.5
4929,January 1984,North Carolina,4530000,2986564,65.9,2776641,61.3,209923,7.0
4930,January 1984,North Dakota,489000,323019,66.1,306668,62.7,16351,5.1
4931,January 1984,Ohio,8033000,5072272,63.1,4556396,56.7,515876,10.2
4932,January 1984,Oklahoma,2426000,1551462,64.0,1437304,59.2,114158,7.4
4933,January 1984,Oregon,2016000,1325042,65.7,1195347,59.3,129695,9.8
4934,January 1984,Pennsylvania,9188000,5472857,59.6,4940346,53.8,532511,9.7
4935,January 1984,Rhode Island,738000,480748,65.1,449422,60.9,31326,6.5
4936,January 1984,South Carolina,2360000,1488167,63.1,1374763,58.3,113404,7.6
4937,January 1984,South Dakota,506000,337694,66.7,322773,63.8,14921,4.4
4938,January 1984,Tennessee,3523000,2203240,62.5,1995540,56.6,207700,9.4
4939,January 1984,Texas,11423000,7689359,67.3,7170636,62.8,518723,6.7
4940,January 1984,Utah,1050000,694387,66.1,645382,61.5,49005,7.1
4941,January 1984,Vermont,394000,265896,67.5,250977,63.7,14919,5.6
4942,January 1984,Virginia,4121000,2765305,67.1,2623993,63.7,141312,5.1
4943,January 1984,Washington,3208000,2068592,64.5,1861593,58.0,206999,10.0
4944,January 1984,West Virginia,1470000,763741,52.0,643516,43.8,120225,15.7
4945,January 1984,Wisconsin,3547000,2404947,67.8,2208299,62.3,196648,8.2
4946,January 1984,Wyoming,363000,255841,70.5,239329,65.9,16512,6.5
4947,February 1984,Alabama,2928000,1774737,60.6,1568105,53.6,206632,11.6
4948,February 1984,Alaska,331000,240541,72.7,216035,65.3,24506,10.2
4949,February 1984,Arizona,2239000,1412596,63.1,1335279,59.6,77317,5.5
4950,February 1984,Arkansas,1728000,1050173,60.8,956525,55.4,93648,8.9
4951,February 1984,California,18985000,12457252,65.6,11440834,60.3,1016418,8.2
4952,February 1984,Colorado,2342000,1700759,72.6,1610440,68.8,90319,5.3
4953,February 1984,Connecticut,2444000,1643172,67.2,1564084,64.0,79088,4.8
4954,February 1984,Delaware,460000,302608,65.8,282958,61.5,19650,6.5
4955,February 1984,District of Columbia,483000,316568,65.5,284099,58.8,32469,10.3
4956,February 1984,Florida,8558000,5082280,59.4,4741478,55.4,340802,6.7
4957,February 1984,Georgia,4203000,2727005,64.9,2556241,60.8,170764,6.3
4958,February 1984,Hawaii,715000,473417,66.2,446501,62.4,26916,5.7
4959,February 1984,Idaho,696000,460398,66.1,426729,61.3,33669,7.3
4960,February 1984,Illinois,8601000,5596241,65.1,5058549,58.8,537692,9.6
4961,February 1984,Indiana,4069000,2612839,64.2,2371959,58.3,240880,9.2
4962,February 1984,Iowa,2161000,1417859,65.6,1319450,61.1,98409,6.9
4963,February 1984,Kansas,1793000,1191635,66.5,1131052,63.1,60583,5.1
4964,February 1984,Kentucky,2728000,1708852,62.6,1541953,56.5,166899,9.8
4965,February 1984,Louisiana,3179000,1928348,60.7,1741203,54.8,187145,9.7
4966,February 1984,Maine,861000,544746,63.3,507864,59.0,36882,6.8
4967,February 1984,Maryland,3271000,2217803,67.8,2094975,64.0,122828,5.5
4968,February 1984,Massachusetts,4497000,3030734,67.4,2864145,63.7,166589,5.5
4969,February 1984,Michigan,6728000,4303510,64.0,3798557,56.5,504953,11.7
4970,February 1984,Minnesota,3098000,2192840,70.8,2043477,66.0,149363,6.8
4971,February 1984,Mississippi,1834000,1056784,57.6,945732,51.6,111052,10.5
4972,February 1984,Missouri,3747000,2387107,63.7,2193144,58.5,193963,8.1
4973,February 1984,Montana,600000,399890,66.6,368520,61.4,31370,7.8
4974,February 1984,Nebraska,1178000,785821,66.7,749066,63.6,36755,4.7
4975,February 1984,Nevada,683000,491958,72.0,453583,66.4,38375,7.8
4976,February 1984,New Hampshire,731000,511250,69.9,489427,67.0,21823,4.3
4977,February 1984,New Jersey,5816000,3789079,65.1,3541083,60.9,247996,6.5
4978,February 1984,New Mexico,1005000,615480,61.2,566895,56.4,48585,7.9
4979,February 1984,New York,13601000,8056637,59.2,7466024,54.9,590613,7.3
4980,February 1984,North Carolina,4538000,2996211,66.0,2793476,61.6,202735,6.8
4981,February 1984,North Dakota,489000,323817,66.2,307442,62.9,16375,5.1
4982,February 1984,Ohio,8034000,5074202,63.2,4567838,56.9,506364,10.0
4983,February 1984,Oklahoma,2426000,1552567,64.0,1440867,59.4,111700,7.2
4984,February 1984,Oregon,2018000,1326921,65.8,1199176,59.4,127745,9.6
4985,February 1984,Pennsylvania,9190000,5473219,59.6,4950932,53.9,522287,9.5
4986,February 1984,Rhode Island,739000,481855,65.2,451505,61.1,30350,6.3
4987,February 1984,South Carolina,2363000,1489335,63.0,1380330,58.4,109005,7.3
4988,February 1984,South Dakota,506000,338570,66.9,323859,64.0,14711,4.3
4989,February 1984,Tennessee,3526000,2205592,62.6,2004272,56.8,201320,9.1
4990,February 1984,Texas,11443000,7693879,67.2,7191301,62.8,502578,6.5
4991,February 1984,Utah,1049000,695504,66.3,647801,61.8,47703,6.9
4992,February 1984,Vermont,394000,266421,67.6,251650,63.9,14771,5.5
4993,February 1984,Virginia,4127000,2776674,67.3,2637383,63.9,139291,5.0
4994,February 1984,Washington,3212000,2067359,64.4,1864242,58.0,203117,9.8
4995,February 1984,West Virginia,1470000,763877,52.0,646002,43.9,117875,15.4
4996,February 1984,Wisconsin,3549000,2403012,67.7,2212748,62.3,190264,7.9
4997,February 1984,Wyoming,363000,255121,70.3,238939,65.8,16182,6.3
4998,March 1984,Alabama,2930000,1779010,60.7,1575469,53.8,203541,11.4
4999,March 1984,Alaska,332000,241846,72.8,217288,65.4,24558,10.2
5000,March 1984,Arizona,2245000,1416927,63.1,1342498,59.8,74429,5.3
5001,March 1984,Arkansas,1729000,1051023,60.8,957997,55.4,93026,8.9
5002,March 1984,California,19024000,12501958,65.7,11498762,60.4,1003196,8.0
5003,March 1984,Colorado,2345000,1706458,72.8,1616774,68.9,89684,5.3
5004,March 1984,Connecticut,2445000,1647932,67.4,1570377,64.2,77555,4.7
5005,March 1984,Delaware,461000,303637,65.9,284356,61.7,19281,6.4
5006,March 1984,District of Columbia,483000,316904,65.6,285637,59.1,31267,9.9
5007,March 1984,Florida,8579000,5103312,59.5,4769522,55.6,333790,6.5
5008,March 1984,Georgia,4210000,2736093,65.0,2569095,61.0,166998,6.1
5009,March 1984,Hawaii,716000,473803,66.2,447009,62.4,26794,5.7
5010,March 1984,Idaho,697000,460799,66.1,427515,61.3,33284,7.2
5011,March 1984,Illinois,8604000,5603039,65.1,5077329,59.0,525710,9.4
5012,March 1984,Indiana,4071000,2619220,64.3,2385472,58.6,233748,8.9
5013,March 1984,Iowa,2161000,1418194,65.6,1320185,61.1,98009,6.9
5014,March 1984,Kansas,1794000,1195055,66.6,1135116,63.3,59939,5.0
5015,March 1984,Kentucky,2728000,1711450,62.7,1545631,56.7,165819,9.7
5016,March 1984,Louisiana,3181000,1934742,60.8,1748169,55.0,186573,9.6
5017,March 1984,Maine,862000,546275,63.4,510354,59.2,35921,6.6
5018,March 1984,Maryland,3275000,2222118,67.9,2100773,64.1,121345,5.5
5019,March 1984,Massachusetts,4501000,3034187,67.4,2874179,63.9,160008,5.3
5020,March 1984,Michigan,6731000,4319658,64.2,3819547,56.7,500111,11.6
5021,March 1984,Minnesota,3100000,2196576,70.9,2049973,66.1,146603,6.7
5022,March 1984,Mississippi,1835000,1061915,57.9,951386,51.8,110529,10.4
5023,March 1984,Missouri,3749000,2387850,63.7,2201498,58.7,186352,7.8
5024,March 1984,Montana,600000,400539,66.8,369472,61.6,31067,7.8
5025,March 1984,Nebraska,1179000,786504,66.7,750493,63.7,36011,4.6
5026,March 1984,Nevada,684000,493688,72.2,455564,66.6,38124,7.7
5027,March 1984,New Hampshire,732000,513191,70.1,491535,67.1,21656,4.2
5028,March 1984,New Jersey,5821000,3804926,65.4,3560711,61.2,244215,6.4
5029,March 1984,New Mexico,1007000,617126,61.3,569669,56.6,47457,7.7
5030,March 1984,New York,13608000,8068225,59.3,7486063,55.0,582162,7.2
5031,March 1984,North Carolina,4545000,3008567,66.2,2809866,61.8,198701,6.6
5032,March 1984,North Dakota,489000,324722,66.4,308203,63.0,16519,5.1
5033,March 1984,Ohio,8034000,5080095,63.2,4580839,57.0,499256,9.8
5034,March 1984,Oklahoma,2426000,1554601,64.1,1444719,59.6,109882,7.1
5035,March 1984,Oregon,2019000,1329291,65.8,1202844,59.6,126447,9.5
5036,March 1984,Pennsylvania,9192000,5477084,59.6,4962874,54.0,514210,9.4
5037,March 1984,Rhode Island,740000,482995,65.3,453586,61.3,29409,6.1
5038,March 1984,South Carolina,2366000,1491495,63.0,1386194,58.6,105301,7.1
5039,March 1984,South Dakota,507000,339638,67.0,325042,64.1,14596,4.3
5040,March 1984,Tennessee,3529000,2210414,62.6,2013448,57.1,196966,8.9
5041,March 1984,Texas,11462000,7701838,67.2,7213604,62.9,488234,6.3
5042,March 1984,Utah,1049000,697039,66.4,650448,62.0,46591,6.7
5043,March 1984,Vermont,395000,266886,67.6,252333,63.9,14553,5.5
5044,March 1984,Virginia,4133000,2789627,67.5,2650680,64.1,138947,5.0
5045,March 1984,Washington,3215000,2066636,64.3,1867202,58.1,199434,9.7
5046,March 1984,West Virginia,1469000,764389,52.0,648489,44.1,115900,15.2
5047,March 1984,Wisconsin,3550000,2402320,67.7,2216779,62.4,185541,7.7
5048,March 1984,Wyoming,363000,254524,70.1,238643,65.7,15881,6.2
5049,April 1984,Alabama,2933000,1784188,60.8,1582577,54.0,201611,11.3
5050,April 1984,Alaska,333000,243119,73.0,218631,65.7,24488,10.1
5051,April 1984,Arizona,2252000,1421156,63.1,1349121,59.9,72035,5.1
5052,April 1984,Arkansas,1731000,1050667,60.7,958160,55.4,92507,8.8
5053,April 1984,California,19062000,12548798,65.8,11556539,60.6,992259,7.9
5054,April 1984,Colorado,2348000,1712367,72.9,1622497,69.1,89870,5.2
5055,April 1984,Connecticut,2447000,1652876,67.5,1576455,64.4,76421,4.6
5056,April 1984,Delaware,461000,304754,66.1,285577,61.9,19177,6.3
5057,April 1984,District of Columbia,483000,317658,65.8,287523,59.5,30135,9.5
5058,April 1984,Florida,8601000,5124734,59.6,4795757,55.8,328977,6.4
5059,April 1984,Georgia,4218000,2747041,65.1,2582062,61.2,164979,6.0
5060,April 1984,Hawaii,717000,474005,66.1,447363,62.4,26642,5.6
5061,April 1984,Idaho,698000,461310,66.1,428149,61.3,33161,7.2
5062,April 1984,Illinois,8608000,5607121,65.1,5094128,59.2,512993,9.1
5063,April 1984,Indiana,4073000,2624805,64.4,2397868,58.9,226937,8.6
5064,April 1984,Iowa,2161000,1418987,65.7,1321374,61.1,97613,6.9
5065,April 1984,Kansas,1795000,1198802,66.8,1139349,63.5,59453,5.0
5066,April 1984,Kentucky,2729000,1713388,62.8,1548410,56.7,164978,9.6
5067,April 1984,Louisiana,3182000,1942246,61.0,1754846,55.1,187400,9.6
5068,April 1984,Maine,863000,547660,63.5,512474,59.4,35186,6.4
5069,April 1984,Maryland,3278000,2228478,68.0,2107359,64.3,121119,5.4
5070,April 1984,Massachusetts,4504000,3037500,67.4,2883837,64.0,153663,5.1
5071,April 1984,Michigan,6733000,4335572,64.4,3839480,57.0,496092,11.4
5072,April 1984,Minnesota,3101000,2199591,70.9,2055830,66.3,143761,6.5
5073,April 1984,Mississippi,1836000,1067760,58.2,956975,52.1,110785,10.4
5074,April 1984,Missouri,3752000,2387059,63.6,2208445,58.9,178614,7.5
5075,April 1984,Montana,601000,401361,66.8,370404,61.6,30957,7.7
5076,April 1984,Nebraska,1179000,787578,66.8,752238,63.8,35340,4.5
5077,April 1984,Nevada,686000,495525,72.2,457319,66.7,38206,7.7
5078,April 1984,New Hampshire,734000,515291,70.2,493556,67.2,21735,4.2
5079,April 1984,New Jersey,5826000,3817563,65.5,3576534,61.4,241029,6.3
5080,April 1984,New Mexico,1008000,618834,61.4,572185,56.8,46649,7.5
5081,April 1984,New York,13615000,8084388,59.4,7505941,55.1,578447,7.2
5082,April 1984,North Carolina,4552000,3021168,66.4,2823475,62.0,197693,6.5
5083,April 1984,North Dakota,489000,325653,66.6,308909,63.2,16744,5.1
5084,April 1984,Ohio,8035000,5087375,63.3,4594302,57.2,493073,9.7
5085,April 1984,Oklahoma,2426000,1557200,64.2,1448225,59.7,108975,7.0
5086,April 1984,Oregon,2021000,1331315,65.9,1205851,59.7,125464,9.4
5087,April 1984,Pennsylvania,9193000,5482993,59.6,4974977,54.1,508016,9.3
5088,April 1984,Rhode Island,740000,484023,65.4,455612,61.6,28411,5.9
5089,April 1984,South Carolina,2369000,1494804,63.1,1392124,58.8,102680,6.9
5090,April 1984,South Dakota,507000,340723,67.2,326150,64.3,14573,4.3
5091,April 1984,Tennessee,3532000,2216465,62.8,2022159,57.3,194306,8.8
5092,April 1984,Texas,11481000,7709908,67.2,7234031,63.0,475877,6.2
5093,April 1984,Utah,1049000,698967,66.6,653310,62.3,45657,6.5
5094,April 1984,Vermont,395000,267214,67.6,252972,64.0,14242,5.3
5095,April 1984,Virginia,4139000,2801778,67.7,2662247,64.3,139531,5.0
5096,April 1984,Washington,3219000,2065973,64.2,1870018,58.1,195955,9.5
5097,April 1984,West Virginia,1469000,764720,52.1,650675,44.3,114045,14.9
5098,April 1984,Wisconsin,3552000,2401821,67.6,2219840,62.5,181981,7.6
5099,April 1984,Wyoming,363000,254131,70.0,238507,65.7,15624,6.1
5100,May 1984,Alabama,2935000,1789401,61.0,1588818,54.1,200583,11.2
5101,May 1984,Alaska,335000,244288,72.9,219947,65.7,24341,10.0
5102,May 1984,Arizona,2258000,1425187,63.1,1355046,60.0,70141,4.9
5103,May 1984,Arkansas,1732000,1049070,60.6,957144,55.3,91926,8.8
5104,May 1984,California,19101000,12594746,65.9,11610302,60.8,984444,7.8
5105,May 1984,Colorado,2351000,1717658,73.1,1626959,69.2,90699,5.3
5106,May 1984,Connecticut,2449000,1657751,67.7,1581974,64.6,75777,4.6
5107,May 1984,Delaware,462000,305924,66.2,286657,62.0,19267,6.3
5108,May 1984,District of Columbia,483000,318772,66.0,289538,59.9,29234,9.2
5109,May 1984,Florida,8623000,5144839,59.7,4818463,55.9,326376,6.3
5110,May 1984,Georgia,4226000,2758656,65.3,2593936,61.4,164720,6.0
5111,May 1984,Hawaii,718000,473860,66.0,447357,62.3,26503,5.6
5112,May 1984,Idaho,699000,461988,66.1,428715,61.3,33273,7.2
5113,May 1984,Illinois,8611000,5608292,65.1,5106724,59.3,501568,8.9
5114,May 1984,Indiana,4075000,2628588,64.5,2407432,59.1,221156,8.4
5115,May 1984,Iowa,2162000,1419686,65.7,1322332,61.2,97354,6.9
5116,May 1984,Kansas,1796000,1202191,66.9,1143103,63.6,59088,4.9
5117,May 1984,Kentucky,2730000,1713779,62.8,1549983,56.8,163796,9.6
5118,May 1984,Louisiana,3183000,1949364,61.2,1760028,55.3,189336,9.7
5119,May 1984,Maine,864000,548664,63.5,513994,59.5,34670,6.3
5120,May 1984,Maryland,3282000,2235580,68.1,2113929,64.4,121651,5.4
5121,May 1984,Massachusetts,4508000,3040175,67.4,2892256,64.2,147919,4.9
5122,May 1984,Michigan,6736000,4348084,64.5,3856119,57.2,491965,11.3
5123,May 1984,Minnesota,3103000,2201683,71.0,2060800,66.4,140883,6.4
5124,May 1984,Mississippi,1837000,1073398,58.4,961649,52.3,111749,10.4
5125,May 1984,Missouri,3754000,2385116,63.5,2213621,59.0,171495,7.2
5126,May 1984,Montana,601000,402140,66.9,371185,61.8,30955,7.7
5127,May 1984,Nebraska,1180000,789110,66.9,754203,63.9,34907,4.4
5128,May 1984,Nevada,688000,497413,72.3,458840,66.7,38573,7.8
5129,May 1984,New Hampshire,735000,517472,70.4,495467,67.4,22005,4.3
5130,May 1984,New Jersey,5831000,3825609,65.6,3586819,61.5,238790,6.2
5131,May 1984,New Mexico,1010000,620766,61.5,574400,56.9,46366,7.5
5132,May 1984,New York,13622000,8102352,59.5,7522726,55.2,579626,7.2
5133,May 1984,North Carolina,4559000,3032157,66.5,2832817,62.1,199340,6.6
5134,May 1984,North Dakota,490000,326519,66.6,309511,63.2,17008,5.2
5135,May 1984,Ohio,8036000,5094297,63.4,4606939,57.3,487358,9.6
5136,May 1984,Oklahoma,2425000,1559856,64.3,1450903,59.8,108953,7.0
5137,May 1984,Oregon,2023000,1332542,65.9,1207887,59.7,124655,9.4
5138,May 1984,Pennsylvania,9195000,5489309,59.7,4985942,54.2,503367,9.2
5139,May 1984,Rhode Island,741000,484928,65.4,457574,61.8,27354,5.6
5140,May 1984,South Carolina,2372000,1499105,63.2,1397651,58.9,101454,6.8
5141,May 1984,South Dakota,507000,341655,67.4,327014,64.5,14641,4.3
5142,May 1984,Tennessee,3535000,2222857,62.9,2029862,57.4,192995,8.7
5143,May 1984,Texas,11500000,7840905,68.2,7374389,64.1,466516,5.9
5144,May 1984,Utah,1049000,701168,66.8,656218,62.6,44950,6.4
5145,May 1984,Vermont,395000,267446,67.7,253570,64.2,13876,5.2
5146,May 1984,Virginia,4146000,2811941,67.8,2671438,64.4,140503,5.0
5147,May 1984,Washington,3223000,2065133,64.1,1872280,58.1,192853,9.3
5148,May 1984,West Virginia,1469000,764751,52.1,652377,44.4,112374,14.7
5149,May 1984,Wisconsin,3553000,2400960,67.6,2221568,62.5,179392,7.5
5150,May 1984,Wyoming,362000,253960,70.2,238494,65.9,15466,6.1
5151,June 1984,Alabama,2938000,1793401,61.0,1593815,54.2,199586,11.1
5152,June 1984,Alaska,336000,245379,73.0,221185,65.8,24194,9.9
5153,June 1984,Arizona,2265000,1428973,63.1,1360150,60.1,68823,4.8
5154,June 1984,Arkansas,1734000,1046454,60.3,955170,55.1,91284,8.7
5155,June 1984,California,19139000,12636924,66.0,11657727,60.9,979197,7.7
5156,June 1984,Colorado,2354000,1721634,73.1,1629608,69.2,92026,5.3
5157,June 1984,Connecticut,2450000,1662241,67.8,1586674,64.8,75567,4.5
5158,June 1984,Delaware,462000,307086,66.5,287648,62.3,19438,6.3
5159,June 1984,District of Columbia,483000,320211,66.3,291581,60.4,28630,8.9
5160,June 1984,Florida,8644000,5162203,59.7,4836803,56.0,325400,6.3
5161,June 1984,Georgia,4233000,2769466,65.4,2603849,61.5,165617,6.0
5162,June 1984,Hawaii,719000,473384,65.8,446965,62.2,26419,5.6
5163,June 1984,Idaho,700000,462764,66.1,429230,61.3,33534,7.2
5164,June 1984,Illinois,8615000,5607841,65.1,5114630,59.4,493211,8.8
5165,June 1984,Indiana,4077000,2630311,64.5,2413364,59.2,216947,8.2
5166,June 1984,Iowa,2162000,1419610,65.7,1322412,61.2,97198,6.8
5167,June 1984,Kansas,1797000,1204752,67.0,1145946,63.8,58806,4.9
5168,June 1984,Kentucky,2730000,1712200,62.7,1550354,56.8,161846,9.5
5169,June 1984,Louisiana,3185000,1955095,61.4,1763000,55.4,192095,9.8
5170,June 1984,Maine,865000,549130,63.5,514869,59.5,34261,6.2
5171,June 1984,Maryland,3285000,2242099,68.3,2119906,64.5,122193,5.4
5172,June 1984,Massachusetts,4511000,3041740,67.4,2898730,64.3,143010,4.7
5173,June 1984,Michigan,6739000,4355457,64.6,3867772,57.4,487685,11.2
5174,June 1984,Minnesota,3105000,2202870,70.9,2064921,66.5,137949,6.3
5175,June 1984,Mississippi,1838000,1078213,58.7,964999,52.5,113214,10.5
5176,June 1984,Missouri,3757000,2382582,63.4,2217079,59.0,165503,6.9
5177,June 1984,Montana,602000,402728,66.9,371796,61.8,30932,7.7
5178,June 1984,Nebraska,1180000,791084,67.0,756292,64.1,34792,4.4
5179,June 1984,Nevada,689000,499262,72.5,460170,66.8,39092,7.8
5180,June 1984,New Hampshire,737000,519648,70.5,497302,67.5,22346,4.3
5181,June 1984,New Jersey,5835000,3828544,65.6,3591237,61.5,237307,6.2
5182,June 1984,New Mexico,1011000,623008,61.6,576356,57.0,46652,7.5
5183,June 1984,New York,13629000,8118126,59.6,7534320,55.3,583806,7.2
5184,June 1984,North Carolina,4566000,3040050,66.6,2837463,62.1,202587,6.7
5185,June 1984,North Dakota,490000,327244,66.8,309975,63.3,17269,5.3
5186,June 1984,Ohio,8036000,5099647,63.5,4617839,57.5,481808,9.4
5187,June 1984,Oklahoma,2425000,1562003,64.4,1452488,59.9,109515,7.0
5188,June 1984,Oregon,2024000,1332764,65.8,1208796,59.7,123968,9.3
5189,June 1984,Pennsylvania,9196000,5495439,59.8,4995432,54.3,500007,9.1
5190,June 1984,Rhode Island,741000,485913,65.6,459572,62.0,26341,5.4
5191,June 1984,South Carolina,2375000,1504011,63.3,1402441,59.1,101570,6.8
5192,June 1984,South Dakota,508000,342391,67.4,327610,64.5,14781,4.3
5193,June 1984,Tennessee,3538000,2228545,63.0,2036209,57.6,192336,8.6
5194,June 1984,Texas,11519000,7883665,68.4,7422787,64.4,460878,5.8
5195,June 1984,Utah,1048000,703496,67.1,658949,62.9,44547,6.3
5196,June 1984,Vermont,396000,267692,67.6,254195,64.2,13497,5.0
5197,June 1984,Virginia,4152000,2819891,67.9,2678318,64.5,141573,5.0
5198,June 1984,Washington,3226000,2063849,64.0,1873680,58.1,190169,9.2
5199,June 1984,West Virginia,1468000,764530,52.1,653474,44.5,111056,14.5
5200,June 1984,Wisconsin,3555000,2398897,67.5,2221701,62.5,177196,7.4
5201,June 1984,Wyoming,362000,253998,70.2,238536,65.9,15462,6.1
5202,July 1984,Alabama,2940000,1795398,61.1,1597406,54.3,197992,11.0
5203,July 1984,Alaska,337000,246408,73.1,222323,66.0,24085,9.8
5204,July 1984,Arizona,2271000,1432586,63.1,1364186,60.1,68400,4.8
5205,July 1984,Arkansas,1735000,1043079,60.1,952533,54.9,90546,8.7
5206,July 1984,California,19178000,12672525,66.1,11698235,61.0,974290,7.7
5207,July 1984,Colorado,2357000,1723818,73.1,1630318,69.2,93500,5.4
5208,July 1984,Connecticut,2452000,1666073,67.9,1590385,64.9,75688,4.5
5209,July 1984,Delaware,463000,308164,66.6,288598,62.3,19566,6.3
5210,July 1984,District of Columbia,483000,321878,66.6,293591,60.8,28287,8.8
5211,July 1984,Florida,8666000,5175887,59.7,4850814,56.0,325073,6.3
5212,July 1984,Georgia,4241000,2778279,65.5,2611497,61.6,166782,6.0
5213,July 1984,Hawaii,720000,472718,65.7,446284,62.0,26434,5.6
5214,July 1984,Idaho,701000,463466,66.1,429637,61.3,33829,7.3
5215,July 1984,Illinois,8618000,5606449,65.1,5118074,59.4,488375,8.7
5216,July 1984,Indiana,4079000,2630850,64.5,2416129,59.2,214721,8.2
5217,July 1984,Iowa,2162000,1418322,65.6,1321140,61.1,97182,6.9
5218,July 1984,Kansas,1798000,1206283,67.1,1147821,63.8,58462,4.8
5219,July 1984,Kentucky,2731000,1708606,62.6,1549678,56.7,158928,9.3
5220,July 1984,Louisiana,3186000,1958754,61.5,1763556,55.4,195198,10.0
5221,July 1984,Maine,866000,549048,63.4,515228,59.5,33820,6.2
5222,July 1984,Maryland,3289000,2247050,68.3,2124992,64.6,122058,5.4
5223,July 1984,Massachusetts,4515000,3041800,67.4,2902853,64.3,138947,4.6
5224,July 1984,Michigan,6742000,4356703,64.6,3873481,57.5,483222,11.1
5225,July 1984,Minnesota,3107000,2203574,70.9,2068507,66.6,135067,6.1
5226,July 1984,Mississippi,1839000,1081885,58.8,967199,52.6,114686,10.6
5227,July 1984,Missouri,3759000,2380088,63.3,2219053,59.0,161035,6.8
5228,July 1984,Montana,602000,402995,66.9,372259,61.8,30736,7.6
5229,July 1984,Nebraska,1181000,793188,67.2,758371,64.2,34817,4.4
5230,July 1984,Nevada,691000,500977,72.5,461348,66.8,39629,7.9
5231,July 1984,New Hampshire,738000,521829,70.7,499189,67.6,22640,4.3
5232,July 1984,New Jersey,5840000,3826454,65.5,3590616,61.5,235838,6.2
5233,July 1984,New Mexico,1013000,625528,61.8,578090,57.1,47438,7.6
5234,July 1984,New York,13636000,8127075,59.6,7540016,55.3,587059,7.2
5235,July 1984,North Carolina,4573000,3043742,66.6,2837927,62.1,205815,6.8
5236,July 1984,North Dakota,490000,327760,66.9,310285,63.3,17475,5.3
5237,July 1984,Ohio,8037000,5102872,63.5,4626707,57.6,476165,9.3
5238,July 1984,Oklahoma,2425000,1563079,64.5,1453044,59.9,110035,7.0
5239,July 1984,Oregon,2026000,1332031,65.7,1208504,59.6,123527,9.3
5240,July 1984,Pennsylvania,9198000,5500711,59.8,5003594,54.4,497117,9.0
5241,July 1984,Rhode Island,742000,487168,65.7,461688,62.2,25480,5.2
5242,July 1984,South Carolina,2378000,1508695,63.4,1406332,59.1,102363,6.8
5243,July 1984,South Dakota,508000,342944,67.5,328005,64.6,14939,4.4
5244,July 1984,Tennessee,3541000,2232099,63.0,2041041,57.6,191058,8.6
5245,July 1984,Texas,11538000,7898829,68.5,7439916,64.5,458913,5.8
5246,July 1984,Utah,1048000,705752,67.3,661331,63.1,44421,6.3
5247,July 1984,Vermont,396000,268068,67.7,254909,64.4,13159,4.9
5248,July 1984,Virginia,4158000,2825913,68.0,2683290,64.5,142623,5.0
5249,July 1984,Washington,3230000,2061984,63.8,1874110,58.0,187874,9.1
5250,July 1984,West Virginia,1468000,764196,52.1,653944,44.5,110252,14.4
5251,July 1984,Wisconsin,3556000,2394849,67.3,2220308,62.4,174541,7.3
5252,July 1984,Wyoming,362000,254139,70.2,238546,65.9,15593,6.1
5253,August 1984,Alabama,2943000,1795727,61.0,1599986,54.4,195741,10.9
5254,August 1984,Alaska,338000,247363,73.2,223374,66.1,23989,9.7
5255,August 1984,Arizona,2278000,1436576,63.1,1367166,60.0,69410,4.8
5256,August 1984,Arkansas,1736000,1039440,59.9,949742,54.7,89698,8.6
5257,August 1984,California,19219000,12703451,66.1,11734076,61.1,969375,7.6
5258,August 1984,Colorado,2360000,1724187,73.1,1629445,69.0,94742,5.5
5259,August 1984,Connecticut,2454000,1669511,68.0,1593376,64.9,76135,4.6
5260,August 1984,Delaware,464000,309120,66.6,289545,62.4,19575,6.3
5261,August 1984,District of Columbia,483000,323625,67.0,295512,61.2,28113,8.7
5262,August 1984,Florida,8687000,5187732,59.7,4862686,56.0,325046,6.3
5263,August 1984,Georgia,4252000,2785444,65.5,2617570,61.6,167874,6.0
5264,August 1984,Hawaii,721000,472144,65.5,445503,61.8,26641,5.6
5265,August 1984,Idaho,701000,463982,66.2,429926,61.3,34056,7.3
5266,August 1984,Illinois,8619000,5607211,65.1,5119214,59.4,487997,8.7
5267,August 1984,Indiana,4080000,2632155,64.5,2417495,59.3,214660,8.2
5268,August 1984,Iowa,2161000,1416074,65.5,1318589,61.0,97485,6.9
5269,August 1984,Kansas,1797000,1207198,67.2,1149109,63.9,58089,4.8
5270,August 1984,Kentucky,2732000,1703653,62.4,1548378,56.7,155275,9.1
5271,August 1984,Louisiana,3187000,1960829,61.5,1762274,55.3,198555,10.1
5272,August 1984,Maine,867000,548624,63.3,515376,59.4,33248,6.1
5273,August 1984,Maryland,3293000,2250416,68.3,2129370,64.7,121046,5.4
5274,August 1984,Massachusetts,4517000,3040770,67.3,2905144,64.3,135626,4.5
5275,August 1984,Michigan,6746000,4354157,64.5,3874926,57.4,479231,11.0
5276,August 1984,Minnesota,3108000,2204644,70.9,2071827,66.7,132817,6.0
5277,August 1984,Mississippi,1842000,1084641,58.9,968919,52.6,115722,10.7
5278,August 1984,Missouri,3760000,2379336,63.3,2220824,59.1,158512,6.7
5279,August 1984,Montana,602000,402970,66.9,372610,61.9,30360,7.5
5280,August 1984,Nebraska,1180000,795095,67.4,760284,64.4,34811,4.4
5281,August 1984,Nevada,694000,502528,72.4,462434,66.6,40094,8.0
5282,August 1984,New Hampshire,740000,524002,70.8,501191,67.7,22811,4.4
5283,August 1984,New Jersey,5842000,3820967,65.4,3587338,61.4,233629,6.1
5284,August 1984,New Mexico,1014000,628202,62.0,579632,57.2,48570,7.7
5285,August 1984,New York,13640000,8129770,59.6,7542633,55.3,587137,7.2
5286,August 1984,North Carolina,4582000,3044370,66.4,2836259,61.9,208111,6.8
5287,August 1984,North Dakota,490000,328074,67.0,310469,63.4,17605,5.4
5288,August 1984,Ohio,8040000,5105135,63.5,4633877,57.6,471258,9.2
5289,August 1984,Oklahoma,2423000,1563193,64.5,1453060,60.0,110133,7.0
5290,August 1984,Oregon,2026000,1330413,65.7,1207165,59.6,123248,9.3
5291,August 1984,Pennsylvania,9198000,5504648,59.8,5011143,54.5,493505,9.0
5292,August 1984,Rhode Island,743000,488781,65.8,463900,62.4,24881,5.1
5293,August 1984,South Carolina,2383000,1512580,63.5,1409454,59.1,103126,6.8
5294,August 1984,South Dakota,508000,343351,67.6,328286,64.6,15065,4.4
5295,August 1984,Tennessee,3546000,2233590,63.0,2045009,57.7,188581,8.4
5296,August 1984,Texas,11557000,7907255,68.4,7446145,64.4,461110,5.8
5297,August 1984,Utah,1049000,707870,67.5,663403,63.2,44467,6.3
5298,August 1984,Vermont,397000,268655,67.7,255744,64.4,12911,4.8
5299,August 1984,Virginia,4163000,2830963,68.0,2687234,64.6,143729,5.1
5300,August 1984,Washington,3232000,2060381,63.7,1874314,58.0,186067,9.0
5301,August 1984,West Virginia,1468000,764067,52.0,654013,44.6,110054,14.4
5302,August 1984,Wisconsin,3557000,2389279,67.2,2217987,62.4,171292,7.2
5303,August 1984,Wyoming,362000,254211,70.2,238446,65.9,15765,6.2
5304,September 1984,Alabama,2945000,1795000,61.0,1602247,54.4,192753,10.7
5305,September 1984,Alaska,338000,248211,73.4,224332,66.4,23879,9.6
5306,September 1984,Arizona,2286000,1441199,63.0,1369373,59.9,71826,5.0
5307,September 1984,Arkansas,1737000,1036098,59.6,947119,54.5,88979,8.6
5308,September 1984,California,19261000,12732809,66.1,11768088,61.1,964721,7.6
5309,September 1984,Colorado,2362000,1723211,73.0,1627493,68.9,95718,5.6
5310,September 1984,Connecticut,2455000,1673012,68.1,1596107,65.0,76905,4.6
5311,September 1984,Delaware,465000,309932,66.7,290472,62.5,19460,6.3
5312,September 1984,District of Columbia,483000,325221,67.3,297207,61.5,28014,8.6
5313,September 1984,Florida,8709000,5200303,59.7,4875136,56.0,325167,6.3
5314,September 1984,Georgia,4263000,2792145,65.5,2623055,61.5,169090,6.1
5315,September 1984,Hawaii,722000,471965,65.4,444946,61.6,27019,5.7
5316,September 1984,Idaho,701000,464279,66.2,430078,61.4,34201,7.4
5317,September 1984,Illinois,8621000,5612325,65.1,5120651,59.4,491674,8.8
5318,September 1984,Indiana,4081000,2635829,64.6,2419195,59.3,216634,8.2
5319,September 1984,Iowa,2160000,1413640,65.4,1315232,60.9,98408,7.0
5320,September 1984,Kansas,1797000,1208252,67.2,1150332,64.0,57920,4.8
5321,September 1984,Kentucky,2734000,1698468,62.1,1546788,56.6,151680,8.9
5322,September 1984,Louisiana,3188000,1962332,61.6,1760020,55.2,202312,10.3
5323,September 1984,Maine,868000,548209,63.2,515600,59.4,32609,5.9
5324,September 1984,Maryland,3298000,2252956,68.3,2133366,64.7,119590,5.3
5325,September 1984,Massachusetts,4518000,3039445,67.3,2906549,64.3,132896,4.4
5326,September 1984,Michigan,6751000,4351117,64.5,3875112,57.4,476005,10.9
5327,September 1984,Minnesota,3109000,2206465,71.0,2074983,66.7,131482,6.0
5328,September 1984,Mississippi,1844000,1086872,58.9,970813,52.6,116059,10.7
5329,September 1984,Missouri,3762000,2381486,63.3,2223642,59.1,157844,6.6
5330,September 1984,Montana,602000,402771,66.9,372833,61.9,29938,7.4
5331,September 1984,Nebraska,1179000,796723,67.6,761849,64.6,34874,4.4
5332,September 1984,Nevada,697000,503907,72.3,463500,66.5,40407,8.0
5333,September 1984,New Hampshire,741000,526069,71.0,503200,67.9,22869,4.3
5334,September 1984,New Jersey,5844000,3814521,65.3,3584100,61.3,230421,6.0
5335,September 1984,New Mexico,1015000,630846,62.2,581005,57.2,49841,7.9
5336,September 1984,New York,13645000,8129062,59.6,7545795,55.3,583267,7.2
5337,September 1984,North Carolina,4591000,3044148,66.3,2834949,61.8,209199,6.9
5338,September 1984,North Dakota,489000,328282,67.1,310593,63.5,17689,5.4
5339,September 1984,Ohio,8044000,5107317,63.5,4639313,57.7,468004,9.2
5340,September 1984,Oklahoma,2421000,1563009,64.6,1452899,60.0,110110,7.0
5341,September 1984,Oregon,2026000,1328062,65.6,1204869,59.5,123193,9.3
5342,September 1984,Pennsylvania,9198000,5507262,59.9,5018423,54.6,488839,8.9
5343,September 1984,Rhode Island,743000,490635,66.0,466051,62.7,24584,5.0
5344,September 1984,South Carolina,2387000,1515386,63.5,1411934,59.2,103452,6.8
5345,September 1984,South Dakota,508000,343676,67.7,328489,64.7,15187,4.4
5346,September 1984,Tennessee,3551000,2234248,62.9,2048828,57.7,185420,8.3
5347,September 1984,Texas,11576000,7917375,68.4,7449495,64.4,467880,5.9
5348,September 1984,Utah,1051000,709953,67.6,665304,63.3,44649,6.3
5349,September 1984,Vermont,397000,269489,67.9,256696,64.7,12793,4.7
5350,September 1984,Virginia,4167000,2835695,68.1,2690655,64.6,145040,5.1
5351,September 1984,Washington,3234000,2060164,63.7,1875201,58.0,184963,9.0
5352,September 1984,West Virginia,1467000,764441,52.1,653995,44.6,110446,14.4
5353,September 1984,Wisconsin,3559000,2383496,67.0,2215413,62.2,168083,7.1
5354,September 1984,Wyoming,361000,254092,70.4,238170,66.0,15922,6.3
5355,October 1984,Alabama,2948000,1794208,60.9,1604931,54.4,189277,10.5
5356,October 1984,Alaska,339000,248952,73.4,225181,66.4,23771,9.5
5357,October 1984,Arizona,2293000,1446550,63.1,1371478,59.8,75072,5.2
5358,October 1984,Arkansas,1738000,1033683,59.5,945106,54.4,88577,8.6
5359,October 1984,California,19302000,12763771,66.1,11804290,61.2,959481,7.5
5360,October 1984,Colorado,2365000,1721986,72.8,1625342,68.7,96644,5.6
5361,October 1984,Connecticut,2457000,1677183,68.3,1599164,65.1,78019,4.7
5362,October 1984,Delaware,465000,310593,66.8,291345,62.7,19248,6.2
5363,October 1984,District of Columbia,483000,326489,67.6,298567,61.8,27922,8.6
5364,October 1984,Florida,8730000,5216132,59.7,4891078,56.0,325054,6.2
5365,October 1984,Georgia,4273000,2799717,65.5,2629236,61.5,170481,6.1
5366,October 1984,Hawaii,723000,472238,65.3,444896,61.5,27342,5.8
5367,October 1984,Idaho,701000,464424,66.3,430125,61.4,34299,7.4
5368,October 1984,Illinois,8622000,5621908,65.2,5125314,59.4,496594,8.8
5369,October 1984,Indiana,4082000,2642991,64.7,2423168,59.4,219823,8.3
5370,October 1984,Iowa,2159000,1411867,65.4,1311897,60.8,99970,7.1
5371,October 1984,Kansas,1796000,1210333,67.4,1152130,64.1,58203,4.8
5372,October 1984,Kentucky,2735000,1694353,62.0,1545524,56.5,148829,8.8
5373,October 1984,Louisiana,3189000,1964481,61.6,1758018,55.1,206463,10.5
5374,October 1984,Maine,868000,548145,63.2,516121,59.5,32024,5.8
5375,October 1984,Maryland,3302000,2255358,68.3,2137426,64.7,117932,5.2
5376,October 1984,Massachusetts,4520000,3038871,67.2,2908351,64.3,130520,4.3
5377,October 1984,Michigan,6755000,4349701,64.4,3877075,57.4,472626,10.9
5378,October 1984,Minnesota,3110000,2208906,71.0,2078100,66.8,130806,5.9
5379,October 1984,Mississippi,1847000,1089186,59.0,973460,52.7,115726,10.6
5380,October 1984,Missouri,3763000,2387171,63.4,2228705,59.2,158466,6.6
5381,October 1984,Montana,602000,402484,66.9,372871,61.9,29613,7.4
5382,October 1984,Nebraska,1178000,798107,67.8,762950,64.8,35157,4.4
5383,October 1984,Nevada,699000,505210,72.3,464667,66.5,40543,8.0
5384,October 1984,New Hampshire,743000,527938,71.1,505081,68.0,22857,4.3
5385,October 1984,New Jersey,5846000,3809938,65.2,3583565,61.3,226373,5.9
5386,October 1984,New Mexico,1016000,633347,62.3,582326,57.3,51021,8.1
5387,October 1984,New York,13649000,8128824,59.6,7553219,55.3,575605,7.1
5388,October 1984,North Carolina,4599000,3045306,66.2,2836545,61.7,208761,6.9
5389,October 1984,North Dakota,489000,328519,67.2,310722,63.5,17797,5.4
5390,October 1984,Ohio,8047000,5109657,63.5,4643855,57.7,465802,9.1
5391,October 1984,Oklahoma,2419000,1563451,64.6,1452984,60.1,110467,7.1
5392,October 1984,Oregon,2025000,1325443,65.5,1201905,59.4,123538,9.3
5393,October 1984,Pennsylvania,9198000,5509387,59.9,5026363,54.6,483024,8.8
5394,October 1984,Rhode Island,744000,492520,66.2,467972,62.9,24548,5.0
5395,October 1984,South Carolina,2392000,1517216,63.4,1414146,59.1,103070,6.8
5396,October 1984,South Dakota,507000,343985,67.8,328632,64.8,15353,4.5
5397,October 1984,Tennessee,3556000,2235504,62.9,2053389,57.7,182115,8.1
5398,October 1984,Texas,11595000,7932600,68.4,7454260,64.3,478340,6.0
5399,October 1984,Utah,1052000,712095,67.7,667179,63.4,44916,6.3
5400,October 1984,Vermont,398000,270520,68.0,257708,64.8,12812,4.7
5401,October 1984,Virginia,4172000,2841002,68.1,2694319,64.6,146683,5.2
5402,October 1984,Washington,3236000,2062065,63.7,1877439,58.0,184626,9.0
5403,October 1984,West Virginia,1467000,765300,52.2,654208,44.6,111092,14.5
5404,October 1984,Wisconsin,3560000,2379003,66.8,2213294,62.2,165709,7.0
5405,October 1984,Wyoming,361000,253751,70.3,237710,65.8,16041,6.3
5406,November 1984,Alabama,2950000,1794284,60.8,1608665,54.5,185619,10.3
5407,November 1984,Alaska,339000,249619,73.6,225916,66.6,23703,9.5
5408,November 1984,Arizona,2300000,1452761,63.2,1374268,59.8,78493,5.4
5409,November 1984,Arkansas,1739000,1032822,59.4,944358,54.3,88464,8.6
5410,November 1984,California,19344000,12799067,66.2,11845937,61.2,953130,7.4
5411,November 1984,Colorado,2367000,1721564,72.7,1623963,68.6,97601,5.7
5412,November 1984,Connecticut,2458000,1682501,68.5,1603097,65.2,79404,4.7
5413,November 1984,Delaware,466000,311132,66.8,292146,62.7,18986,6.1
5414,November 1984,District of Columbia,483000,327296,67.8,299478,62.0,27818,8.5
5415,November 1984,Florida,8751000,5237341,59.8,4912691,56.1,324650,6.2
5416,November 1984,Georgia,4284000,2809371,65.6,2637283,61.6,172088,6.1
5417,November 1984,Hawaii,724000,472856,65.3,445473,61.5,27383,5.8
5418,November 1984,Idaho,700000,464612,66.4,430170,61.5,34442,7.4
5419,November 1984,Illinois,8623000,5635515,65.4,5135571,59.6,499944,8.9
5420,November 1984,Indiana,4083000,2653662,65.0,2431079,59.5,222583,8.4
5421,November 1984,Iowa,2157000,1411444,65.4,1309527,60.7,101917,7.2
5422,November 1984,Kansas,1795000,1213868,67.6,1154988,64.3,58880,4.9
5423,November 1984,Kentucky,2736000,1692044,61.8,1545182,56.5,146862,8.7
5424,November 1984,Louisiana,3190000,1968139,61.7,1757478,55.1,210661,10.7
5425,November 1984,Maine,869000,548699,63.1,517049,59.5,31650,5.8
5426,November 1984,Maryland,3307000,2258156,68.3,2142055,64.8,116101,5.1
5427,November 1984,Massachusetts,4521000,3039946,67.2,2911813,64.4,128133,4.2
5428,November 1984,Michigan,6760000,4351284,64.4,3883026,57.4,468258,10.8
5429,November 1984,Minnesota,3111000,2211738,71.1,2081142,66.9,130596,5.9
5430,November 1984,Mississippi,1849000,1092346,59.1,977290,52.9,115056,10.5
5431,November 1984,Missouri,3764000,2396710,63.7,2237003,59.4,159707,6.7
5432,November 1984,Montana,603000,402231,66.7,372743,61.8,29488,7.3
5433,November 1984,Nebraska,1177000,799365,67.9,763685,64.9,35680,4.5
5434,November 1984,Nevada,702000,506627,72.2,466050,66.4,40577,8.0
5435,November 1984,New Hampshire,745000,529582,71.1,506761,68.0,22821,4.3
5436,November 1984,New Jersey,5848000,3809800,65.1,3587572,61.3,222228,5.8
5437,November 1984,New Mexico,1017000,635669,62.5,583751,57.4,51918,8.2
5438,November 1984,New York,13653000,8133760,59.6,7567724,55.4,566036,7.0
5439,November 1984,North Carolina,4608000,3049448,66.2,2843184,61.7,206264,6.8
5440,November 1984,North Dakota,489000,328908,67.3,310918,63.6,17990,5.5
5441,November 1984,Ohio,8051000,5112655,63.5,4649289,57.7,463366,9.1
5442,November 1984,Oklahoma,2417000,1564901,64.7,1453707,60.1,111194,7.1
5443,November 1984,Oregon,2025000,1323044,65.3,1198921,59.2,124123,9.4
5444,November 1984,Pennsylvania,9198000,5512564,59.9,5036661,54.8,475903,8.6
5445,November 1984,Rhode Island,744000,494237,66.4,469550,63.1,24687,5.0
5446,November 1984,South Carolina,2396000,1518527,63.4,1416707,59.1,101820,6.7
5447,November 1984,South Dakota,507000,344305,67.9,328720,64.8,15585,4.5
5448,November 1984,Tennessee,3561000,2238624,62.9,2059513,57.8,179111,8.0
5449,November 1984,Texas,11614000,7953218,68.5,7462918,64.3,490300,6.2
5450,November 1984,Utah,1053000,714392,67.8,669183,63.6,45209,6.3
5451,November 1984,Vermont,398000,271646,68.3,258708,65.0,12938,4.8
5452,November 1984,Virginia,4176000,2847614,68.2,2699032,64.6,148582,5.2
5453,November 1984,Washington,3238000,2066270,63.8,1881683,58.1,184587,8.9
5454,November 1984,West Virginia,1466000,766360,52.3,654867,44.7,111493,14.5
5455,November 1984,Wisconsin,3562000,2376927,66.7,2212154,62.1,164773,6.9
5456,November 1984,Wyoming,360000,253187,70.3,237115,65.9,16072,6.3
5457,December 1984,Alabama,2953000,1795580,60.8,1613496,54.6,182084,10.1
5458,December 1984,Alaska,340000,250199,73.6,226511,66.6,23688,9.5
5459,December 1984,Arizona,2307000,1459471,63.3,1377782,59.7,81689,5.6
5460,December 1984,Arkansas,1740000,1033611,59.4,945099,54.3,88512,8.6
5461,December 1984,California,19385000,12837779,66.2,11891523,61.3,946256,7.4
5462,December 1984,Colorado,2370000,1722093,72.7,1623632,68.5,98461,5.7
5463,December 1984,Connecticut,2460000,1688760,68.6,1607838,65.4,80922,4.8
5464,December 1984,Delaware,467000,311596,66.7,292882,62.7,18714,6.0
5465,December 1984,District of Columbia,483000,327533,67.8,299813,62.1,27720,8.5
5466,December 1984,Florida,8773000,5262687,60.0,4938703,56.3,323984,6.2
5467,December 1984,Georgia,4295000,2821397,65.7,2647059,61.6,174338,6.2
5468,December 1984,Hawaii,725000,473609,65.3,446563,61.6,27046,5.7
5469,December 1984,Idaho,700000,464983,66.4,430283,61.5,34700,7.5
5470,December 1984,Illinois,8624000,5650959,65.5,5149963,59.7,500996,8.9
5471,December 1984,Indiana,4084000,2666638,65.3,2442769,59.8,223869,8.4
5472,December 1984,Iowa,2156000,1412306,65.5,1308513,60.7,103793,7.3
5473,December 1984,Kansas,1795000,1218464,67.9,1158749,64.6,59715,4.9
5474,December 1984,Kentucky,2737000,1691594,61.8,1545723,56.5,145871,8.6
5475,December 1984,Louisiana,3191000,1972937,61.8,1758565,55.1,214372,10.9
5476,December 1984,Maine,870000,549830,63.2,518298,59.6,31532,5.7
5477,December 1984,Maryland,3311000,2261420,68.3,2147295,64.9,114125,5.0
5478,December 1984,Massachusetts,4523000,3042721,67.3,2916951,64.5,125770,4.1
5479,December 1984,Michigan,6764000,4355283,64.4,3892628,57.5,462655,10.6
5480,December 1984,Minnesota,3112000,2214567,71.2,2083935,67.0,130632,5.9
5481,December 1984,Mississippi,1852000,1096674,59.2,982206,53.0,114468,10.4
5482,December 1984,Missouri,3766000,2409121,64.0,2247884,59.7,161237,6.7
5483,December 1984,Montana,603000,402162,66.7,372541,61.8,29621,7.4
5484,December 1984,Nebraska,1176000,800672,68.1,764238,65.0,36434,4.6
5485,December 1984,Nevada,705000,508270,72.1,467666,66.3,40604,8.0
5486,December 1984,New Hampshire,746000,531060,71.2,508321,68.1,22739,4.3
5487,December 1984,New Jersey,5850000,3814255,65.2,3595367,61.5,218888,5.7
5488,December 1984,New Mexico,1018000,637832,62.7,585328,57.5,52504,8.2
5489,December 1984,New York,13657000,8145936,59.6,7588255,55.6,557681,6.8
5490,December 1984,North Carolina,4617000,3056772,66.2,2854949,61.8,201823,6.6
5491,December 1984,North Dakota,488000,329459,67.5,311223,63.8,18236,5.5
5492,December 1984,Ohio,8054000,5116617,63.5,4656456,57.8,460161,9.0
5493,December 1984,Oklahoma,2415000,1566958,64.9,1454917,60.2,112041,7.2
5494,December 1984,Oregon,2025000,1321063,65.2,1196574,59.1,124489,9.4
5495,December 1984,Pennsylvania,9198000,5517682,60.0,5049454,54.9,468228,8.5
5496,December 1984,Rhode Island,745000,495631,66.5,470757,63.2,24874,5.0
5497,December 1984,South Carolina,2401000,1520004,63.3,1419971,59.1,100033,6.6
5498,December 1984,South Dakota,507000,344614,68.0,328760,64.8,15854,4.6
5499,December 1984,Tennessee,3566000,2243909,62.9,2066698,58.0,177211,7.9
5500,December 1984,Texas,11633000,7976672,68.6,7474652,64.3,502020,6.3
5501,December 1984,Utah,1054000,716818,68.0,671378,63.7,45440,6.3
5502,December 1984,Vermont,399000,272750,68.4,259647,65.1,13103,4.8
5503,December 1984,Virginia,4181000,2854864,68.3,2704426,64.7,150438,5.3
5504,December 1984,Washington,3240000,2072152,64.0,1887832,58.3,184320,8.9
5505,December 1984,West Virginia,1466000,767093,52.3,655875,44.7,111218,14.5
5506,December 1984,Wisconsin,3563000,2377115,66.7,2211896,62.1,165219,7.0
5507,December 1984,Wyoming,360000,252519,70.1,236511,65.7,16008,6.3
5508,January 1985,Alabama,2955000,1797622,60.8,1618556,54.8,179066,10.0
5509,January 1985,Alaska,340000,250621,73.7,226899,66.7,23722,9.5
5510,January 1985,Arizona,2315000,1465634,63.3,1381054,59.7,84580,5.8
5511,January 1985,Arkansas,1741000,1035677,59.5,947038,54.4,88639,8.6
5512,January 1985,California,19426000,12874926,66.3,11933959,61.4,940967,7.3
5513,January 1985,Colorado,2372000,1722807,72.6,1623644,68.5,99163,5.8
5514,January 1985,Connecticut,2461000,1695158,68.9,1612622,65.5,82536,4.9
5515,January 1985,Delaware,468000,312037,66.7,293614,62.7,18423,5.9
5516,January 1985,District of Columbia,483000,327191,67.7,299526,62.0,27665,8.5
5517,January 1985,Florida,8794000,5287331,60.1,4963787,56.4,323544,6.1
5518,January 1985,Georgia,4306000,2834714,65.8,2656786,61.7,177928,6.3
5519,January 1985,Hawaii,725000,474287,65.4,447865,61.8,26422,5.6
5520,January 1985,Idaho,700000,465490,66.5,430425,61.5,35065,7.5
5521,January 1985,Illinois,8626000,5664267,65.7,5162968,59.9,501299,8.9
5522,January 1985,Indiana,4085000,2679887,65.6,2455980,60.1,223907,8.4
5523,January 1985,Iowa,2155000,1413585,65.6,1308354,60.7,105231,7.4
5524,January 1985,Kansas,1794000,1223187,68.2,1162607,64.8,60580,5.0
5525,January 1985,Kentucky,2739000,1692480,61.8,1546407,56.5,146073,8.6
5526,January 1985,Louisiana,3192000,1977628,62.0,1760215,55.1,217413,11.0
5527,January 1985,Maine,871000,551145,63.3,519562,59.7,31583,5.7
5528,January 1985,Maryland,3315000,2264788,68.3,2152557,64.9,112231,5.0
5529,January 1985,Massachusetts,4524000,3046152,67.3,2922301,64.6,123851,4.1
5530,January 1985,Michigan,6768000,4359385,64.4,3902602,57.7,456783,10.5
5531,January 1985,Minnesota,3113000,2217003,71.2,2086324,67.0,130679,5.9
5532,January 1985,Mississippi,1854000,1101739,59.4,987500,53.3,114239,10.4
5533,January 1985,Missouri,3767000,2422015,64.3,2258789,60.0,163226,6.7
5534,January 1985,Montana,603000,402308,66.7,372346,61.7,29962,7.4
5535,January 1985,Nebraska,1176000,802184,68.2,764711,65.0,37473,4.7
5536,January 1985,Nevada,708000,510083,72.0,469377,66.3,40706,8.0
5537,January 1985,New Hampshire,748000,532518,71.2,509968,68.2,22550,4.2
5538,January 1985,New Jersey,5851000,3821255,65.3,3603921,61.6,217334,5.7
5539,January 1985,New Mexico,1019000,639894,62.8,586976,57.6,52918,8.3
5540,January 1985,New York,13662000,8162398,59.7,7608817,55.7,553581,6.8
5541,January 1985,North Carolina,4626000,3065647,66.3,2869381,62.0,196266,6.4
5542,January 1985,North Dakota,488000,330103,67.6,311636,63.9,18467,5.6
5543,January 1985,Ohio,8057000,5120826,63.6,4664168,57.9,456658,8.9
5544,January 1985,Oklahoma,2413000,1568623,65.0,1455729,60.3,112894,7.2
5545,January 1985,Oregon,2025000,1319562,65.2,1195254,59.0,124308,9.4
5546,January 1985,Pennsylvania,9198000,5524349,60.1,5062544,55.0,461805,8.4
5547,January 1985,Rhode Island,745000,496565,66.7,471591,63.3,24974,5.0
5548,January 1985,South Carolina,2405000,1522319,63.3,1423668,59.2,98651,6.5
5549,January 1985,South Dakota,507000,344857,68.0,328721,64.8,16136,4.7
5550,January 1985,Tennessee,3571000,2249892,63.0,2072937,58.0,176955,7.9
5551,January 1985,Texas,11651000,7998343,68.6,7484932,64.2,513411,6.4
5552,January 1985,Utah,1056000,719230,68.1,673699,63.8,45531,6.3
5553,January 1985,Vermont,399000,273727,68.6,260489,65.3,13238,4.8
5554,January 1985,Virginia,4185000,2860775,68.4,2708675,64.7,152100,5.3
5555,January 1985,Washington,3242000,2078425,64.1,1894656,58.4,183769,8.8
5556,January 1985,West Virginia,1466000,766966,52.3,656901,44.8,110065,14.4
5557,January 1985,Wisconsin,3564000,2378184,66.7,2211606,62.1,166578,7.0
5558,January 1985,Wyoming,360000,251841,70.0,235938,65.5,15903,6.3
5559,February 1985,Alabama,2958000,1799234,60.8,1622868,54.9,176366,9.8
5560,February 1985,Alaska,341000,250871,73.6,227040,66.6,23831,9.5
5561,February 1985,Arizona,2322000,1470262,63.3,1382982,59.6,87280,5.9
5562,February 1985,Arkansas,1743000,1038522,59.6,949611,54.5,88911,8.6
5563,February 1985,California,19468000,12905317,66.3,11966262,61.5,939055,7.3
5564,February 1985,Colorado,2375000,1722632,72.5,1622934,68.3,99698,5.8
5565,February 1985,Connecticut,2463000,1700766,69.1,1616609,65.6,84157,4.9
5566,February 1985,Delaware,468000,312547,66.8,294475,62.9,18072,5.8
5567,February 1985,District of Columbia,484000,326426,67.4,298761,61.7,27665,8.5
5568,February 1985,Florida,8815000,5306382,60.2,4982635,56.5,323747,6.1
5569,February 1985,Georgia,4316000,2847447,66.0,2664594,61.7,182853,6.4
5570,February 1985,Hawaii,726000,474852,65.4,449097,61.9,25755,5.4
5571,February 1985,Idaho,700000,466047,66.6,430488,61.5,35559,7.6
5572,February 1985,Illinois,8627000,5672272,65.8,5169385,59.9,502887,8.9
5573,February 1985,Indiana,4086000,2691544,65.9,2468168,60.4,223376,8.3
5574,February 1985,Iowa,2154000,1414281,65.7,1308103,60.7,106178,7.5
5575,February 1985,Kansas,1793000,1226963,68.4,1165625,65.0,61338,5.0
5576,February 1985,Kentucky,2740000,1693680,61.8,1546269,56.4,147411,8.7
5577,February 1985,Louisiana,3193000,1980983,62.0,1760985,55.2,219998,11.1
5578,February 1985,Maine,871000,552086,63.4,520448,59.8,31638,5.7
5579,February 1985,Maryland,3320000,2267821,68.3,2157172,65.0,110649,4.9
5580,February 1985,Massachusetts,4526000,3049047,67.4,2926412,64.7,122635,4.0
5581,February 1985,Michigan,6773000,4361246,64.4,3909305,57.7,451941,10.4
5582,February 1985,Minnesota,3114000,2218942,71.3,2088153,67.1,130789,5.9
5583,February 1985,Mississippi,1857000,1106915,59.6,992443,53.4,114472,10.3
5584,February 1985,Missouri,3768000,2432878,64.6,2267609,60.2,165269,6.8
5585,February 1985,Montana,603000,402547,66.8,372211,61.7,30336,7.5
5586,February 1985,Nebraska,1175000,803783,68.4,765080,65.1,38703,4.8
5587,February 1985,Nevada,711000,511922,72.0,471039,66.3,40883,8.0
5588,February 1985,New Hampshire,750000,534051,71.2,511777,68.2,22274,4.2
5589,February 1985,New Jersey,5853000,3828408,65.4,3610389,61.7,218019,5.7
5590,February 1985,New Mexico,1021000,641913,62.9,588618,57.7,53295,8.3
5591,February 1985,New York,13666000,8177031,59.8,7623263,55.8,553768,6.8
5592,February 1985,North Carolina,4634000,3074050,66.3,2883406,62.2,190644,6.2
5593,February 1985,North Dakota,488000,330767,67.8,312122,64.0,18645,5.6
5594,February 1985,Ohio,8061000,5124709,63.6,4670536,57.9,454173,8.9
5595,February 1985,Oklahoma,2410000,1569041,65.1,1455392,60.4,113649,7.2
5596,February 1985,Oregon,2024000,1318537,65.1,1194908,59.0,123629,9.4
5597,February 1985,Pennsylvania,9199000,5531180,60.1,5073444,55.2,457736,8.3
5598,February 1985,Rhode Island,746000,497007,66.6,472084,63.3,24923,5.0
5599,February 1985,South Carolina,2410000,1525780,63.3,1427135,59.2,98645,6.5
5600,February 1985,South Dakota,506000,345001,68.2,328562,64.9,16439,4.8
5601,February 1985,Tennessee,3577000,2254551,63.0,2076347,58.0,178204,7.9
5602,February 1985,Texas,11670000,8014082,68.7,7489140,64.2,524942,6.6
5603,February 1985,Utah,1057000,721571,68.3,676047,64.0,45524,6.3
5604,February 1985,Vermont,400000,274567,68.6,261240,65.3,13327,4.9
5605,February 1985,Virginia,4190000,2864044,68.4,2710010,64.7,154034,5.4
5606,February 1985,Washington,3244000,2083680,64.2,1900716,58.6,182964,8.8
5607,February 1985,West Virginia,1465000,765901,52.3,657626,44.9,108275,14.1
5608,February 1985,Wisconsin,3566000,2378757,66.7,2210378,62.0,168379,7.1
5609,February 1985,Wyoming,359000,251280,70.0,235402,65.6,15878,6.3
5610,March 1985,Alabama,2960000,1799433,60.8,1626137,54.9,173296,9.6
5611,March 1985,Alaska,341000,250987,73.6,226968,66.6,24019,9.6
5612,March 1985,Arizona,2329000,1473001,63.2,1383229,59.4,89772,6.1
5613,March 1985,Arkansas,1744000,1041696,59.7,952334,54.6,89362,8.6
5614,March 1985,California,19509000,12925568,66.3,11986395,61.4,939173,7.3
5615,March 1985,Colorado,2377000,1721147,72.4,1620944,68.2,100203,5.8
5616,March 1985,Connecticut,2465000,1704872,69.2,1619460,65.7,85412,5.0
5617,March 1985,Delaware,469000,313245,66.8,295571,63.0,17674,5.6
5618,March 1985,District of Columbia,484000,325452,67.2,297771,61.5,27681,8.5
5619,March 1985,Florida,8837000,5317656,60.2,4993518,56.5,324138,6.1
5620,March 1985,Georgia,4327000,2857905,66.0,2669891,61.7,188014,6.6
5621,March 1985,Hawaii,727000,475393,65.4,450103,61.9,25290,5.3
5622,March 1985,Idaho,700000,466556,66.7,430451,61.5,36105,7.7
5623,March 1985,Illinois,8628000,5673445,65.8,5167793,59.9,505652,8.9
5624,March 1985,Indiana,4087000,2700260,66.1,2477912,60.6,222348,8.2
5625,March 1985,Iowa,2153000,1413567,65.7,1307049,60.7,106518,7.5
5626,March 1985,Kansas,1793000,1228955,68.5,1167173,65.1,61782,5.0
5627,March 1985,Kentucky,2741000,1694097,61.8,1544840,56.4,149257,8.8
5628,March 1985,Louisiana,3194000,1982445,62.1,1760221,55.1,222224,11.2
5629,March 1985,Maine,872000,552214,63.3,520731,59.7,31483,5.7
5630,March 1985,Maryland,3324000,2270273,68.3,2160976,65.0,109297,4.8
5631,March 1985,Massachusetts,4527000,3050746,67.4,2928763,64.7,121983,4.0
5632,March 1985,Michigan,6777000,4359554,64.3,3911336,57.7,448218,10.3
5633,March 1985,Minnesota,3115000,2220295,71.3,2089492,67.1,130803,5.9
5634,March 1985,Mississippi,1859000,1111588,59.8,996724,53.6,114864,10.3
5635,March 1985,Missouri,3770000,2440301,64.7,2274002,60.3,166299,6.8
5636,March 1985,Montana,603000,402800,66.8,372219,61.7,30581,7.6
5637,March 1985,Nebraska,1174000,805175,68.6,765258,65.2,39917,5.0
5638,March 1985,Nevada,714000,513599,71.9,472564,66.2,41035,8.0
5639,March 1985,New Hampshire,751000,535631,71.3,513694,68.4,21937,4.1
5640,March 1985,New Jersey,5855000,3833422,65.5,3613936,61.7,219486,5.7
5641,March 1985,New Mexico,1022000,643779,63.0,590137,57.7,53642,8.3
5642,March 1985,New York,13670000,8184560,59.9,7629801,55.8,554759,6.8
5643,March 1985,North Carolina,4643000,3080676,66.4,2895136,62.4,185540,6.0
5644,March 1985,North Dakota,487000,331368,68.0,312625,64.2,18743,5.7
5645,March 1985,Ohio,8064000,5127704,63.6,4674812,58.0,452892,8.8
5646,March 1985,Oklahoma,2408000,1567736,65.1,1453929,60.4,113807,7.3
5647,March 1985,Oregon,2024000,1317822,65.1,1195313,59.1,122509,9.3
5648,March 1985,Pennsylvania,9199000,5536394,60.2,5080995,55.2,455399,8.2
5649,March 1985,Rhode Island,746000,497076,66.6,472367,63.3,24709,5.0
5650,March 1985,South Carolina,2414000,1530401,63.4,1430055,59.2,100346,6.6
5651,March 1985,South Dakota,506000,345147,68.2,328413,64.9,16734,4.8
5652,March 1985,Tennessee,3582000,2256367,63.0,2076439,58.0,179928,8.0
5653,March 1985,Texas,11689000,8021570,68.6,7485636,64.0,535934,6.7
5654,March 1985,Utah,1058000,723800,68.4,678384,64.1,45416,6.3
5655,March 1985,Vermont,400000,275348,68.8,261968,65.5,13380,4.9
5656,March 1985,Virginia,4195000,2864518,68.3,2708133,64.6,156385,5.5
5657,March 1985,Washington,3246000,2087005,64.3,1905380,58.7,181625,8.7
5658,March 1985,West Virginia,1465000,764097,52.2,657893,44.9,106204,13.9
5659,March 1985,Wisconsin,3567000,2378087,66.7,2208139,61.9,169948,7.1
5660,March 1985,Wyoming,359000,250992,69.9,234980,65.5,16012,6.4
5661,April 1985,Alabama,2963000,1798122,60.7,1628532,55.0,169590,9.4
5662,April 1985,Alaska,342000,251079,73.4,226851,66.3,24228,9.6
5663,April 1985,Arizona,2336000,1474550,63.1,1382503,59.2,92047,6.2
5664,April 1985,Arkansas,1745000,1044833,59.9,954850,54.7,89983,8.6
5665,April 1985,California,19551000,12936909,66.2,11997160,61.4,939749,7.3
5666,April 1985,Colorado,2380000,1718774,72.2,1617849,68.0,100925,5.9
5667,April 1985,Connecticut,2466000,1707382,69.2,1621367,65.7,86015,5.0
5668,April 1985,Delaware,470000,314197,66.9,296932,63.2,17265,5.5
5669,April 1985,District of Columbia,484000,324497,67.0,296847,61.3,27650,8.5
5670,April 1985,Florida,8858000,5322271,60.1,4997882,56.4,324389,6.1
5671,April 1985,Georgia,4338000,2865734,66.1,2673377,61.6,192357,6.7
5672,April 1985,Hawaii,728000,476029,65.4,450883,61.9,25146,5.3
5673,April 1985,Idaho,700000,466894,66.7,430329,61.5,36565,7.8
5674,April 1985,Illinois,8629000,5669458,65.7,5160193,59.8,509265,9.0
5675,April 1985,Indiana,4088000,2705884,66.2,2485057,60.8,220827,8.2
5676,April 1985,Iowa,2152000,1411493,65.6,1305231,60.7,106262,7.5
5677,April 1985,Kansas,1792000,1229051,68.6,1167224,65.1,61827,5.0
5678,April 1985,Kentucky,2742000,1693685,61.8,1542400,56.3,151285,8.9
5679,April 1985,Louisiana,3195000,1982428,62.0,1758202,55.0,224226,11.3
5680,April 1985,Maine,873000,551550,63.2,520525,59.6,31025,5.6
5681,April 1985,Maryland,3329000,2272298,68.3,2164235,65.0,108063,4.8
5682,April 1985,Massachusetts,4529000,3051132,67.4,2929535,64.7,121597,4.0
5683,April 1985,Michigan,6782000,4355334,64.2,3909641,57.6,445693,10.2
5684,April 1985,Minnesota,3116000,2221367,71.3,2090656,67.1,130711,5.9
5685,April 1985,Mississippi,1862000,1115551,59.9,1000321,53.7,115230,10.3
5686,April 1985,Missouri,3771000,2444448,64.8,2278602,60.4,165846,6.8
5687,April 1985,Montana,603000,402999,66.8,372352,61.7,30647,7.6
5688,April 1985,Nebraska,1173000,806144,68.7,765229,65.2,40915,5.1
5689,April 1985,Nevada,716000,514955,71.9,473919,66.2,41036,8.0
5690,April 1985,New Hampshire,753000,537159,71.3,515612,68.5,21547,4.0
5691,April 1985,New Jersey,5857000,3835331,65.5,3615404,61.7,219927,5.7
5692,April 1985,New Mexico,1023000,645236,63.1,591343,57.8,53893,8.4
5693,April 1985,New York,13674000,8249355,60.3,7695257,56.3,554098,6.7
5694,April 1985,North Carolina,4652000,3085411,66.3,2904253,62.4,181158,5.9
5695,April 1985,North Dakota,487000,331850,68.1,313091,64.3,18759,5.7
5696,April 1985,Ohio,8068000,5130600,63.6,4677442,58.0,453158,8.8
5697,April 1985,Oklahoma,2406000,1564985,65.0,1451899,60.3,113086,7.2
5698,April 1985,Oregon,2024000,1317387,65.1,1196345,59.1,121042,9.2
5699,April 1985,Pennsylvania,9199000,5539568,60.2,5085802,55.3,453766,8.2
5700,April 1985,Rhode Island,747000,497017,66.5,472662,63.3,24355,4.9
5701,April 1985,South Carolina,2419000,1536238,63.5,1432675,59.2,103563,6.7
5702,April 1985,South Dakota,506000,345348,68.3,328397,64.9,16951,4.9
5703,April 1985,Tennessee,3587000,2255397,62.9,2074052,57.8,181345,8.0
5704,April 1985,Texas,11708000,8021915,68.5,7475793,63.9,546122,6.8
5705,April 1985,Utah,1059000,725897,68.5,680726,64.3,45171,6.2
5706,April 1985,Vermont,401000,276157,68.9,262744,65.5,13413,4.9
5707,April 1985,Virginia,4199000,2863040,68.2,2704008,64.4,159032,5.6
5708,April 1985,Washington,3248000,2088389,64.3,1908705,58.8,179684,8.6
5709,April 1985,West Virginia,1464000,761991,52.0,657748,44.9,104243,13.7
5710,April 1985,Wisconsin,3569000,2376218,66.6,2205370,61.8,170848,7.2
5711,April 1985,Wyoming,358000,251067,70.1,234746,65.6,16321,6.5
5712,May 1985,Alabama,2965000,1796253,60.6,1630588,55.0,165665,9.2
5713,May 1985,Alaska,342000,251233,73.5,226860,66.3,24373,9.7
5714,May 1985,Arizona,2344000,1476114,63.0,1381862,59.0,94252,6.4
5715,May 1985,Arkansas,1746000,1047624,60.0,956944,54.8,90680,8.7
5716,May 1985,California,19592000,12944832,66.1,12004242,61.3,940590,7.3
5717,May 1985,Colorado,2382000,1716098,72.0,1614157,67.8,101941,5.9
5718,May 1985,Connecticut,2468000,1708850,69.2,1622914,65.8,85936,5.0
5719,May 1985,Delaware,471000,315355,67.0,298501,63.4,16854,5.3
5720,May 1985,District of Columbia,484000,323723,66.9,296211,61.2,27512,8.5
5721,May 1985,Florida,8879000,5323389,60.0,4999020,56.3,324369,6.1
5722,May 1985,Georgia,4349000,2871561,66.0,2676532,61.5,195029,6.8
5723,May 1985,Hawaii,729000,476867,65.4,451557,61.9,25310,5.3
5724,May 1985,Idaho,699000,467002,66.8,430155,61.5,36847,7.9
5725,May 1985,Illinois,8631000,5663832,65.6,5150153,59.7,513679,9.1
5726,May 1985,Indiana,4089000,2709275,66.3,2490499,60.9,218776,8.1
5727,May 1985,Iowa,2150000,1408913,65.5,1303226,60.6,105687,7.5
5728,May 1985,Kansas,1791000,1227931,68.6,1166269,65.1,61662,5.0
5729,May 1985,Kentucky,2744000,1692887,61.7,1539483,56.1,153404,9.1
5730,May 1985,Louisiana,3196000,1981885,62.0,1755720,54.9,226165,11.4
5731,May 1985,Maine,874000,550519,63.0,520161,59.5,30358,5.5
5732,May 1985,Maryland,3333000,2274309,68.2,2167411,65.0,106898,4.7
5733,May 1985,Massachusetts,4530000,3050588,67.3,2929268,64.7,121320,4.0
5734,May 1985,Michigan,6786000,4351006,64.1,3906666,57.6,444340,10.2
5735,May 1985,Minnesota,3117000,2223022,71.3,2091962,67.1,131060,5.9
5736,May 1985,Mississippi,1864000,1119015,60.0,1003389,53.8,115626,10.3
5737,May 1985,Missouri,3772000,2446992,64.9,2282585,60.5,164407,6.7
5738,May 1985,Montana,604000,403112,66.7,372502,61.7,30610,7.6
5739,May 1985,Nebraska,1172000,806629,68.8,765058,65.3,41571,5.2
5740,May 1985,Nevada,719000,515948,71.8,475109,66.1,40839,7.9
5741,May 1985,New Hampshire,755000,538584,71.3,517491,68.5,21093,3.9
5742,May 1985,New Jersey,5859000,3834857,65.5,3616360,61.7,218497,5.7
5743,May 1985,New Mexico,1024000,646338,63.1,592316,57.8,54022,8.4
5744,May 1985,New York,13679000,8278164,60.5,7726502,56.5,551662,6.7
5745,May 1985,North Carolina,4661000,3089311,66.3,2911914,62.5,177397,5.7
5746,May 1985,North Dakota,487000,332214,68.2,313483,64.4,18731,5.6
5747,May 1985,Ohio,8071000,5135147,63.6,4679665,58.0,455482,8.9
5748,May 1985,Oklahoma,2404000,1561911,65.0,1450080,60.3,111831,7.2
5749,May 1985,Oregon,2024000,1317217,65.1,1198005,59.2,119212,9.1
5750,May 1985,Pennsylvania,9199000,5541627,60.2,5089528,55.3,452099,8.2
5751,May 1985,Rhode Island,747000,497055,66.5,473175,63.3,23880,4.8
5752,May 1985,South Carolina,2423000,1542873,63.7,1435335,59.2,107538,7.0
5753,May 1985,South Dakota,506000,345567,68.3,328530,64.9,17037,4.9
5754,May 1985,Tennessee,3592000,2252845,62.7,2070876,57.7,181969,8.1
5755,May 1985,Texas,11727000,8018956,68.4,7462899,63.6,556057,6.9
5756,May 1985,Utah,1061000,727887,68.6,683130,64.4,44757,6.1
5757,May 1985,Vermont,401000,277042,69.1,263615,65.7,13427,4.8
5758,May 1985,Virginia,4204000,2860749,68.0,2699290,64.2,161459,5.6
5759,May 1985,Washington,3250000,2088676,64.3,1911282,58.8,177394,8.5
5760,May 1985,West Virginia,1464000,759929,51.9,657416,44.9,102513,13.5
5761,May 1985,Wisconsin,3570000,2373854,66.5,2202917,61.7,170937,7.2
5762,May 1985,Wyoming,358000,251441,70.2,234703,65.6,16738,6.7
5763,June 1985,Alabama,2968000,1795173,60.5,1632945,55.0,162228,9.0
5764,June 1985,Alaska,343000,251456,73.3,227043,66.2,24413,9.7
5765,June 1985,Arizona,2351000,1478808,62.9,1382557,58.8,96251,6.5
5766,June 1985,Arkansas,1747000,1049820,60.1,958512,54.9,91308,8.7
5767,June 1985,California,19634000,12955497,66.0,12014317,61.2,941180,7.3
5768,June 1985,Colorado,2385000,1713649,71.9,1610470,67.5,103179,6.0
5769,June 1985,Connecticut,2469000,1710033,69.3,1624892,65.8,85141,5.0
5770,June 1985,Delaware,471000,316594,67.2,300153,63.7,16441,5.2
5771,June 1985,District of Columbia,484000,323150,66.8,295907,61.1,27243,8.4
5772,June 1985,Florida,8901000,5325080,59.8,5001341,56.2,323739,6.1
5773,June 1985,Georgia,4359000,2876328,66.0,2681022,61.5,195306,6.8
5774,June 1985,Hawaii,730000,477921,65.5,452244,62.0,25677,5.4
5775,June 1985,Idaho,699000,466911,66.8,429982,61.5,36929,7.9
5776,June 1985,Illinois,8632000,5660394,65.6,5141738,59.6,518656,9.2
5777,June 1985,Indiana,4090000,2711724,66.3,2495528,61.0,216196,8.0
5778,June 1985,Iowa,2149000,1407077,65.5,1301851,60.6,105226,7.5
5779,June 1985,Kansas,1791000,1226528,68.5,1165036,65.0,61492,5.0
5780,June 1985,Kentucky,2745000,1692299,61.7,1536750,56.0,155549,9.2
5781,June 1985,Louisiana,3197000,1981746,62.0,1753608,54.9,228138,11.5
5782,June 1985,Maine,874000,549646,62.9,519937,59.5,29709,5.4
5783,June 1985,Maryland,3338000,2276629,68.2,2170892,65.0,105737,4.6
5784,June 1985,Massachusetts,4532000,3049883,67.3,2928817,64.6,121066,4.0
5785,June 1985,Michigan,6791000,4349562,64.0,3906126,57.5,443436,10.2
5786,June 1985,Minnesota,3118000,2225647,71.4,2093481,67.1,132166,5.9
5787,June 1985,Mississippi,1867000,1122206,60.1,1006241,53.9,115965,10.3
5788,June 1985,Missouri,3774000,2450403,64.9,2287763,60.6,162640,6.6
5789,June 1985,Montana,604000,403114,66.7,372564,61.7,30550,7.6
5790,June 1985,Nebraska,1171000,806707,68.9,764805,65.3,41902,5.2
5791,June 1985,Nevada,722000,516655,71.6,476169,66.0,40486,7.8
5792,June 1985,New Hampshire,756000,539945,71.4,519364,68.7,20581,3.8
5793,June 1985,New Jersey,5861000,3834284,65.4,3618523,61.7,215761,5.6
5794,June 1985,New Mexico,1025000,647426,63.2,593340,57.9,54086,8.4
5795,June 1985,New York,13683000,8293359,60.6,7745005,56.6,548354,6.6
5796,June 1985,North Carolina,4669000,3094246,66.3,2920327,62.5,173919,5.6
5797,June 1985,North Dakota,486000,332515,68.4,313805,64.6,18710,5.6
5798,June 1985,Ohio,8075000,5142712,63.7,4682859,58.0,459853,8.9
5799,June 1985,Oklahoma,2402000,1559874,64.9,1449255,60.3,110619,7.1
5800,June 1985,Oregon,2023000,1317521,65.1,1200438,59.3,117083,8.9
5801,June 1985,Pennsylvania,9199000,5543759,60.3,5094048,55.4,449711,8.1
5802,June 1985,Rhode Island,748000,497359,66.5,474028,63.4,23331,4.7
5803,June 1985,South Carolina,2428000,1549339,63.8,1438226,59.2,111113,7.2
5804,June 1985,South Dakota,505000,345665,68.4,328687,65.1,16978,4.9
5805,June 1985,Tennessee,3597000,2250452,62.6,2069006,57.5,181446,8.1
5806,June 1985,Texas,11746000,8017427,68.3,7451462,63.4,565965,7.1
5807,June 1985,Utah,1062000,729813,68.7,685616,64.6,44197,6.1
5808,June 1985,Vermont,402000,278043,69.2,264605,65.8,13438,4.8
5809,June 1985,Virginia,4208000,2858827,67.9,2695897,64.1,162930,5.7
5810,June 1985,Washington,3252000,2089504,64.3,1914303,58.9,175201,8.4
5811,June 1985,West Virginia,1463000,758037,51.8,657171,44.9,100866,13.3
5812,June 1985,Wisconsin,3572000,2372439,66.4,2201742,61.6,170697,7.2
5813,June 1985,Wyoming,357000,251946,70.6,234767,65.8,17179,6.8
5814,July 1985,Alabama,2970000,1795743,60.5,1636056,55.1,159687,8.9
5815,July 1985,Alaska,343000,251778,73.4,227389,66.3,24389,9.7
5816,July 1985,Arizona,2358000,1483303,62.9,1385439,58.8,97864,6.6
5817,July 1985,Arkansas,1748000,1051304,60.1,959439,54.9,91865,8.7
5818,July 1985,California,19675000,12972909,65.9,12031922,61.2,940987,7.3
5819,July 1985,Colorado,2387000,1711664,71.7,1607163,67.3,104501,6.1
5820,July 1985,Connecticut,2471000,1711428,69.3,1627781,65.9,83647,4.9
5821,July 1985,Delaware,472000,317753,67.3,301726,63.9,16027,5.0
5822,July 1985,District of Columbia,484000,322767,66.7,295932,61.1,26835,8.3
5823,July 1985,Florida,8922000,5330416,59.7,5008120,56.1,322296,6.0
5824,July 1985,Georgia,4370000,2881087,65.9,2687755,61.5,193332,6.7
5825,July 1985,Hawaii,731000,479132,65.5,453078,62.0,26054,5.4
5826,July 1985,Idaho,699000,466665,66.8,429805,61.5,36860,7.9
5827,July 1985,Illinois,8633000,5661764,65.6,5138149,59.5,523615,9.2
5828,July 1985,Indiana,4091000,2714094,66.3,2500978,61.1,213116,7.9
5829,July 1985,Iowa,2148000,1406900,65.5,1301809,60.6,105091,7.5
5830,July 1985,Kansas,1790000,1225793,68.5,1164074,65.0,61719,5.0
5831,July 1985,Kentucky,2746000,1692579,61.6,1534700,55.9,157879,9.3
5832,July 1985,Louisiana,3198000,1982809,62.0,1752411,54.8,230398,11.6
5833,July 1985,Maine,875000,549363,62.8,520094,59.4,29269,5.3
5834,July 1985,Maryland,3342000,2279468,68.2,2174892,65.1,104576,4.6
5835,July 1985,Massachusetts,4533000,3049657,67.3,2928848,64.6,120809,4.0
5836,July 1985,Michigan,6795000,4352425,64.1,3910828,57.6,441597,10.1
5837,July 1985,Minnesota,3119000,2229070,71.5,2095167,67.2,133903,6.0
5838,July 1985,Mississippi,1869000,1125453,60.2,1009060,54.0,116393,10.3
5839,July 1985,Missouri,3775000,2456285,65.1,2295261,60.8,161024,6.6
5840,July 1985,Montana,604000,403022,66.7,372432,61.7,30590,7.6
5841,July 1985,Nebraska,1170000,806662,68.9,764505,65.3,42157,5.2
5842,July 1985,Nevada,725000,517220,71.3,477151,65.8,40069,7.7
5843,July 1985,New Hampshire,758000,541314,71.4,521296,68.8,20018,3.7
5844,July 1985,New Jersey,5863000,3835985,65.4,3622881,61.8,213104,5.6
5845,July 1985,New Mexico,1026000,648881,63.2,594752,58.0,54129,8.3
5846,July 1985,New York,13687000,8307718,60.7,7761951,56.7,545767,6.6
5847,July 1985,North Carolina,4678000,3101962,66.3,2931316,62.7,170646,5.5
5848,July 1985,North Dakota,486000,332830,68.5,314089,64.6,18741,5.6
5849,July 1985,Ohio,8078000,5153356,63.8,4687855,58.0,465501,9.0
5850,July 1985,Oklahoma,2400000,1559930,65.0,1449771,60.4,110159,7.1
5851,July 1985,Oregon,2023000,1318629,65.2,1203673,59.5,114956,8.7
5852,July 1985,Pennsylvania,9199000,5547520,60.3,5101124,55.5,446396,8.0
5853,July 1985,Rhode Island,748000,498089,66.6,475291,63.5,22798,4.6
5854,July 1985,South Carolina,2432000,1554847,63.9,1441386,59.3,113461,7.3
5855,July 1985,South Dakota,505000,345581,68.4,328730,65.1,16851,4.9
5856,July 1985,Tennessee,3602000,2249991,62.5,2069642,57.5,180349,8.0
5857,July 1985,Texas,11765000,8020208,68.2,7444654,63.3,575554,7.2
5858,July 1985,Utah,1063000,731782,68.8,688117,64.7,43665,6.0
5859,July 1985,Vermont,402000,279177,69.4,265725,66.1,13452,4.8
5860,July 1985,Virginia,4213000,2858197,67.8,2695104,64.0,163093,5.7
5861,July 1985,Washington,3254000,2092099,64.3,1918672,59.0,173427,8.3
5862,July 1985,West Virginia,1463000,756337,51.7,657188,44.9,99149,13.1
5863,July 1985,Wisconsin,3573000,2373040,66.4,2202167,61.6,170873,7.2
5864,July 1985,Wyoming,357000,252384,70.7,234819,65.8,17565,7.0
5865,August 1985,Alabama,2973000,1798165,60.5,1640408,55.2,157757,8.8
5866,August 1985,Alaska,344000,252244,73.3,227858,66.2,24386,9.7
5867,August 1985,Arizona,2364000,1489554,63.0,1391033,58.8,98521,6.6
5868,August 1985,Arkansas,1749000,1052165,60.2,959968,54.9,92197,8.8
5869,August 1985,California,19708000,12996682,65.9,12060631,61.2,936051,7.2
5870,August 1985,Colorado,2390000,1710437,71.6,1604806,67.1,105631,6.2
5871,August 1985,Connecticut,2472000,1713123,69.3,1631791,66.0,81332,4.7
5872,August 1985,Delaware,473000,318689,67.4,303097,64.1,15592,4.9
5873,August 1985,District of Columbia,484000,322520,66.6,296265,61.2,26255,8.1
5874,August 1985,Florida,8943000,5341594,59.7,5022212,56.2,319382,6.0
5875,August 1985,Georgia,4377000,2886157,65.9,2697367,61.6,188790,6.5
5876,August 1985,Hawaii,732000,480448,65.6,454199,62.0,26249,5.5
5877,August 1985,Idaho,700000,466442,66.6,429615,61.4,36827,7.9
5878,August 1985,Illinois,8637000,5666971,65.6,5141938,59.5,525033,9.3
5879,August 1985,Indiana,4093000,2716499,66.4,2507761,61.3,208738,7.7
5880,August 1985,Iowa,2147000,1408763,65.6,1303616,60.7,105147,7.5
5881,August 1985,Kansas,1792000,1226169,68.4,1163861,64.9,62308,5.1
5882,August 1985,Kentucky,2747000,1693655,61.7,1533653,55.8,160002,9.4
5883,August 1985,Louisiana,3200000,1985341,62.0,1752772,54.8,232569,11.7
5884,August 1985,Maine,876000,549921,62.8,520763,59.4,29158,5.3
5885,August 1985,Maryland,3346000,2282714,68.2,2179638,65.1,103076,4.5
5886,August 1985,Massachusetts,4536000,3050590,67.3,2930200,64.6,120390,3.9
5887,August 1985,Michigan,6800000,4357980,64.1,3921888,57.7,436092,10.0
5888,August 1985,Minnesota,3123000,2232462,71.5,2097048,67.1,135414,6.1
5889,August 1985,Mississippi,1869000,1129072,60.4,1012171,54.2,116901,10.4
5890,August 1985,Missouri,3779000,2464868,65.2,2305744,61.0,159124,6.5
5891,August 1985,Montana,604000,402882,66.7,372125,61.6,30757,7.6
5892,August 1985,Nebraska,1171000,806733,68.9,764268,65.3,42465,5.3
5893,August 1985,Nevada,726000,517769,71.3,478151,65.9,39618,7.7
5894,August 1985,New Hampshire,760000,542785,71.4,523372,68.9,19413,3.6
5895,August 1985,New Jersey,5871000,3841488,65.4,3630041,61.8,211447,5.5
5896,August 1985,New Mexico,1029000,650934,63.3,596783,58.0,54151,8.3
5897,August 1985,New York,13689000,8325905,60.8,7783043,56.9,542862,6.5
5898,August 1985,North Carolina,4682000,3112577,66.5,2946049,62.9,166528,5.4
5899,August 1985,North Dakota,486000,333203,68.6,314361,64.7,18842,5.7
5900,August 1985,Ohio,8080000,5165095,63.9,4696142,58.1,468953,9.1
5901,August 1985,Oklahoma,2402000,1562319,65.0,1451854,60.4,110465,7.1
5902,August 1985,Oregon,2026000,1320659,65.2,1207664,59.6,112995,8.6
5903,August 1985,Pennsylvania,9203000,5554421,60.4,5112648,55.6,441773,8.0
5904,August 1985,Rhode Island,749000,499209,66.7,476913,63.7,22296,4.5
5905,August 1985,South Carolina,2434000,1558789,64.0,1444871,59.4,113918,7.3
5906,August 1985,South Dakota,506000,345397,68.3,328670,65.0,16727,4.8
5907,August 1985,Tennessee,3604000,2252210,62.5,2073573,57.5,178637,7.9
5908,August 1985,Texas,11781000,8026736,68.1,7444572,63.2,582164,7.3
5909,August 1985,Utah,1064000,733850,69.0,690572,64.9,43278,5.9
5910,August 1985,Vermont,402000,280411,69.8,266961,66.4,13450,4.8
5911,August 1985,Virginia,4220000,2859433,67.8,2697904,63.9,161529,5.6
5912,August 1985,Washington,3261000,2096793,64.3,1925081,59.0,171712,8.2
5913,August 1985,West Virginia,1462000,754658,51.6,657568,45.0,97090,12.9
5914,August 1985,Wisconsin,3575000,2375711,66.5,2204388,61.7,171323,7.2
5915,August 1985,Wyoming,357000,252638,70.8,234763,65.8,17875,7.1
5916,September 1985,Alabama,2975000,1802534,60.6,1645956,55.3,156578,8.7
5917,September 1985,Alaska,345000,252858,73.3,228384,66.2,24474,9.7
5918,September 1985,Arizona,2370000,1497013,63.2,1398861,59.0,98152,6.6
5919,September 1985,Arkansas,1750000,1052650,60.2,960455,54.9,92195,8.8
5920,September 1985,California,19742000,13024685,66.0,12099311,61.3,925374,7.1
5921,September 1985,Colorado,2392000,1709944,71.5,1603416,67.0,106528,6.2
5922,September 1985,Connecticut,2474000,1714893,69.3,1636644,66.2,78249,4.6
5923,September 1985,Delaware,473000,319352,67.5,304188,64.3,15164,4.7
5924,September 1985,District of Columbia,483000,322383,66.7,296873,61.5,25510,7.9
5925,September 1985,Florida,8964000,5358773,59.8,5043444,56.3,315329,5.9
5926,September 1985,Georgia,4383000,2891697,66.0,2709357,61.8,182340,6.3
5927,September 1985,Hawaii,733000,481810,65.7,455581,62.2,26229,5.4
5928,September 1985,Idaho,701000,466436,66.5,429433,61.3,37003,7.9
5929,September 1985,Illinois,8641000,5673838,65.7,5152005,59.6,521833,9.2
5930,September 1985,Indiana,4096000,2719130,66.4,2516182,61.4,202948,7.5
5931,September 1985,Iowa,2146000,1412177,65.8,1307089,60.9,105088,7.4
5932,September 1985,Kansas,1795000,1227471,68.4,1164478,64.9,62993,5.1
5933,September 1985,Kentucky,2749000,1694989,61.7,1533437,55.8,161552,9.5
5934,September 1985,Louisiana,3203000,1989049,62.1,1754495,54.8,234554,11.8
5935,September 1985,Maine,876000,551248,62.9,521900,59.6,29348,5.3
5936,September 1985,Maryland,3351000,2286220,68.2,2185031,65.2,101189,4.4
5937,September 1985,Massachusetts,4538000,3052701,67.3,2932914,64.6,119787,3.9
5938,September 1985,Michigan,6806000,4363844,64.1,3937331,57.9,426513,9.8
5939,September 1985,Minnesota,3127000,2235303,71.5,2098976,67.1,136327,6.1
5940,September 1985,Mississippi,1869000,1133079,60.6,1015629,54.3,117450,10.4
5941,September 1985,Missouri,3783000,2475387,65.4,2318381,61.3,157006,6.3
5942,September 1985,Montana,603000,402788,66.8,371784,61.7,31004,7.7
5943,September 1985,Nebraska,1172000,807006,68.9,764231,65.2,42775,5.3
5944,September 1985,Nevada,727000,518315,71.3,479223,65.9,39092,7.5
5945,September 1985,New Hampshire,762000,544496,71.5,525688,69.0,18808,3.5
5946,September 1985,New Jersey,5879000,3851004,65.5,3639399,61.9,211605,5.5
5947,September 1985,New Mexico,1032000,653536,63.3,599327,58.1,54209,8.3
5948,September 1985,New York,13692000,8347996,61.0,7808417,57.0,539579,6.5
5949,September 1985,North Carolina,4687000,3125224,66.7,2963613,63.2,161611,5.2
5950,September 1985,North Dakota,486000,333610,68.6,314615,64.7,18995,5.7
5951,September 1985,Ohio,8081000,5176451,64.1,4708342,58.3,468109,9.0
5952,September 1985,Oklahoma,2404000,1566269,65.2,1455203,60.5,111066,7.1
5953,September 1985,Oregon,2029000,1323584,65.2,1212018,59.7,111566,8.4
5954,September 1985,Pennsylvania,9207000,5564427,60.4,5128349,55.7,436078,7.8
5955,September 1985,Rhode Island,749000,500568,66.8,478734,63.9,21834,4.4
5956,September 1985,South Carolina,2436000,1561212,64.1,1448660,59.5,112552,7.2
5957,September 1985,South Dakota,506000,345239,68.2,328608,64.9,16631,4.8
5958,September 1985,Tennessee,3606000,2256730,62.6,2079978,57.7,176752,7.8
5959,September 1985,Texas,11798000,8035444,68.1,7449910,63.1,585534,7.3
5960,September 1985,Utah,1066000,735929,69.0,692908,65.0,43021,5.8
5961,September 1985,Vermont,403000,281651,69.9,268245,66.6,13406,4.8
5962,September 1985,Virginia,4228000,2862077,67.7,2703772,63.9,158305,5.5
5963,September 1985,Washington,3267000,2103285,64.4,1933461,59.2,169824,8.1
5964,September 1985,West Virginia,1462000,752876,51.5,658182,45.0,94694,12.6
5965,September 1985,Wisconsin,3576000,2379745,66.5,2208047,61.7,171698,7.2
5966,September 1985,Wyoming,358000,252690,70.6,234559,65.5,18131,7.2
5967,October 1985,Alabama,2978000,1808859,60.7,1652051,55.5,156808,8.7
5968,October 1985,Alaska,345000,253571,73.5,228883,66.3,24688,9.7
5969,October 1985,Arizona,2375000,1504897,63.4,1407510,59.3,97387,6.5
5970,October 1985,Arkansas,1751000,1053052,60.1,961075,54.9,91977,8.7
5971,October 1985,California,19775000,13054442,66.0,12141686,61.4,912756,7.0
5972,October 1985,Colorado,2395000,1709530,71.4,1602138,66.9,107392,6.3
5973,October 1985,Connecticut,2475000,1716384,69.3,1641569,66.3,74815,4.4
5974,October 1985,Delaware,474000,319799,67.5,304973,64.3,14826,4.6
5975,October 1985,District of Columbia,483000,322307,66.7,297616,61.6,24691,7.7
5976,October 1985,Florida,8985000,5379940,59.9,5068370,56.4,311570,5.8
5977,October 1985,Georgia,4390000,2897948,66.0,2722035,62.0,175913,6.1
5978,October 1985,Hawaii,734000,483217,65.8,457111,62.3,26106,5.4
5979,October 1985,Idaho,701000,466721,66.6,429326,61.2,37395,8.0
5980,October 1985,Illinois,8645000,5680545,65.7,5164156,59.7,516389,9.1
5981,October 1985,Indiana,4098000,2722189,66.4,2525257,61.6,196932,7.2
5982,October 1985,Iowa,2146000,1416168,66.0,1311325,61.1,104843,7.4
5983,October 1985,Kansas,1797000,1229137,68.4,1165461,64.9,63676,5.2
5984,October 1985,Kentucky,2750000,1696007,61.7,1533343,55.8,162664,9.6
5985,October 1985,Louisiana,3205000,1993046,62.2,1756530,54.8,236516,11.9
5986,October 1985,Maine,877000,552959,63.1,523299,59.7,29660,5.4
5987,October 1985,Maryland,3355000,2290206,68.3,2190602,65.3,99604,4.3
5988,October 1985,Massachusetts,4541000,3055180,67.3,2936024,64.7,119156,3.9
5989,October 1985,Michigan,6811000,4367809,64.1,3953002,58.0,414807,9.5
5990,October 1985,Minnesota,3131000,2237462,71.5,2100633,67.1,136829,6.1
5991,October 1985,Mississippi,1869000,1137078,60.8,1018955,54.5,118123,10.4
5992,October 1985,Missouri,3787000,2486171,65.7,2330929,61.6,155242,6.2
5993,October 1985,Montana,603000,402883,66.8,371566,61.6,31317,7.8
5994,October 1985,Nebraska,1172000,807533,68.9,764468,65.2,43065,5.3
5995,October 1985,Nevada,727000,518850,71.4,480381,66.1,38469,7.4
5996,October 1985,New Hampshire,763000,546524,71.6,528247,69.2,18277,3.3
5997,October 1985,New Jersey,5886000,3862128,65.6,3649022,62.0,213106,5.5
5998,October 1985,New Mexico,1034000,656410,63.5,601975,58.2,54435,8.3
5999,October 1985,New York,13694000,8371636,61.1,7833604,57.2,538032,6.4
6000,October 1985,North Carolina,4691000,3138323,66.9,2980922,63.5,157401,5.0
6001,October 1985,North Dakota,486000,333983,68.7,314817,64.8,19166,5.7
6002,October 1985,Ohio,8083000,5185955,64.2,4722582,58.4,463373,8.9
6003,October 1985,Oklahoma,2406000,1570726,65.3,1458788,60.6,111938,7.1
6004,October 1985,Oregon,2032000,1327002,65.3,1216004,59.8,110998,8.4
6005,October 1985,Pennsylvania,9210000,5576028,60.5,5145446,55.9,430582,7.7
6006,October 1985,Rhode Island,750000,502032,66.9,480564,64.1,21468,4.3
6007,October 1985,South Carolina,2437000,1562889,64.1,1452558,59.6,110331,7.1
6008,October 1985,South Dakota,507000,345241,68.1,328668,64.8,16573,4.8
6009,October 1985,Tennessee,3608000,2262631,62.7,2086632,57.8,175999,7.8
6010,October 1985,Texas,11814000,8044556,68.1,7456083,63.1,588473,7.3
6011,October 1985,Utah,1067000,737899,69.2,695083,65.1,42816,5.8
6012,October 1985,Vermont,403000,282788,70.2,269495,66.9,13293,4.7
6013,October 1985,Virginia,4235000,2864949,67.6,2710655,64.0,154294,5.4
6014,October 1985,Washington,3274000,2111192,64.5,1943051,59.3,168141,8.0
6015,October 1985,West Virginia,1461000,750999,51.4,658702,45.1,92297,12.3
6016,October 1985,Wisconsin,3578000,2384012,66.6,2212203,61.8,171809,7.2
6017,October 1985,Wyoming,358000,252558,70.5,234203,65.4,18355,7.3
6018,November 1985,Alabama,2981000,1816802,60.9,1657844,55.6,158958,8.7
6019,November 1985,Alaska,346000,254325,73.5,229261,66.3,25064,9.9
6020,November 1985,Arizona,2381000,1512378,63.5,1415587,59.5,96791,6.4
6021,November 1985,Arkansas,1753000,1053603,60.1,961859,54.9,91744,8.7
6022,November 1985,California,19808000,13082914,66.0,12181327,61.5,901587,6.9
6023,November 1985,Colorado,2397000,1708654,71.3,1600114,66.8,108540,6.4
6024,November 1985,Connecticut,2477000,1717520,69.3,1645893,66.4,71627,4.2
6025,November 1985,Delaware,475000,320156,67.4,305491,64.3,14665,4.6
6026,November 1985,District of Columbia,482000,322278,66.9,298344,61.9,23934,7.4
6027,November 1985,Florida,9006000,5402174,60.0,5093131,56.6,309043,5.7
6028,November 1985,Georgia,4397000,2904847,66.1,2733776,62.2,171071,5.9
6029,November 1985,Hawaii,736000,484656,65.9,458652,62.3,26004,5.4
6030,November 1985,Idaho,702000,467234,66.6,429374,61.2,37860,8.1
6031,November 1985,Illinois,8649000,5684173,65.7,5174331,59.8,509842,9.0
6032,November 1985,Indiana,4101000,2725510,66.5,2533319,61.8,192191,7.1
6033,November 1985,Iowa,2145000,1419730,66.2,1315259,61.3,104471,7.4
6034,November 1985,Kansas,1799000,1230560,68.4,1166321,64.8,64239,5.2
6035,November 1985,Kentucky,2751000,1696311,61.7,1532800,55.7,163511,9.6
6036,November 1985,Louisiana,3208000,1996035,62.2,1757495,54.8,238540,12.0
6037,November 1985,Maine,878000,554635,63.2,524691,59.8,29944,5.4
6038,November 1985,Maryland,3359000,2294873,68.3,2195980,65.4,98893,4.3
6039,November 1985,Massachusetts,4544000,3056986,67.3,2938430,64.7,118556,3.9
6040,November 1985,Michigan,6816000,4368279,64.1,3965157,58.2,403122,9.2
6041,November 1985,Minnesota,3135000,2238605,71.4,2101827,67.0,136778,6.1
6042,November 1985,Mississippi,1868000,1140481,61.1,1021431,54.7,119050,10.4
6043,November 1985,Missouri,3791000,2495067,65.8,2341297,61.8,153770,6.2
6044,November 1985,Montana,603000,403146,66.9,371533,61.6,31613,7.8
6045,November 1985,Nebraska,1173000,808249,68.9,764922,65.2,43327,5.4
6046,November 1985,Nevada,728000,519395,71.3,481649,66.2,37746,7.3
6047,November 1985,New Hampshire,765000,548755,71.7,530872,69.4,17883,3.3
6048,November 1985,New Jersey,5894000,3871484,65.7,3657059,62.0,214425,5.5
6049,November 1985,New Mexico,1037000,659229,63.6,604261,58.3,54968,8.3
6050,November 1985,New York,13697000,8392584,61.3,7853542,57.3,539042,6.4
6051,November 1985,North Carolina,4695000,3149707,67.1,2994405,63.8,155302,4.9
6052,November 1985,North Dakota,486000,334245,68.8,314911,64.8,19334,5.8
6053,November 1985,Ohio,8085000,5192031,64.2,4736278,58.6,455753,8.8
6054,November 1985,Oklahoma,2409000,1574932,65.4,1461612,60.7,113320,7.2
6055,November 1985,Oregon,2035000,1330406,65.4,1218990,59.9,111416,8.4
6056,November 1985,Pennsylvania,9214000,5586806,60.6,5160582,56.0,426224,7.6
6057,November 1985,Rhode Island,750000,503414,67.1,482218,64.3,21196,4.2
6058,November 1985,South Carolina,2439000,1564686,64.2,1456362,59.7,108324,6.9
6059,November 1985,South Dakota,507000,345461,68.1,328908,64.9,16553,4.8
6060,November 1985,Tennessee,3610000,2268622,62.8,2091668,57.9,176954,7.8
6061,November 1985,Texas,11831000,8052732,68.1,7458747,63.0,593985,7.4
6062,November 1985,Utah,1068000,739677,69.3,697053,65.3,42624,5.8
6063,November 1985,Vermont,404000,283778,70.2,270645,67.0,13133,4.6
6064,November 1985,Virginia,4243000,2867110,67.6,2716573,64.0,150537,5.3
6065,November 1985,Washington,3280000,2120172,64.6,1952881,59.5,167291,7.9
6066,November 1985,West Virginia,1460000,749091,51.3,658807,45.1,90284,12.1
6067,November 1985,Wisconsin,3579000,2387401,66.7,2215889,61.9,171512,7.2
6068,November 1985,Wyoming,358000,252414,70.5,233743,65.3,18671,7.4
6069,December 1985,Alabama,2983000,1825854,61.2,1662698,55.7,163156,8.9
6070,December 1985,Alaska,347000,255089,73.5,229475,66.1,25614,10.0
6071,December 1985,Arizona,2387000,1518986,63.6,1422252,59.6,96734,6.4
6072,December 1985,Arkansas,1754000,1054437,60.1,962854,54.9,91583,8.7
6073,December 1985,California,19841000,13109100,66.1,12214417,61.6,894683,6.8
6074,December 1985,Colorado,2400000,1707249,71.1,1596926,66.5,110323,6.5
6075,December 1985,Connecticut,2478000,1718634,69.4,1649398,66.6,69236,4.0
6076,December 1985,Delaware,475000,320574,67.5,305838,64.4,14736,4.6
6077,December 1985,District of Columbia,482000,322326,66.9,298939,62.0,23387,7.3
6078,December 1985,Florida,9027000,5423608,60.1,5115075,56.7,308533,5.7
6079,December 1985,Georgia,4403000,2912379,66.1,2743713,62.3,168666,5.8
6080,December 1985,Hawaii,737000,486011,65.9,460061,62.4,25950,5.3
6081,December 1985,Idaho,703000,467869,66.6,429603,61.1,38266,8.2
6082,December 1985,Illinois,8653000,5683345,65.7,5180479,59.9,502866,8.8
6083,December 1985,Indiana,4103000,2728807,66.5,2539064,61.9,189743,7.0
6084,December 1985,Iowa,2144000,1422186,66.3,1318208,61.5,103978,7.3
6085,December 1985,Kansas,1802000,1231521,68.3,1166793,64.7,64728,5.3
6086,December 1985,Kentucky,2752000,1695667,61.6,1531740,55.7,163927,9.7
6087,December 1985,Louisiana,3210000,1997044,62.2,1756336,54.7,240708,12.1
6088,December 1985,Maine,878000,555982,63.3,525862,59.9,30120,5.4
6089,December 1985,Maryland,3363000,2300312,68.4,2201194,65.5,99118,4.3
6090,December 1985,Massachusetts,4546000,3057632,67.3,2939468,64.7,118164,3.9
6091,December 1985,Michigan,6821000,4366055,64.0,3971898,58.2,394157,9.0
6092,December 1985,Minnesota,3139000,2238733,71.3,2102634,67.0,136099,6.1
6093,December 1985,Mississippi,1868000,1142960,61.2,1022432,54.7,120528,10.5
6094,December 1985,Missouri,3795000,2500931,65.9,2348419,61.9,152512,6.1
6095,December 1985,Montana,602000,403432,67.0,371592,61.7,31840,7.9
6096,December 1985,Nebraska,1174000,808962,68.9,765484,65.2,43478,5.4
6097,December 1985,Nevada,729000,520026,71.3,483113,66.3,36913,7.1
6098,December 1985,New Hampshire,767000,550979,71.8,533343,69.5,17636,3.2
6099,December 1985,New Jersey,5902000,3877359,65.7,3662704,62.1,214655,5.5
6100,December 1985,New Mexico,1040000,661728,63.6,605882,58.3,55846,8.4
6101,December 1985,New York,13699000,8407813,61.4,7865100,57.4,542713,6.5
6102,December 1985,North Carolina,4700000,3157694,67.2,3001657,63.9,156037,4.9
6103,December 1985,North Dakota,486000,334380,68.8,314848,64.8,19532,5.8
6104,December 1985,Ohio,8086000,5194640,64.2,4747435,58.7,447205,8.6
6105,December 1985,Oklahoma,2411000,1578634,65.5,1463097,60.7,115537,7.3
6106,December 1985,Oregon,2038000,1333529,65.4,1220823,59.9,112706,8.5
6107,December 1985,Pennsylvania,9218000,5595027,60.7,5171834,56.1,423193,7.6
6108,December 1985,Rhode Island,751000,504553,67.2,483576,64.4,20977,4.2
6109,December 1985,South Carolina,2441000,1567224,64.2,1460112,59.8,107112,6.8
6110,December 1985,South Dakota,508000,345862,68.1,329301,64.8,16561,4.8
6111,December 1985,Tennessee,3612000,2273440,62.9,2094288,58.0,179152,7.9
6112,December 1985,Texas,11847000,8060684,68.0,7455924,62.9,604760,7.5
6113,December 1985,Utah,1069000,741225,69.3,698754,65.4,42471,5.7
6114,December 1985,Vermont,404000,284590,70.4,271632,67.2,12958,4.6
6115,December 1985,Virginia,4250000,2868354,67.5,2720520,64.0,147834,5.2
6116,December 1985,Washington,3287000,2129788,64.8,1962228,59.7,167560,7.9
6117,December 1985,West Virginia,1460000,747358,51.2,658421,45.1,88937,11.9
6118,December 1985,Wisconsin,3581000,2389538,66.7,2218489,62.0,171049,7.2
6119,December 1985,Wyoming,358000,252388,70.5,233228,65.1,19160,7.6
6120,January 1986,Alabama,2986000,1835544,61.5,1666502,55.8,169042,9.2
6121,January 1986,Alaska,348000,255807,73.5,229520,66.0,26287,10.3
6122,January 1986,Arizona,2393000,1525219,63.7,1427668,59.7,97551,6.4
6123,January 1986,Arkansas,1755000,1055616,60.1,964069,54.9,91547,8.7
6124,January 1986,California,19875000,13135610,66.1,12241894,61.6,893716,6.8
6125,January 1986,Colorado,2402000,1705714,71.0,1592932,66.3,112782,6.6
6126,January 1986,Connecticut,2479000,1720198,69.4,1652326,66.7,67872,3.9
6127,January 1986,Delaware,476000,321191,67.5,306162,64.3,15029,4.7
6128,January 1986,District of Columbia,482000,322370,66.9,299215,62.1,23155,7.2
6129,January 1986,Florida,9048000,5445124,60.2,5134526,56.7,310598,5.7
6130,January 1986,Georgia,4410000,2921207,66.2,2752295,62.4,168912,5.8
6131,January 1986,Hawaii,738000,487195,66.0,461290,62.5,25905,5.3
6132,January 1986,Idaho,704000,468618,66.6,430002,61.1,38616,8.2
6133,January 1986,Illinois,8657000,5680413,65.6,5183639,59.9,496774,8.7
6134,January 1986,Indiana,4105000,2732320,66.6,2542470,61.9,189850,6.9
6135,January 1986,Iowa,2143000,1423682,66.4,1320280,61.6,103402,7.3
6136,January 1986,Kansas,1804000,1232217,68.3,1166969,64.7,65248,5.3
6137,January 1986,Kentucky,2754000,1694300,61.5,1530581,55.6,163719,9.7
6138,January 1986,Louisiana,3212000,1995970,62.1,1752884,54.6,243086,12.2
6139,January 1986,Maine,879000,556936,63.4,526779,59.9,30157,5.4
6140,January 1986,Maryland,3368000,2306741,68.5,2206594,65.5,100147,4.3
6141,January 1986,Massachusetts,4549000,3057504,67.2,2939318,64.6,118186,3.9
6142,January 1986,Michigan,6827000,4363943,63.9,3974008,58.2,389935,8.9
6143,January 1986,Minnesota,3142000,2238380,71.2,2103352,66.9,135028,6.0
6144,January 1986,Mississippi,1868000,1144726,61.3,1021952,54.7,122774,10.7
6145,January 1986,Missouri,3799000,2504672,65.9,2352727,61.9,151945,6.1
6146,January 1986,Montana,602000,403638,67.0,371635,61.7,32003,7.9
6147,January 1986,Nebraska,1175000,809486,68.9,766095,65.2,43391,5.4
6148,January 1986,Nevada,730000,520848,71.3,484868,66.4,35980,6.9
6149,January 1986,New Hampshire,769000,553047,71.9,535551,69.6,17496,3.2
6150,January 1986,New Jersey,5910000,3880270,65.7,3666645,62.0,213625,5.5
6151,January 1986,New Mexico,1043000,663747,63.6,606705,58.2,57042,8.6
6152,January 1986,New York,13701000,8417695,61.4,7869249,57.4,548446,6.5
6153,January 1986,North Carolina,4704000,3162187,67.2,3002923,63.8,159264,5.0
6154,January 1986,North Dakota,486000,334399,68.8,314626,64.7,19773,5.9
6155,January 1986,Ohio,8088000,5196110,64.2,4755702,58.8,440408,8.5
6156,January 1986,Oklahoma,2413000,1582106,65.6,1463317,60.6,118789,7.5
6157,January 1986,Oregon,2040000,1336556,65.5,1222027,59.9,114529,8.6
6158,January 1986,Pennsylvania,9222000,5600759,60.7,5179670,56.2,421089,7.5
6159,January 1986,Rhode Island,751000,505425,67.3,484624,64.5,20801,4.1
6160,January 1986,South Carolina,2443000,1570659,64.3,1463898,59.9,106761,6.8
6161,January 1986,South Dakota,508000,346371,68.2,329819,64.9,16552,4.8
6162,January 1986,Tennessee,3614000,2277258,63.0,2095266,58.0,181992,8.0
6163,January 1986,Texas,11863000,8071823,68.0,7449243,62.8,622580,7.7
6164,January 1986,Utah,1071000,742617,69.3,700200,65.4,42417,5.7
6165,January 1986,Vermont,404000,285258,70.6,272460,67.4,12798,4.5
6166,January 1986,Virginia,4257000,2869914,67.4,2723281,64.0,146633,5.1
6167,January 1986,Washington,3293000,2140036,65.0,1971086,59.9,168950,7.9
6168,January 1986,West Virginia,1459000,746191,51.1,657753,45.1,88438,11.9
6169,January 1986,Wisconsin,3582000,2391224,66.8,2220350,62.0,170874,7.1
6170,January 1986,Wyoming,359000,252531,70.3,232733,64.8,19798,7.8
6171,February 1986,Alabama,2989000,1845204,61.7,1669612,55.9,175592,9.5
6172,February 1986,Alaska,348000,256388,73.7,229408,65.9,26980,10.5
6173,February 1986,Arizona,2399000,1532054,63.9,1432753,59.7,99301,6.5
6174,February 1986,Arkansas,1756000,1057189,60.2,965599,55.0,91590,8.7
6175,February 1986,California,19908000,13166354,66.1,12268403,61.6,897951,6.8
6176,February 1986,Colorado,2405000,1704681,70.9,1588996,66.1,115685,6.8
6177,February 1986,Connecticut,2481000,1722739,69.4,1655250,66.7,67489,3.9
6178,February 1986,Delaware,477000,322043,67.5,306593,64.3,15450,4.8
6179,February 1986,District of Columbia,481000,322323,67.0,299063,62.2,23260,7.2
6180,February 1986,Florida,9070000,5468761,60.3,5154089,56.8,314672,5.8
6181,February 1986,Georgia,4417000,2932132,66.4,2760804,62.5,171328,5.8
6182,February 1986,Hawaii,739000,488185,66.1,462386,62.6,25799,5.3
6183,February 1986,Idaho,704000,469461,66.7,430576,61.2,38885,8.3
6184,February 1986,Illinois,8662000,5679345,65.6,5186958,59.9,492387,8.7
6185,February 1986,Indiana,4108000,2736355,66.6,2544685,61.9,191670,7.0
6186,February 1986,Iowa,2142000,1424801,66.5,1322128,61.7,102673,7.2
6187,February 1986,Kansas,1806000,1233128,68.3,1167227,64.6,65901,5.3
6188,February 1986,Kentucky,2755000,1692826,61.4,1530010,55.5,162816,9.6
6189,February 1986,Louisiana,3215000,1993298,62.0,1747825,54.4,245473,12.3
6190,February 1986,Maine,880000,557685,63.4,527617,60.0,30068,5.4
6191,February 1986,Maryland,3372000,2314154,68.6,2212545,65.6,101609,4.4
6192,February 1986,Massachusetts,4552000,3057365,67.2,2938739,64.6,118626,3.9
6193,February 1986,Michigan,6832000,4364701,63.9,3974203,58.2,390498,8.9
6194,February 1986,Minnesota,3146000,2238201,71.1,2104493,66.9,133708,6.0
6195,February 1986,Mississippi,1868000,1146273,61.4,1020606,54.6,125667,11.0
6196,February 1986,Missouri,3804000,2508546,65.9,2355882,61.9,152664,6.1
6197,February 1986,Montana,602000,403697,67.1,371582,61.7,32115,8.0
6198,February 1986,Nebraska,1176000,809692,68.9,766689,65.2,43003,5.3
6199,February 1986,Nevada,731000,521965,71.4,486954,66.6,35011,6.7
6200,February 1986,New Hampshire,771000,554862,72.0,537513,69.7,17349,3.1
6201,February 1986,New Jersey,5917000,3882076,65.6,3670682,62.0,211394,5.4
6202,February 1986,New Mexico,1045000,665364,63.7,606844,58.1,58520,8.8
6203,February 1986,New York,13704000,8425409,61.5,7870640,57.4,554769,6.6
6204,February 1986,North Carolina,4708000,3164766,67.2,3000899,63.7,163867,5.2
6205,February 1986,North Dakota,487000,334299,68.6,314278,64.5,20021,6.0
6206,February 1986,Ohio,8090000,5198954,64.3,4762363,58.9,436591,8.4
6207,February 1986,Oklahoma,2415000,1585586,65.7,1462942,60.6,122644,7.7
6208,February 1986,Oregon,2043000,1339833,65.6,1223619,59.9,116214,8.7
6209,February 1986,Pennsylvania,9225000,5604615,60.8,5185709,56.2,418906,7.5
6210,February 1986,Rhode Island,752000,506117,67.3,485456,64.6,20661,4.1
6211,February 1986,South Carolina,2445000,1574605,64.4,1467795,60.0,106810,6.8
6212,February 1986,South Dakota,509000,346915,68.2,330437,64.9,16478,4.7
6213,February 1986,Tennessee,3616000,2281145,63.1,2096470,58.0,184675,8.1
6214,February 1986,Texas,11880000,8089551,68.1,7442856,62.7,646695,8.0
6215,February 1986,Utah,1072000,743937,69.4,701486,65.4,42451,5.7
6216,February 1986,Vermont,405000,285847,70.6,273186,67.5,12661,4.4
6217,February 1986,Virginia,4265000,2873454,67.4,2726934,63.9,146520,5.1
6218,February 1986,Washington,3300000,2151279,65.2,1979949,60.0,171330,8.0
6219,February 1986,West Virginia,1458000,745799,51.2,657153,45.1,88646,11.9
6220,February 1986,Wisconsin,3584000,2393610,66.8,2222514,62.0,171096,7.1
6221,February 1986,Wyoming,359000,252845,70.4,232288,64.7,20557,8.1
6222,March 1986,Alabama,2991000,1853642,62.0,1672315,55.9,181327,9.8
6223,March 1986,Alaska,349000,256756,73.6,229143,65.7,27613,10.8
6224,March 1986,Arizona,2405000,1540035,64.0,1438266,59.8,101769,6.6
6225,March 1986,Arkansas,1757000,1059144,60.3,967562,55.1,91582,8.6
6226,March 1986,California,19941000,13202326,66.2,12297776,61.7,904550,6.9
6227,March 1986,Colorado,2408000,1704190,70.8,1585654,65.8,118536,7.0
6228,March 1986,Connecticut,2482000,1726294,69.6,1658559,66.8,67735,3.9
6229,March 1986,Delaware,477000,323029,67.7,307203,64.4,15826,4.9
6230,March 1986,District of Columbia,481000,322154,67.0,298533,62.1,23621,7.3
6231,March 1986,Florida,9091000,5495022,60.4,5175740,56.9,319282,5.8
6232,March 1986,Georgia,4423000,2944969,66.6,2770127,62.6,174842,5.9
6233,March 1986,Hawaii,740000,488997,66.1,463409,62.6,25588,5.2
6234,March 1986,Idaho,705000,470342,66.7,431229,61.2,39113,8.3
6235,March 1986,Illinois,8666000,5682147,65.6,5192710,59.9,489437,8.6
6236,March 1986,Indiana,4110000,2740634,66.7,2546898,62.0,193736,7.1
6237,March 1986,Iowa,2141000,1426203,66.6,1324348,61.9,101855,7.1
6238,March 1986,Kansas,1809000,1234509,68.2,1167893,64.6,66616,5.4
6239,March 1986,Kentucky,2756000,1691680,61.4,1530443,55.5,161237,9.5
6240,March 1986,Louisiana,3217000,1989343,61.8,1741918,54.1,247425,12.4
6241,March 1986,Maine,880000,558502,63.5,528564,60.1,29938,5.4
6242,March 1986,Maryland,3376000,2322024,68.8,2218984,65.7,103040,4.4
6243,March 1986,Massachusetts,4554000,3057678,67.1,2938338,64.5,119340,3.9
6244,March 1986,Michigan,6837000,4368816,63.9,3975145,58.1,393671,9.0
6245,March 1986,Minnesota,3150000,2238312,71.1,2106346,66.9,131966,5.9
6246,March 1986,Mississippi,1868000,1147887,61.5,1019061,54.6,128826,11.2
6247,March 1986,Missouri,3808000,2514032,66.0,2359477,62.0,154555,6.1
6248,March 1986,Montana,601000,403483,67.1,371321,61.8,32162,8.0
6249,March 1986,Nebraska,1177000,809504,68.8,767171,65.2,42333,5.2
6250,March 1986,Nevada,732000,523454,71.5,489330,66.8,34124,6.5
6251,March 1986,New Hampshire,773000,556481,72.0,539371,69.8,17110,3.1
6252,March 1986,New Jersey,5925000,3884745,65.6,3676134,62.0,208611,5.4
6253,March 1986,New Mexico,1048000,666911,63.6,606731,57.9,60180,9.0
6254,March 1986,New York,13706000,8432690,61.5,7873009,57.4,559681,6.6
6255,March 1986,North Carolina,4713000,3166969,67.2,2998760,63.6,168209,5.3
6256,March 1986,North Dakota,487000,334081,68.6,313856,64.4,20225,6.1
6257,March 1986,Ohio,8091000,5203986,64.3,4768519,58.9,435467,8.4
6258,March 1986,Oklahoma,2417000,1589317,65.8,1462444,60.5,126873,8.0
6259,March 1986,Oregon,2046000,1343714,65.7,1226421,59.9,117293,8.7
6260,March 1986,Pennsylvania,9229000,5607284,60.8,5191744,56.3,415540,7.4
6261,March 1986,Rhode Island,752000,506761,67.4,486187,64.7,20574,4.1
6262,March 1986,South Carolina,2447000,1578305,64.5,1471764,60.1,106541,6.8
6263,March 1986,South Dakota,510000,347378,68.1,331035,64.9,16343,4.7
6264,March 1986,Tennessee,3618000,2285419,63.2,2099360,58.0,186059,8.1
6265,March 1986,Texas,11896000,8113485,68.2,7440192,62.5,673293,8.3
6266,March 1986,Utah,1073000,745252,69.5,702619,65.5,42633,5.7
6267,March 1986,Vermont,405000,286424,70.7,273876,67.6,12548,4.4
6268,March 1986,Virginia,4272000,2879582,67.4,2732916,64.0,146666,5.1
6269,March 1986,Washington,3307000,2163281,65.4,1988933,60.1,174348,8.1
6270,March 1986,West Virginia,1458000,746142,51.2,656898,45.1,89244,12.0
6271,March 1986,Wisconsin,3585000,2397257,66.9,2225732,62.1,171525,7.2
6272,March 1986,Wyoming,359000,253139,70.5,231809,64.6,21330,8.4
6273,April 1986,Alabama,2994000,1859859,62.1,1674799,55.9,185060,10.0
6274,April 1986,Alaska,350000,256853,73.4,228708,65.3,28145,11.0
6275,April 1986,Arizona,2410000,1548830,64.3,1444229,59.9,104601,6.8
6276,April 1986,Arkansas,1758000,1061433,60.4,969969,55.2,91464,8.6
6277,April 1986,California,19974000,13242420,66.3,12331995,61.7,910425,6.9
6278,April 1986,Colorado,2410000,1703943,70.7,1582888,65.7,121055,7.1
6279,April 1986,Connecticut,2484000,1730424,69.7,1662309,66.9,68115,3.9
6280,April 1986,Delaware,478000,323971,67.8,307998,64.4,15973,4.9
6281,April 1986,District of Columbia,480000,321953,67.1,297865,62.1,24088,7.5
6282,April 1986,Florida,9112000,5523419,60.6,5200285,57.1,323134,5.9
6283,April 1986,Georgia,4430000,2958672,66.8,2780482,62.8,178190,6.0
6284,April 1986,Hawaii,741000,489659,66.1,464417,62.7,25242,5.2
6285,April 1986,Idaho,706000,471258,66.8,431831,61.2,39427,8.4
6286,April 1986,Illinois,8670000,5689055,65.6,5201679,60.0,487376,8.6
6287,April 1986,Indiana,4113000,2744818,66.7,2549939,62.0,194879,7.1
6288,April 1986,Iowa,2141000,1428188,66.7,1327153,62.0,101035,7.1
6289,April 1986,Kansas,1811000,1236410,68.3,1169125,64.6,67285,5.4
6290,April 1986,Kentucky,2757000,1691021,61.3,1531815,55.6,159206,9.4
6291,April 1986,Louisiana,3220000,1984730,61.6,1735753,53.9,248977,12.5
6292,April 1986,Maine,881000,559548,63.5,529685,60.1,29863,5.3
6293,April 1986,Maryland,3380000,2329883,68.9,2225635,65.8,104248,4.5
6294,April 1986,Massachusetts,4557000,3058795,67.1,2938532,64.5,120263,3.9
6295,April 1986,Michigan,6842000,4375290,63.9,3978398,58.1,396892,9.1
6296,April 1986,Minnesota,3154000,2238762,71.0,2108933,66.9,129829,5.8
6297,April 1986,Mississippi,1868000,1149681,61.5,1017962,54.5,131719,11.5
6298,April 1986,Missouri,3812000,2521488,66.1,2364414,62.0,157074,6.2
6299,April 1986,Montana,601000,402947,67.0,370816,61.7,32131,8.0
6300,April 1986,Nebraska,1177000,808949,68.7,767443,65.2,41506,5.1
6301,April 1986,Nevada,732000,525289,71.8,491905,67.2,33384,6.4
6302,April 1986,New Hampshire,774000,558036,72.1,541281,69.9,16755,3.0
6303,April 1986,New Jersey,5933000,3889198,65.6,3683160,62.1,206038,5.3
6304,April 1986,New Mexico,1051000,668639,63.6,606811,57.7,61828,9.2
6305,April 1986,New York,13709000,8439440,61.6,7878431,57.5,561009,6.6
6306,April 1986,North Carolina,4717000,3170017,67.2,2998782,63.6,171235,5.4
6307,April 1986,North Dakota,487000,333759,68.5,313427,64.4,20332,6.1
6308,April 1986,Ohio,8093000,5211057,64.4,4774741,59.0,436316,8.4
6309,April 1986,Oklahoma,2419000,1593111,65.9,1461900,60.4,131211,8.2
6310,April 1986,Oregon,2049000,1348299,65.8,1230788,60.1,117511,8.7
6311,April 1986,Pennsylvania,9233000,5609660,60.8,5199076,56.3,410584,7.3
6312,April 1986,Rhode Island,753000,507451,67.4,486878,64.7,20573,4.1
6313,April 1986,South Carolina,2448000,1581199,64.6,1475607,60.3,105592,6.7
6314,April 1986,South Dakota,510000,347747,68.2,331552,65.0,16195,4.7
6315,April 1986,Tennessee,3620000,2289988,63.3,2104302,58.1,185686,8.1
6316,April 1986,Texas,11913000,8141016,68.3,7442665,62.5,698351,8.6
6317,April 1986,Utah,1074000,746690,69.5,703592,65.5,43098,5.8
6318,April 1986,Vermont,406000,287045,70.7,274585,67.6,12460,4.3
6319,April 1986,Virginia,4280000,2888250,67.5,2741398,64.1,146852,5.1
6320,April 1986,Washington,3313000,2175146,65.7,1997783,60.3,177363,8.2
6321,April 1986,West Virginia,1457000,747055,51.3,657109,45.1,89946,12.0
6322,April 1986,Wisconsin,3587000,2402224,67.0,2230251,62.2,171973,7.2
6323,April 1986,Wyoming,359000,253220,70.5,231233,64.4,21987,8.7
6324,May 1986,Alabama,2997000,1863428,62.2,1677189,56.0,186239,10.0
6325,May 1986,Alaska,351000,256643,73.1,228115,65.0,28528,11.1
6326,May 1986,Arizona,2416000,1557429,64.5,1450171,60.0,107258,6.9
6327,May 1986,Arkansas,1760000,1064009,60.5,972781,55.3,91228,8.6
6328,May 1986,California,20008000,13283132,66.4,12370849,61.8,912283,6.9
6329,May 1986,Colorado,2413000,1703874,70.6,1580475,65.5,123399,7.2
6330,May 1986,Connecticut,2485000,1734409,69.8,1666225,67.1,68184,3.9
6331,May 1986,Delaware,479000,324704,67.8,308917,64.5,15787,4.9
6332,May 1986,District of Columbia,480000,321870,67.1,297373,62.0,24497,7.6
6333,May 1986,Florida,9133000,5552663,60.8,5227208,57.2,325455,5.9
6334,May 1986,Georgia,4437000,2971919,67.0,2791498,62.9,180421,6.1
6335,May 1986,Hawaii,743000,490212,66.0,465458,62.6,24754,5.0
6336,May 1986,Idaho,707000,472109,66.8,432274,61.1,39835,8.4
6337,May 1986,Illinois,8674000,5697582,65.7,5213107,60.1,484475,8.5
6338,May 1986,Indiana,4115000,2748303,66.8,2554060,62.1,194243,7.1
6339,May 1986,Iowa,2140000,1430478,66.8,1330511,62.2,99967,7.0
6340,May 1986,Kansas,1813000,1238575,68.3,1170836,64.6,67739,5.5
6341,May 1986,Kentucky,2759000,1690864,61.3,1533703,55.6,157161,9.3
6342,May 1986,Louisiana,3222000,1980197,61.5,1729887,53.7,250310,12.6
6343,May 1986,Maine,882000,560781,63.6,530923,60.2,29858,5.3
6344,May 1986,Maryland,3385000,2337458,69.1,2232232,65.9,105226,4.5
6345,May 1986,Massachusetts,4560000,3060840,67.1,2939658,64.5,121182,4.0
6346,May 1986,Michigan,6848000,4382522,64.0,3984511,58.2,398011,9.1
6347,May 1986,Minnesota,3158000,2239294,70.9,2112158,66.9,127136,5.7
6348,May 1986,Mississippi,1867000,1151577,61.7,1017818,54.5,133759,11.6
6349,May 1986,Missouri,3816000,2530161,66.3,2370549,62.1,159612,6.3
6350,May 1986,Montana,601000,402226,66.9,370203,61.6,32023,8.0
6351,May 1986,Nebraska,1178000,808155,68.6,767507,65.2,40648,5.0
6352,May 1986,Nevada,733000,527355,71.9,494554,67.5,32801,6.2
6353,May 1986,New Hampshire,776000,559566,72.1,543287,70.0,16279,2.9
6354,May 1986,New Jersey,5941000,3895193,65.6,3691502,62.1,203691,5.2
6355,May 1986,New Mexico,1054000,670447,63.6,607233,57.6,63214,9.4
6356,May 1986,New York,13711000,8444060,61.6,7887486,57.5,556574,6.6
6357,May 1986,North Carolina,4721000,3174187,67.2,3001746,63.6,172441,5.4
6358,May 1986,North Dakota,487000,333322,68.4,313055,64.3,20267,6.1
6359,May 1986,Ohio,8095000,5218611,64.5,4781117,59.1,437494,8.4
6360,May 1986,Oklahoma,2422000,1596114,65.9,1461233,60.3,134881,8.5
6361,May 1986,Oregon,2052000,1353211,65.9,1236609,60.3,116602,8.6
6362,May 1986,Pennsylvania,9237000,5611341,60.7,5207664,56.4,403677,7.2
6363,May 1986,Rhode Island,753000,508198,67.5,487564,64.7,20634,4.1
6364,May 1986,South Carolina,2450000,1583273,64.6,1479377,60.4,103896,6.6
6365,May 1986,South Dakota,511000,348103,68.1,332034,65.0,16069,4.6
6366,May 1986,Tennessee,3622000,2294387,63.3,2110478,58.3,183909,8.0
6367,May 1986,Texas,11929000,8167653,68.5,7449293,62.4,718360,8.8
6368,May 1986,Utah,1076000,748297,69.5,704412,65.5,43885,5.9
6369,May 1986,Vermont,406000,287741,70.9,275346,67.8,12395,4.3
6370,May 1986,Virginia,4287000,2898522,67.6,2751591,64.2,146931,5.1
6371,May 1986,Washington,3320000,2185655,65.8,2006008,60.4,179647,8.2
6372,May 1986,West Virginia,1456000,748151,51.4,657735,45.2,90416,12.1
6373,May 1986,Wisconsin,3588000,2407960,67.1,2235920,62.3,172040,7.1
6374,May 1986,Wyoming,360000,252949,70.3,230483,64.0,22466,8.9
6375,June 1986,Alabama,2999000,1865072,62.2,1679604,56.0,185468,9.9
6376,June 1986,Alaska,351000,256173,73.0,227464,64.8,28709,11.2
6377,June 1986,Arizona,2422000,1565280,64.6,1455778,60.1,109502,7.0
6378,June 1986,Arkansas,1761000,1066875,60.6,975864,55.4,91011,8.5
6379,June 1986,California,20041000,13323161,66.5,12413356,61.9,909805,6.8
6380,June 1986,Colorado,2415000,1704135,70.6,1578275,65.4,125860,7.4
6381,June 1986,Connecticut,2487000,1737807,69.9,1670037,67.2,67770,3.9
6382,June 1986,Delaware,479000,325165,67.9,309896,64.7,15269,4.7
6383,June 1986,District of Columbia,479000,322052,67.2,297291,62.1,24761,7.7
6384,June 1986,Florida,9154000,5582265,61.0,5255586,57.4,326679,5.9
6385,June 1986,Georgia,4443000,2984353,67.2,2802716,63.1,181637,6.1
6386,June 1986,Hawaii,744000,490708,66.0,466585,62.7,24123,4.9
6387,June 1986,Idaho,707000,472785,66.9,432479,61.2,40306,8.5
6388,June 1986,Illinois,8678000,5705168,65.7,5225438,60.2,479730,8.4
6389,June 1986,Indiana,4118000,2751063,66.8,2559147,62.1,191916,7.0
6390,June 1986,Iowa,2139000,1432778,67.0,1334330,62.4,98448,6.9
6391,June 1986,Kansas,1816000,1240832,68.3,1172973,64.6,67859,5.5
6392,June 1986,Kentucky,2760000,1691417,61.3,1535581,55.6,155836,9.2
6393,June 1986,Louisiana,3225000,1976666,61.3,1724854,53.5,251812,12.7
6394,June 1986,Maine,882000,562111,63.7,532210,60.3,29901,5.3
6395,June 1986,Maryland,3389000,2344812,69.2,2238570,66.1,106242,4.5
6396,June 1986,Massachusetts,4562000,3063832,67.2,2941973,64.5,121859,4.0
6397,June 1986,Michigan,6853000,4390064,64.1,3993605,58.3,396459,9.0
6398,June 1986,Minnesota,3162000,2239974,70.8,2115745,66.9,124229,5.5
6399,June 1986,Mississippi,1867000,1153622,61.8,1018766,54.6,134856,11.7
6400,June 1986,Missouri,3820000,2538899,66.5,2377254,62.2,161645,6.4
6401,June 1986,Montana,600000,401498,66.9,369607,61.6,31891,7.9
6402,June 1986,Nebraska,1179000,807406,68.5,767473,65.1,39933,4.9
6403,June 1986,Nevada,734000,529545,72.1,497187,67.7,32358,6.1
6404,June 1986,New Hampshire,778000,561011,72.1,545301,70.1,15710,2.8
6405,June 1986,New Jersey,5948000,3902319,65.6,3701090,62.2,201229,5.2
6406,June 1986,New Mexico,1056000,672088,63.6,607924,57.6,64164,9.5
6407,June 1986,New York,13714000,8446309,61.6,7899992,57.6,546317,6.5
6408,June 1986,North Carolina,4726000,3179631,67.3,3007319,63.6,172312,5.4
6409,June 1986,North Dakota,487000,332781,68.3,312768,64.2,20013,6.0
6410,June 1986,Ohio,8096000,5225407,64.5,4787755,59.1,437652,8.4
6411,June 1986,Oklahoma,2424000,1597734,65.9,1460482,60.3,137252,8.6
6412,June 1986,Oregon,2055000,1357931,66.1,1243343,60.5,114588,8.4
6413,June 1986,Pennsylvania,9240000,5611807,60.7,5216660,56.5,395147,7.0
6414,June 1986,Rhode Island,754000,508984,67.5,488253,64.8,20731,4.1
6415,June 1986,South Carolina,2452000,1585147,64.6,1483256,60.5,101891,6.4
6416,June 1986,South Dakota,511000,348557,68.2,332567,65.1,15990,4.6
6417,June 1986,Tennessee,3624000,2298881,63.4,2116923,58.4,181958,7.9
6418,June 1986,Texas,11946000,8190515,68.6,7458133,62.4,732382,8.9
6419,June 1986,Utah,1077000,749990,69.6,705076,65.5,44914,6.0
6420,June 1986,Vermont,407000,288515,70.9,276165,67.9,12350,4.3
6421,June 1986,Virginia,4295000,2909636,67.7,2762560,64.3,147076,5.1
6422,June 1986,Washington,3326000,2193991,66.0,2013106,60.5,180885,8.2
6423,June 1986,West Virginia,1456000,749108,51.4,658653,45.2,90455,12.1
6424,June 1986,Wisconsin,3590000,2413963,67.2,2242536,62.5,171427,7.1
6425,June 1986,Wyoming,360000,252277,70.1,229511,63.8,22766,9.0
6426,July 1986,Alabama,3002000,1865890,62.2,1682106,56.0,183784,9.8
6427,July 1986,Alaska,352000,255539,72.6,226857,64.4,28682,11.2
6428,July 1986,Arizona,2428000,1571912,64.7,1460653,60.2,111259,7.1
6429,July 1986,Arkansas,1762000,1069837,60.7,978900,55.6,90937,8.5
6430,July 1986,California,20074000,13362255,66.6,12457662,62.1,904593,6.8
6431,July 1986,Colorado,2418000,1704815,70.5,1576033,65.2,128782,7.6
6432,July 1986,Connecticut,2488000,1740598,70.0,1673664,67.3,66934,3.8
6433,July 1986,Delaware,480000,325419,67.8,310902,64.8,14517,4.5
6434,July 1986,District of Columbia,479000,322548,67.3,297656,62.1,24892,7.7
6435,July 1986,Florida,9175000,5611622,61.2,5284285,57.6,327337,5.8
6436,July 1986,Georgia,4450000,2995503,67.3,2813645,63.2,181858,6.1
6437,July 1986,Hawaii,745000,491234,65.9,467834,62.8,23400,4.8
6438,July 1986,Idaho,708000,473288,66.8,432581,61.1,40707,8.6
6439,July 1986,Illinois,8682000,5709817,65.8,5236739,60.3,473078,8.3
6440,July 1986,Indiana,4120000,2753281,66.8,2564731,62.3,188550,6.8
6441,July 1986,Iowa,2138000,1434996,67.1,1338385,62.6,96611,6.7
6442,July 1986,Kansas,1818000,1243055,68.4,1175539,64.7,67516,5.4
6443,July 1986,Kentucky,2761000,1692518,61.3,1536947,55.7,155571,9.2
6444,July 1986,Louisiana,3227000,1974549,61.2,1720897,53.3,253652,12.8
6445,July 1986,Maine,883000,563434,63.8,533480,60.4,29954,5.3
6446,July 1986,Maryland,3393000,2352063,69.3,2244501,66.2,107562,4.6
6447,July 1986,Massachusetts,4565000,3067367,67.2,2945347,64.5,122020,4.0
6448,July 1986,Michigan,6858000,4398077,64.1,4005267,58.4,392810,8.9
6449,July 1986,Minnesota,3166000,2240640,70.8,2119226,66.9,121414,5.4
6450,July 1986,Mississippi,1867000,1155549,61.9,1020472,54.7,135077,11.7
6451,July 1986,Missouri,3824000,2546201,66.6,2383756,62.3,162445,6.4
6452,July 1986,Montana,600000,400922,66.8,369129,61.5,31793,7.9
6453,July 1986,Nebraska,1180000,806992,68.4,767519,65.0,39473,4.9
6454,July 1986,Nevada,735000,531760,72.3,499747,68.0,32013,6.0
6455,July 1986,New Hampshire,780000,562321,72.1,547190,70.2,15131,2.7
6456,July 1986,New Jersey,5956000,3909517,65.6,3711542,62.3,197975,5.1
6457,July 1986,New Mexico,1059000,673452,63.6,608798,57.5,64654,9.6
6458,July 1986,New York,13716000,8446807,61.6,7914993,57.7,531814,6.3
6459,July 1986,North Carolina,4730000,3186050,67.4,3014524,63.7,171526,5.4
6460,July 1986,North Dakota,487000,332201,68.2,312566,64.2,19635,5.9
6461,July 1986,Ohio,8098000,5230665,64.6,4794538,59.2,436127,8.3
6462,July 1986,Oklahoma,2426000,1597776,65.9,1459705,60.2,138071,8.6
6463,July 1986,Oregon,2058000,1361896,66.2,1250316,60.8,111580,8.2
6464,July 1986,Pennsylvania,9244000,5610545,60.7,5224859,56.5,385686,6.9
6465,July 1986,Rhode Island,754000,509756,67.6,488902,64.8,20854,4.1
6466,July 1986,South Carolina,2454000,1587320,64.7,1487267,60.6,100053,6.3
6467,July 1986,South Dakota,512000,349121,68.2,333189,65.1,15932,4.6
6468,July 1986,Tennessee,3626000,2303603,63.5,2122964,58.5,180639,7.8
6469,July 1986,Texas,11962000,8208764,68.6,7467166,62.4,741598,9.0
6470,July 1986,Utah,1078000,751605,69.7,705609,65.5,45996,6.1
6471,July 1986,Vermont,407000,289338,71.1,277020,68.1,12318,4.3
6472,July 1986,Virginia,4302000,2920677,67.9,2773420,64.5,147257,5.0
6473,July 1986,Washington,3333000,2200050,66.0,2018872,60.6,181178,8.2
6474,July 1986,West Virginia,1455000,749617,51.5,659683,45.3,89934,12.0
6475,July 1986,Wisconsin,3591000,2419959,67.4,2249901,62.7,170058,7.0
6476,July 1986,Wyoming,360000,251286,69.8,228366,63.4,22920,9.1
6477,August 1986,Alabama,3005000,1866749,62.1,1684502,56.1,182247,9.8
6478,August 1986,Alaska,351000,254832,72.6,226327,64.5,28505,11.2
6479,August 1986,Arizona,2436000,1576976,64.7,1464410,60.1,112566,7.1
6480,August 1986,Arkansas,1763000,1072517,60.8,981419,55.7,91098,8.5
6481,August 1986,California,20113000,13399406,66.6,12500320,62.2,899086,6.7
6482,August 1986,Colorado,2420000,1705738,70.5,1573519,65.0,132219,7.8
6483,August 1986,Connecticut,2490000,1742970,70.0,1676906,67.3,66064,3.8
6484,August 1986,Delaware,481000,325610,67.7,311947,64.9,13663,4.2
6485,August 1986,District of Columbia,479000,323311,67.5,298356,62.3,24955,7.7
6486,August 1986,Florida,9197000,5638832,61.3,5311110,57.7,327722,5.8
6487,August 1986,Georgia,4459000,3004898,67.4,2823399,63.3,181499,6.0
6488,August 1986,Hawaii,747000,491871,65.8,469228,62.8,22643,4.6
6489,August 1986,Idaho,708000,473482,66.9,432613,61.1,40869,8.6
6490,August 1986,Illinois,8687000,5710298,65.7,5244677,60.4,465621,8.2
6491,August 1986,Indiana,4123000,2754982,66.8,2569524,62.3,185458,6.7
6492,August 1986,Iowa,2138000,1437022,67.2,1342275,62.8,94747,6.6
6493,August 1986,Kansas,1819000,1245175,68.5,1178299,64.8,66876,5.4
6494,August 1986,Kentucky,2762000,1693921,61.3,1537520,55.7,156401,9.2
6495,August 1986,Louisiana,3224000,1973394,61.2,1717687,53.3,255707,13.0
6496,August 1986,Maine,884000,564603,63.9,534672,60.5,29931,5.3
6497,August 1986,Maryland,3398000,2359212,69.4,2249978,66.2,109234,4.6
6498,August 1986,Massachusetts,4567000,3070548,67.2,2949087,64.6,121461,4.0
6499,August 1986,Michigan,6865000,4406967,64.2,4018578,58.5,388389,8.8
6500,August 1986,Minnesota,3169000,2241200,70.7,2122289,67.0,118911,5.3
6501,August 1986,Mississippi,1868000,1156901,61.9,1022203,54.7,134698,11.6
6502,August 1986,Missouri,3828000,2551008,66.6,2388993,62.4,162015,6.4
6503,August 1986,Montana,600000,400575,66.8,368827,61.5,31748,7.9
6504,August 1986,Nebraska,1180000,806994,68.4,767731,65.1,39263,4.9
6505,August 1986,Nevada,738000,533935,72.3,502164,68.0,31771,6.0
6506,August 1986,New Hampshire,782000,563545,72.1,548908,70.2,14637,2.6
6507,August 1986,New Jersey,5960000,3915232,65.7,3721829,62.4,193403,4.9
6508,August 1986,New Mexico,1060000,674509,63.6,609705,57.5,64804,9.6
6509,August 1986,New York,13720000,8446010,61.6,7929866,57.8,516144,6.1
6510,August 1986,North Carolina,4737000,3192884,67.4,3022092,63.8,170792,5.3
6511,August 1986,North Dakota,487000,331664,68.1,312443,64.2,19221,5.8
6512,August 1986,Ohio,8104000,5234520,64.6,4800869,59.2,433651,8.3
6513,August 1986,Oklahoma,2424000,1596175,65.8,1458727,60.2,137448,8.6
6514,August 1986,Oregon,2060000,1364901,66.3,1256932,61.0,107969,7.9
6515,August 1986,Pennsylvania,9249000,5607318,60.6,5231224,56.6,376094,6.7
6516,August 1986,Rhode Island,755000,510511,67.6,489552,64.8,20959,4.1
6517,August 1986,South Carolina,2458000,1590061,64.7,1491353,60.7,98708,6.2
6518,August 1986,South Dakota,512000,349700,68.3,333832,65.2,15868,4.5
6519,August 1986,Tennessee,3631000,2308069,63.6,2127854,58.6,180215,7.8
6520,August 1986,Texas,11967000,8222473,68.7,7474205,62.5,748268,9.1
6521,August 1986,Utah,1079000,752995,69.8,705981,65.4,47014,6.2
6522,August 1986,Vermont,408000,290163,71.1,277869,68.1,12294,4.2
6523,August 1986,Virginia,4310000,2930592,68.0,2783108,64.6,147484,5.0
6524,August 1986,Washington,3339000,2204227,66.0,2023287,60.6,180940,8.2
6525,August 1986,West Virginia,1455000,749556,51.5,660598,45.4,88958,11.9
6526,August 1986,Wisconsin,3593000,2425781,67.5,2257539,62.8,168242,6.9
6527,August 1986,Wyoming,359000,250139,69.7,227149,63.3,22990,9.2
6528,September 1986,Alabama,3008000,1868065,62.1,1686660,56.1,181405,9.7
6529,September 1986,Alaska,351000,254106,72.4,225868,64.3,28238,11.1
6530,September 1986,Arizona,2443000,1580687,64.7,1467127,60.1,113560,7.2
6531,September 1986,Arkansas,1765000,1074516,60.9,983134,55.7,91382,8.5
6532,September 1986,California,20153000,13434273,66.7,12539608,62.2,894665,6.7
6533,September 1986,Colorado,2422000,1706673,70.5,1570968,64.9,135705,8.0
6534,September 1986,Connecticut,2491000,1745142,70.1,1679566,67.4,65576,3.8
6535,September 1986,Delaware,482000,325898,67.6,313087,65.0,12811,3.9
6536,September 1986,District of Columbia,478000,324223,67.8,299228,62.6,24995,7.7
6537,September 1986,Florida,9219000,5662822,61.4,5334942,57.9,327880,5.8
6538,September 1986,Georgia,4469000,3012625,67.4,2831569,63.4,181056,6.0
6539,September 1986,Hawaii,748000,492678,65.9,470798,62.9,21880,4.4
6540,September 1986,Idaho,709000,473197,66.7,432492,61.0,40705,8.6
6541,September 1986,Illinois,8693000,5707015,65.7,5248652,60.4,458363,8.0
6542,September 1986,Indiana,4127000,2756033,66.8,2572241,62.3,183792,6.7
6543,September 1986,Iowa,2138000,1438831,67.3,1345876,63.0,92955,6.5
6544,September 1986,Kansas,1820000,1247202,68.5,1180934,64.9,66268,5.3
6545,September 1986,Kentucky,2763000,1695384,61.4,1537446,55.6,157938,9.3
6546,September 1986,Louisiana,3222000,1972463,61.2,1714963,53.2,257500,13.1
6547,September 1986,Maine,886000,565566,63.8,535801,60.5,29765,5.3
6548,September 1986,Maryland,3403000,2366101,69.5,2255197,66.3,110904,4.7
6549,September 1986,Massachusetts,4569000,3073020,67.3,2952811,64.6,120209,3.9
6550,September 1986,Michigan,6872000,4417173,64.3,4033131,58.7,384042,8.7
6551,September 1986,Minnesota,3171000,2242163,70.7,2125033,67.0,117130,5.2
6552,September 1986,Mississippi,1869000,1157479,61.9,1023383,54.8,134096,11.6
6553,September 1986,Missouri,3832000,2553464,66.6,2392534,62.4,160930,6.3
6554,September 1986,Montana,600000,400463,66.7,368712,61.5,31751,7.9
6555,September 1986,Nebraska,1180000,807324,68.4,768097,65.1,39227,4.9
6556,September 1986,Nevada,740000,536132,72.5,504422,68.2,31710,5.9
6557,September 1986,New Hampshire,784000,564784,72.0,550530,70.2,14254,2.5
6558,September 1986,New Jersey,5964000,3918501,65.7,3731117,62.6,187384,4.8
6559,September 1986,New Mexico,1062000,675214,63.6,610492,57.5,64722,9.6
6560,September 1986,New York,13725000,8444650,61.5,7942965,57.9,501685,5.9
6561,September 1986,North Carolina,4743000,3199621,67.5,3029368,63.9,170253,5.3
6562,September 1986,North Dakota,486000,331235,68.2,312393,64.3,18842,5.7
6563,September 1986,Ohio,8109000,5237875,64.6,4806816,59.3,431059,8.2
6564,September 1986,Oklahoma,2422000,1593218,65.8,1457452,60.2,135766,8.5
6565,September 1986,Oregon,2062000,1366971,66.3,1262965,61.2,104006,7.6
6566,September 1986,Pennsylvania,9254000,5602920,60.5,5236147,56.6,366773,6.5
6567,September 1986,Rhode Island,756000,511186,67.6,490279,64.9,20907,4.1
6568,September 1986,South Carolina,2461000,1593479,64.7,1495476,60.8,98003,6.2
6569,September 1986,South Dakota,513000,350210,68.3,334427,65.2,15783,4.5
6570,September 1986,Tennessee,3636000,2311871,63.6,2131669,58.6,180202,7.8
6571,September 1986,Texas,11972000,8232427,68.8,7478872,62.5,753555,9.2
6572,September 1986,Utah,1080000,754158,69.8,706173,65.4,47985,6.4
6573,September 1986,Vermont,408000,290930,71.3,278673,68.3,12257,4.2
6574,September 1986,Virginia,4318000,2939004,68.1,2791427,64.6,147577,5.0
6575,September 1986,Washington,3344000,2207212,66.0,2026699,60.6,180513,8.2
6576,September 1986,West Virginia,1454000,748972,51.5,661313,45.5,87659,11.7
6577,September 1986,Wisconsin,3596000,2431554,67.6,2265129,63.0,166425,6.8
6578,September 1986,Wyoming,358000,249011,69.6,225974,63.1,23037,9.3
6579,October 1986,Alabama,3011000,1869560,62.1,1688677,56.1,180883,9.7
6580,October 1986,Alaska,350000,253389,72.4,225446,64.4,27943,11.0
6581,October 1986,Arizona,2451000,1583506,64.6,1469452,60.0,114054,7.2
6582,October 1986,Arkansas,1766000,1075532,60.9,983989,55.7,91543,8.5
6583,October 1986,California,20192000,13467014,66.7,12576773,62.3,890241,6.6
6584,October 1986,Colorado,2423000,1707589,70.5,1568878,64.7,138711,8.1
6585,October 1986,Connecticut,2493000,1747144,70.1,1681630,67.5,65514,3.7
6586,October 1986,Delaware,483000,326397,67.6,314369,65.1,12028,3.7
6587,October 1986,District of Columbia,478000,325166,68.0,300186,62.8,24980,7.7
6588,October 1986,Florida,9242000,5684194,61.5,5356396,58.0,327798,5.8
6589,October 1986,Georgia,4478000,3019038,67.4,2838409,63.4,180629,6.0
6590,October 1986,Hawaii,750000,493747,65.8,472571,63.0,21176,4.3
6591,October 1986,Idaho,709000,472474,66.6,432182,61.0,40292,8.5
6592,October 1986,Illinois,8698000,5701150,65.5,5249593,60.4,451557,7.9
6593,October 1986,Indiana,4130000,2755968,66.7,2572543,62.3,183425,6.7
6594,October 1986,Iowa,2138000,1440648,67.4,1349433,63.1,91215,6.3
6595,October 1986,Kansas,1822000,1249029,68.6,1183287,64.9,65742,5.3
6596,October 1986,Kentucky,2765000,1696525,61.4,1537114,55.6,159411,9.4
6597,October 1986,Louisiana,3219000,1971070,61.2,1712681,53.2,258389,13.1
6598,October 1986,Maine,887000,566437,63.9,537003,60.5,29434,5.2
6599,October 1986,Maryland,3408000,2372440,69.6,2260426,66.3,112014,4.7
6600,October 1986,Massachusetts,4571000,3075023,67.3,2956547,64.7,118476,3.9
6601,October 1986,Michigan,6878000,4429069,64.4,4048887,58.9,380182,8.6
6602,October 1986,Minnesota,3174000,2244249,70.7,2127796,67.0,116453,5.2
6603,October 1986,Mississippi,1870000,1157388,61.9,1023979,54.8,133409,11.5
6604,October 1986,Missouri,3836000,2554476,66.6,2394716,62.4,159760,6.3
6605,October 1986,Montana,599000,400509,66.9,368776,61.6,31733,7.9
6606,October 1986,Nebraska,1180000,807842,68.5,768567,65.1,39275,4.9
6607,October 1986,Nevada,743000,538345,72.5,506518,68.2,31827,5.9
6608,October 1986,New Hampshire,786000,566126,72.0,552177,70.3,13949,2.5
6609,October 1986,New Jersey,5969000,3920018,65.7,3739322,62.6,180696,4.6
6610,October 1986,New Mexico,1063000,675547,63.6,611102,57.5,64445,9.5
6611,October 1986,New York,13729000,8443246,61.5,7954497,57.9,488749,5.8
6612,October 1986,North Carolina,4750000,3205992,67.5,3036560,63.9,169432,5.3
6613,October 1986,North Dakota,486000,330936,68.1,312414,64.3,18522,5.6
6614,October 1986,Ohio,8115000,5241897,64.6,4813354,59.3,428543,8.2
6615,October 1986,Oklahoma,2419000,1589436,65.7,1456060,60.2,133376,8.4
6616,October 1986,Oregon,2065000,1368363,66.3,1268455,61.4,99908,7.3
6617,October 1986,Pennsylvania,9258000,5598221,60.5,5240637,56.6,357584,6.4
6618,October 1986,Rhode Island,756000,511690,67.7,491052,65.0,20638,4.0
6619,October 1986,South Carolina,2465000,1597469,64.8,1499541,60.8,97928,6.1
6620,October 1986,South Dakota,513000,350595,68.3,334943,65.3,15652,4.5
6621,October 1986,Tennessee,3641000,2314879,63.6,2135378,58.6,179501,7.8
6622,October 1986,Texas,11977000,8239269,68.8,7482823,62.5,756446,9.2
6623,October 1986,Utah,1080000,755182,69.9,706256,65.4,48926,6.5
6624,October 1986,Vermont,409000,291584,71.3,279403,68.3,12181,4.2
6625,October 1986,Virginia,4327000,2946198,68.1,2798980,64.7,147218,5.0
6626,October 1986,Washington,3350000,2209785,66.0,2029809,60.6,179976,8.1
6627,October 1986,West Virginia,1454000,748103,51.5,661894,45.5,86209,11.5
6628,October 1986,Wisconsin,3598000,2437665,67.8,2272732,63.2,164933,6.8
6629,October 1986,Wyoming,357000,248066,69.5,224940,63.0,23126,9.3
6630,November 1986,Alabama,3014000,1870468,62.1,1690601,56.1,179867,9.6
6631,November 1986,Alaska,349000,252647,72.4,225005,64.5,27642,10.9
6632,November 1986,Arizona,2458000,1585859,64.5,1471883,59.9,113976,7.2
6633,November 1986,Arkansas,1768000,1075571,60.8,984089,55.7,91482,8.5
6634,November 1986,California,20232000,13497905,66.7,12612458,62.3,885447,6.6
6635,November 1986,Colorado,2425000,1708212,70.4,1567304,64.6,140908,8.2
6636,November 1986,Connecticut,2494000,1748830,70.1,1683095,67.5,65735,3.8
6637,November 1986,Delaware,484000,327149,67.6,315771,65.2,11378,3.5
6638,November 1986,District of Columbia,477000,326097,68.4,301259,63.2,24838,7.6
6639,November 1986,Florida,9264000,5703078,61.6,5375664,58.0,327414,5.7
6640,November 1986,Georgia,4487000,3024296,67.4,2843859,63.4,180437,6.0
6641,November 1986,Hawaii,751000,495151,65.9,474575,63.2,20576,4.2
6642,November 1986,Idaho,709000,471506,66.5,431696,60.9,39810,8.4
6643,November 1986,Illinois,8703000,5694792,65.4,5248165,60.3,446627,7.8
6644,November 1986,Indiana,4134000,2754784,66.6,2570884,62.2,183900,6.7
6645,November 1986,Iowa,2138000,1442433,67.5,1352935,63.3,89498,6.2
6646,November 1986,Kansas,1823000,1250557,68.6,1185161,65.0,65396,5.2
6647,November 1986,Kentucky,2766000,1697044,61.4,1536758,55.6,160286,9.4
6648,November 1986,Louisiana,3216000,1968654,61.2,1710555,53.2,258099,13.1
6649,November 1986,Maine,888000,567339,63.9,538447,60.6,28892,5.1
6650,November 1986,Maryland,3413000,2378003,69.7,2265681,66.4,112322,4.7
6651,November 1986,Massachusetts,4573000,3076627,67.3,2960006,64.7,116621,3.8
6652,November 1986,Michigan,6885000,4441925,64.5,4064697,59.0,377228,8.5
6653,November 1986,Minnesota,3177000,2247864,70.8,2130920,67.1,116944,5.2
6654,November 1986,Mississippi,1871000,1156620,61.8,1024132,54.7,132488,11.5
6655,November 1986,Missouri,3839000,2555217,66.6,2395568,62.4,159649,6.2
6656,November 1986,Montana,599000,400617,66.9,368990,61.6,31627,7.9
6657,November 1986,Nebraska,1180000,808228,68.5,769064,65.2,39164,4.8
6658,November 1986,Nevada,745000,540451,72.5,508401,68.2,32050,5.9
6659,November 1986,New Hampshire,788000,567651,72.0,553991,70.3,13660,2.4
6660,November 1986,New Jersey,5973000,3921104,65.6,3746391,62.7,174713,4.5
6661,November 1986,New Mexico,1064000,675513,63.5,611488,57.5,64025,9.5
6662,November 1986,New York,13734000,8441569,61.5,7964163,58.0,477406,5.7
6663,November 1986,North Carolina,4757000,3212057,67.5,3043762,64.0,168295,5.2
6664,November 1986,North Dakota,486000,330737,68.1,312489,64.3,18248,5.5
6665,November 1986,Ohio,8120000,5246652,64.6,4820393,59.4,426259,8.1
6666,November 1986,Oklahoma,2417000,1585249,65.6,1454526,60.2,130723,8.2
6667,November 1986,Oregon,2067000,1369348,66.2,1273261,61.6,96087,7.0
6668,November 1986,Pennsylvania,9263000,5594274,60.4,5245382,56.6,348892,6.2
6669,November 1986,Rhode Island,757000,512105,67.6,491851,65.0,20254,4.0
6670,November 1986,South Carolina,2469000,1601905,64.9,1503370,60.9,98535,6.2
6671,November 1986,South Dakota,513000,350865,68.4,335383,65.4,15482,4.4
6672,November 1986,Tennessee,3646000,2316913,63.5,2139086,58.7,177827,7.7
6673,November 1986,Texas,11982000,8243079,68.8,7486771,62.5,756308,9.2
6674,November 1986,Utah,1081000,756101,69.9,706307,65.3,49794,6.6
6675,November 1986,Vermont,409000,292067,71.4,280046,68.5,12021,4.1
6676,November 1986,Virginia,4335000,2952375,68.1,2805955,64.7,146420,5.0
6677,November 1986,Washington,3355000,2212127,65.9,2032834,60.6,179293,8.1
6678,November 1986,West Virginia,1453000,747255,51.4,662371,45.6,84884,11.4
6679,November 1986,Wisconsin,3600000,2444104,67.9,2280362,63.3,163742,6.7
6680,November 1986,Wyoming,356000,247277,69.5,224065,62.9,23212,9.4
6681,December 1986,Alabama,3017000,1870743,62.0,1692995,56.1,177748,9.5
6682,December 1986,Alaska,349000,251869,72.2,224534,64.3,27335,10.9
6683,December 1986,Arizona,2466000,1588732,64.4,1475400,59.8,113332,7.1
6684,December 1986,Arkansas,1769000,1075353,60.8,984174,55.6,91179,8.5
6685,December 1986,California,20271000,13530074,66.7,12651094,62.4,878980,6.5
6686,December 1986,Colorado,2427000,1708562,70.4,1566539,64.5,142023,8.3
6687,December 1986,Connecticut,2496000,1750240,70.1,1684322,67.5,65918,3.8
6688,December 1986,Delaware,485000,328117,67.7,317216,65.4,10901,3.3
6689,December 1986,District of Columbia,477000,327012,68.6,302515,63.4,24497,7.5
6690,December 1986,Florida,9286000,5721916,61.6,5395551,58.1,326365,5.7
6691,December 1986,Georgia,4496000,3028875,67.4,2848931,63.4,179944,5.9
6692,December 1986,Hawaii,753000,497006,66.0,476855,63.3,20151,4.1
6693,December 1986,Idaho,709000,470594,66.4,431241,60.8,39353,8.4
6694,December 1986,Illinois,8708000,5692168,65.4,5247800,60.3,444368,7.8
6695,December 1986,Indiana,4137000,2753727,66.6,2569234,62.1,184493,6.7
6696,December 1986,Iowa,2138000,1444307,67.6,1356540,63.4,87767,6.1
6697,December 1986,Kansas,1824000,1251910,68.6,1186782,65.1,65128,5.2
6698,December 1986,Kentucky,2767000,1697192,61.3,1536955,55.5,160237,9.4
6699,December 1986,Louisiana,3214000,1965512,61.2,1709120,53.2,256392,13.0
6700,December 1986,Maine,889000,568506,63.9,540359,60.8,28147,5.0
6701,December 1986,Maryland,3418000,2382870,69.7,2271062,66.4,111808,4.7
6702,December 1986,Massachusetts,4575000,3078412,67.3,2963616,64.8,114796,3.7
6703,December 1986,Michigan,6892000,4455307,64.6,4080356,59.2,374951,8.4
6704,December 1986,Minnesota,3179000,2252896,70.9,2134747,67.2,118149,5.2
6705,December 1986,Mississippi,1872000,1155479,61.7,1024482,54.7,130997,11.3
6706,December 1986,Missouri,3843000,2557702,66.6,2396542,62.4,161160,6.3
6707,December 1986,Montana,599000,400742,66.9,369385,61.7,31357,7.8
6708,December 1986,Nebraska,1180000,808303,68.5,769557,65.2,38746,4.8
6709,December 1986,Nevada,748000,542455,72.5,510104,68.2,32351,6.0
6710,December 1986,New Hampshire,790000,569426,72.1,556072,70.4,13354,2.3
6711,December 1986,New Jersey,5977000,3923674,65.6,3753531,62.8,170143,4.3
6712,December 1986,New Mexico,1065000,675264,63.4,611771,57.4,63493,9.4
6713,December 1986,New York,13738000,8440883,61.4,7974393,58.0,466490,5.5
6714,December 1986,North Carolina,4763000,3218607,67.6,3052084,64.1,166523,5.2
6715,December 1986,North Dakota,485000,330601,68.2,312624,64.5,17977,5.4
6716,December 1986,Ohio,8126000,5251892,64.6,4828506,59.4,423386,8.1
6717,December 1986,Oklahoma,2415000,1581313,65.5,1453231,60.2,128082,8.1
6718,December 1986,Oregon,2069000,1370331,66.2,1277503,61.7,92828,6.8
6719,December 1986,Pennsylvania,9268000,5593262,60.4,5252364,56.7,340898,6.1
6720,December 1986,Rhode Island,758000,512557,67.6,492677,65.0,19880,3.9
6721,December 1986,South Carolina,2472000,1606745,65.0,1507155,61.0,99590,6.2
6722,December 1986,South Dakota,513000,351102,68.4,335805,65.5,15297,4.4
6723,December 1986,Tennessee,3651000,2319077,63.5,2143655,58.7,175422,7.6
6724,December 1986,Texas,11987000,8245423,68.8,7493133,62.5,752290,9.1
6725,December 1986,Utah,1082000,756954,70.0,706497,65.3,50457,6.7
6726,December 1986,Vermont,410000,292403,71.3,280636,68.4,11767,4.0
6727,December 1986,Virginia,4343000,2958913,68.1,2813609,64.8,145304,4.9
6728,December 1986,Washington,3361000,2214912,65.9,2036554,60.6,178358,8.1
6729,December 1986,West Virginia,1453000,746686,51.4,662834,45.6,83852,11.2
6730,December 1986,Wisconsin,3602000,2450978,68.0,2288620,63.5,162358,6.6
6731,December 1986,Wyoming,355000,246539,69.4,223362,62.9,23177,9.4
6732,January 1987,Alabama,3021000,1870191,61.9,1696143,56.1,174048,9.3
6733,January 1987,Alaska,348000,251134,72.2,224053,64.4,27081,10.8
6734,January 1987,Arizona,2473000,1592550,64.4,1480457,59.9,112093,7.0
6735,January 1987,Arkansas,1771000,1075607,60.7,984919,55.6,90688,8.4
6736,January 1987,California,20311000,13564202,66.8,12695031,62.5,869171,6.4
6737,January 1987,Colorado,2429000,1708446,70.3,1566483,64.5,141963,8.3
6738,January 1987,Connecticut,2498000,1751385,70.1,1685682,67.5,65703,3.8
6739,January 1987,Delaware,486000,329158,67.7,318561,65.5,10597,3.2
6740,January 1987,District of Columbia,477000,327947,68.8,304008,63.7,23939,7.3
6741,January 1987,Florida,9308000,5741724,61.7,5417583,58.2,324141,5.6
6742,January 1987,Georgia,4506000,3032615,67.3,2854287,63.3,178328,5.9
6743,January 1987,Hawaii,754000,499299,66.2,479342,63.6,19957,4.0
6744,January 1987,Idaho,710000,469937,66.2,431044,60.7,38893,8.3
6745,January 1987,Illinois,8714000,5695609,65.4,5251060,60.3,444549,7.8
6746,January 1987,Indiana,4141000,2753688,66.5,2568971,62.0,184717,6.7
6747,January 1987,Iowa,2138000,1446169,67.6,1360090,63.6,86079,6.0
6748,January 1987,Kansas,1825000,1253152,68.7,1188413,65.1,64739,5.2
6749,January 1987,Kentucky,2768000,1697184,61.3,1538007,55.6,159177,9.4
6750,January 1987,Louisiana,3211000,1961955,61.1,1708572,53.2,253383,12.9
6751,January 1987,Maine,891000,570225,64.0,542822,60.9,27403,4.8
6752,January 1987,Maryland,3423000,2387012,69.7,2276457,66.5,110555,4.6
6753,January 1987,Massachusetts,4577000,3080517,67.3,2967597,64.8,112920,3.7
6754,January 1987,Michigan,6899000,4468326,64.8,4095171,59.4,373155,8.4
6755,January 1987,Minnesota,3182000,2258791,71.0,2139276,67.2,119515,5.3
6756,January 1987,Mississippi,1873000,1154133,61.6,1025392,54.7,128741,11.2
6757,January 1987,Missouri,3847000,2562312,66.6,2398743,62.4,163569,6.4
6758,January 1987,Montana,599000,400748,66.9,369831,61.7,30917,7.7
6759,January 1987,Nebraska,1181000,808157,68.4,770009,65.2,38148,4.7
6760,January 1987,Nevada,750000,544410,72.6,511724,68.2,32686,6.0
6761,January 1987,New Hampshire,793000,571376,72.1,558319,70.4,13057,2.3
6762,January 1987,New Jersey,5981000,3928696,65.7,3761477,62.9,167219,4.3
6763,January 1987,New Mexico,1067000,675042,63.3,612119,57.4,62923,9.3
6764,January 1987,New York,13743000,8441771,61.4,7986560,58.1,455211,5.4
6765,January 1987,North Carolina,4770000,3225931,67.6,3061873,64.2,164058,5.1
6766,January 1987,North Dakota,485000,330466,68.1,312797,64.5,17669,5.3
6767,January 1987,Ohio,8132000,5256723,64.6,4837622,59.5,419101,8.0
6768,January 1987,Oklahoma,2413000,1577846,65.4,1452234,60.2,125612,8.0
6769,January 1987,Oregon,2071000,1371494,66.2,1281223,61.9,90271,6.6
6770,January 1987,Pennsylvania,9273000,5596231,60.3,5262464,56.8,333767,6.0
6771,January 1987,Rhode Island,759000,513145,67.6,493519,65.0,19626,3.8
6772,January 1987,South Carolina,2476000,1611747,65.1,1511265,61.0,100482,6.2
6773,January 1987,South Dakota,514000,351321,68.4,336187,65.4,15134,4.3
6774,January 1987,Tennessee,3656000,2322102,63.5,2149329,58.8,172773,7.4
6775,January 1987,Texas,11992000,8247221,68.8,7502987,62.6,744234,9.0
6776,January 1987,Utah,1083000,757654,70.0,706838,65.3,50816,6.7
6777,January 1987,Vermont,410000,292648,71.4,281197,68.6,11451,3.9
6778,January 1987,Virginia,4351000,2966196,68.2,2822324,64.9,143872,4.9
6779,January 1987,Washington,3367000,2218434,65.9,2041461,60.6,176973,8.0
6780,January 1987,West Virginia,1453000,746386,51.4,663288,45.6,83098,11.1
6781,January 1987,Wisconsin,3605000,2458091,68.2,2297535,63.7,160556,6.5
6782,January 1987,Wyoming,354000,245755,69.4,222807,62.9,22948,9.3
6783,February 1987,Alabama,3024000,1868688,61.8,1699848,56.2,168840,9.0
6784,February 1987,Alaska,347000,250445,72.2,223570,64.4,26875,10.7
6785,February 1987,Arizona,2481000,1596953,64.4,1486641,59.9,110312,6.9
6786,February 1987,Arkansas,1772000,1076693,60.8,986658,55.7,90035,8.4
6787,February 1987,California,20350000,13597830,66.8,12742741,62.6,855089,6.3
6788,February 1987,Colorado,2430000,1707370,70.3,1566626,64.5,140744,8.2
6789,February 1987,Connecticut,2499000,1752057,70.1,1687189,67.5,64868,3.7
6790,February 1987,Delaware,486000,330099,67.9,319668,65.8,10431,3.2
6791,February 1987,District of Columbia,476000,328924,69.1,305702,64.2,23222,7.1
6792,February 1987,Florida,9330000,5762017,61.8,5441213,58.3,320804,5.6
6793,February 1987,Georgia,4515000,3035260,67.2,2859866,63.3,175394,5.8
6794,February 1987,Hawaii,756000,501808,66.4,481866,63.7,19942,4.0
6795,February 1987,Idaho,710000,469640,66.1,431226,60.7,38414,8.2
6796,February 1987,Illinois,8719000,5704391,65.4,5258662,60.3,445729,7.8
6797,February 1987,Indiana,4144000,2754579,66.5,2570195,62.0,184384,6.7
6798,February 1987,Iowa,2137000,1447782,67.7,1363187,63.8,84595,5.8
6799,February 1987,Kansas,1826000,1254388,68.7,1190230,65.2,64158,5.1
6800,February 1987,Kentucky,2769000,1696788,61.3,1539760,55.6,157028,9.3
6801,February 1987,Louisiana,3208000,1958125,61.0,1708713,53.3,249412,12.7
6802,February 1987,Maine,892000,572464,64.2,545727,61.2,26737,4.7
6803,February 1987,Maryland,3427000,2390387,69.8,2281543,66.6,108844,4.6
6804,February 1987,Massachusetts,4578000,3082625,67.3,2971673,64.9,110952,3.6
6805,February 1987,Michigan,6906000,4480513,64.9,4107773,59.5,372740,8.3
6806,February 1987,Minnesota,3185000,2264613,71.1,2144173,67.3,120440,5.3
6807,February 1987,Mississippi,1873000,1152490,61.5,1026758,54.8,125732,10.9
6808,February 1987,Missouri,3851000,2568057,66.7,2402010,62.4,166047,6.5
6809,February 1987,Montana,598000,400568,67.0,370177,61.9,30391,7.6
6810,February 1987,Nebraska,1181000,807984,68.4,770454,65.2,37530,4.6
6811,February 1987,Nevada,753000,546364,72.6,513356,68.2,33008,6.0
6812,February 1987,New Hampshire,795000,573492,72.1,560671,70.5,12821,2.2
6813,February 1987,New Jersey,5985000,3935786,65.8,3769893,63.0,165893,4.2
6814,February 1987,New Mexico,1068000,674904,63.2,612647,57.4,62257,9.2
6815,February 1987,New York,13747000,8443503,61.4,7999842,58.2,443661,5.3
6816,February 1987,North Carolina,4777000,3233354,67.7,3072439,64.3,160915,5.0
6817,February 1987,North Dakota,485000,330321,68.1,312999,64.5,17322,5.2
6818,February 1987,Ohio,8137000,5259758,64.6,4846662,59.6,413096,7.9
6819,February 1987,Oklahoma,2410000,1574681,65.3,1451183,60.2,123498,7.8
6820,February 1987,Oregon,2073000,1372834,66.2,1284497,62.0,88337,6.4
6821,February 1987,Pennsylvania,9277000,5603352,60.4,5275398,56.9,327954,5.9
6822,February 1987,Rhode Island,759000,513949,67.7,494435,65.1,19514,3.8
6823,February 1987,South Carolina,2480000,1616157,65.2,1515742,61.1,100415,6.2
6824,February 1987,South Dakota,514000,351516,68.4,336500,65.5,15016,4.3
6825,February 1987,Tennessee,3660000,2325341,63.5,2155482,58.9,169859,7.3
6826,February 1987,Texas,11996000,8248301,68.8,7515113,62.6,733188,8.9
6827,February 1987,Utah,1083000,758012,70.0,707167,65.3,50845,6.7
6828,February 1987,Vermont,411000,292871,71.3,281748,68.6,11123,3.8
6829,February 1987,Virginia,4359000,2973373,68.2,2831540,65.0,141833,4.8
6830,February 1987,Washington,3372000,2222487,65.9,2047619,60.7,174868,7.9
6831,February 1987,West Virginia,1452000,746244,51.4,663714,45.7,82530,11.1
6832,February 1987,Wisconsin,3607000,2464764,68.3,2306605,63.9,158159,6.4
6833,February 1987,Wyoming,353000,244777,69.3,222315,63.0,22462,9.2
6834,March 1987,Alabama,3027000,1867060,61.7,1704066,56.3,162994,8.7
6835,March 1987,Alaska,347000,249757,72.0,223101,64.3,26656,10.7
6836,March 1987,Arizona,2488000,1601894,64.4,1493626,60.0,108268,6.8
6837,March 1987,Arkansas,1773000,1078863,60.8,989465,55.8,89398,8.3
6838,March 1987,California,20389000,13631173,66.9,12793105,62.7,838068,6.1
6839,March 1987,Colorado,2432000,1705414,70.1,1566918,64.4,138496,8.1
6840,March 1987,Connecticut,2501000,1752193,70.1,1688785,67.5,63408,3.6
6841,March 1987,Delaware,487000,330822,67.9,320481,65.8,10341,3.1
6842,March 1987,District of Columbia,476000,329927,69.3,307467,64.6,22460,6.8
6843,March 1987,Florida,9352000,5783688,61.8,5466553,58.5,317135,5.5
6844,March 1987,Georgia,4524000,3037785,67.1,2865939,63.3,171846,5.7
6845,March 1987,Hawaii,757000,504291,66.6,484266,64.0,20025,4.0
6846,March 1987,Idaho,710000,469758,66.2,431843,60.8,37915,8.1
6847,March 1987,Illinois,8724000,5718115,65.5,5271571,60.4,446544,7.8
6848,March 1987,Indiana,4147000,2756325,66.5,2572700,62.0,183625,6.7
6849,March 1987,Iowa,2137000,1449061,67.8,1365733,63.9,83328,5.8
6850,March 1987,Kansas,1827000,1255969,68.7,1192544,65.3,63425,5.0
6851,March 1987,Kentucky,2770000,1696041,61.2,1542036,55.7,154005,9.1
6852,March 1987,Louisiana,3206000,1954763,61.0,1709559,53.3,245204,12.5
6853,March 1987,Maine,893000,575128,64.4,548968,61.5,26160,4.5
6854,March 1987,Maryland,3432000,2393361,69.7,2286279,66.6,107082,4.5
6855,March 1987,Massachusetts,4580000,3084653,67.4,2975903,65.0,108750,3.5
6856,March 1987,Michigan,6913000,4492918,65.0,4118173,59.6,374745,8.3
6857,March 1987,Minnesota,3187000,2269933,71.2,2149085,67.4,120848,5.3
6858,March 1987,Mississippi,1874000,1150909,61.4,1028535,54.9,122374,10.6
6859,March 1987,Missouri,3855000,2574579,66.8,2406356,62.4,168223,6.5
6860,March 1987,Montana,598000,400319,66.9,370414,61.9,29905,7.5
6861,March 1987,Nebraska,1181000,808040,68.4,770989,65.3,37051,4.6
6862,March 1987,Nevada,755000,548395,72.6,515094,68.2,33301,6.1
6863,March 1987,New Hampshire,797000,575769,72.2,563093,70.7,12676,2.2
6864,March 1987,New Jersey,5989000,3944594,65.9,3778805,63.1,165789,4.2
6865,March 1987,New Mexico,1069000,674827,63.1,613367,57.4,61460,9.1
6866,March 1987,New York,13751000,8447195,61.4,8014696,58.3,432499,5.1
6867,March 1987,North Carolina,4783000,3241066,67.8,3083550,64.5,157516,4.9
6868,March 1987,North Dakota,484000,330210,68.2,313243,64.7,16967,5.1
6869,March 1987,Ohio,8143000,5261141,64.6,4855148,59.6,405993,7.7
6870,March 1987,Oklahoma,2408000,1571460,65.3,1450101,60.2,121359,7.7
6871,March 1987,Oregon,2075000,1374540,66.2,1287726,62.1,86814,6.3
6872,March 1987,Pennsylvania,9282000,5614406,60.5,5290540,57.0,323866,5.8
6873,March 1987,Rhode Island,760000,514966,67.8,495471,65.2,19495,3.8
6874,March 1987,South Carolina,2483000,1619217,65.2,1520281,61.2,98936,6.1
6875,March 1987,South Dakota,514000,351713,68.4,336760,65.5,14953,4.3
6876,March 1987,Tennessee,3665000,2328912,63.5,2162002,59.0,166910,7.2
6877,March 1987,Texas,12001000,8251106,68.8,7529047,62.7,722059,8.8
6878,March 1987,Utah,1084000,757953,69.9,707422,65.3,50531,6.7
6879,March 1987,Vermont,411000,293187,71.3,282340,68.7,10847,3.7
6880,March 1987,Virginia,4367000,2980640,68.3,2841415,65.1,139225,4.7
6881,March 1987,Washington,3378000,2227506,65.9,2055422,60.8,172084,7.7
6882,March 1987,West Virginia,1452000,746232,51.4,664154,45.7,82078,11.0
6883,March 1987,Wisconsin,3609000,2470881,68.5,2315586,64.2,155295,6.3
6884,March 1987,Wyoming,352000,243558,69.2,221803,63.0,21755,8.9
6885,April 1987,Alabama,3030000,1866010,61.6,1708792,56.4,157218,8.4
6886,April 1987,Alaska,346000,249060,72.0,222667,64.4,26393,10.6
6887,April 1987,Arizona,2496000,1607041,64.4,1500877,60.1,106164,6.6
6888,April 1987,Arkansas,1775000,1082028,61.0,993106,55.9,88922,8.2
6889,April 1987,California,20429000,13663518,66.9,12843895,62.9,819623,6.0
6890,April 1987,Colorado,2434000,1702816,70.0,1567436,64.4,135380,8.0
6891,April 1987,Connecticut,2502000,1751731,70.0,1690290,67.6,61441,3.5
6892,April 1987,Delaware,488000,331288,67.9,321023,65.8,10265,3.1
6893,April 1987,District of Columbia,475000,330819,69.6,309041,65.1,21778,6.6
6894,April 1987,Florida,9375000,5806469,61.9,5492981,58.6,313488,5.4
6895,April 1987,Georgia,4533000,3041084,67.1,2872499,63.4,168585,5.5
6896,April 1987,Hawaii,759000,506545,66.7,486432,64.1,20113,4.0
6897,April 1987,Idaho,710000,470188,66.2,432835,61.0,37353,7.9
6898,April 1987,Illinois,8729000,5733928,65.7,5288616,60.6,445312,7.8
6899,April 1987,Indiana,4151000,2758217,66.4,2576026,62.1,182191,6.6
6900,April 1987,Iowa,2137000,1449922,67.8,1367710,64.0,82212,5.7
6901,April 1987,Kansas,1829000,1258018,68.8,1195384,65.4,62634,5.0
6902,April 1987,Kentucky,2772000,1694711,61.1,1544420,55.7,150291,8.9
6903,April 1987,Louisiana,3203000,1952009,60.9,1710846,53.4,241163,12.4
6904,April 1987,Maine,894000,578210,64.7,552463,61.8,25747,4.5
6905,April 1987,Maryland,3437000,2396247,69.7,2290794,66.7,105453,4.4
6906,April 1987,Massachusetts,4582000,3086410,67.4,2980370,65.0,106040,3.4
6907,April 1987,Michigan,6920000,4505150,65.1,4127062,59.6,378088,8.4
6908,April 1987,Minnesota,3190000,2274429,71.3,2153645,67.5,120784,5.3
6909,April 1987,Mississippi,1875000,1149702,61.3,1030547,55.0,119155,10.4
6910,April 1987,Missouri,3859000,2580867,66.9,2411616,62.5,169251,6.6
6911,April 1987,Montana,598000,400116,66.9,370554,62.0,29562,7.4
6912,April 1987,Nebraska,1181000,808442,68.5,771660,65.3,36782,4.5
6913,April 1987,Nevada,758000,550579,72.6,517004,68.2,33575,6.1
6914,April 1987,New Hampshire,799000,578069,72.3,565418,70.8,12651,2.2
6915,April 1987,New Jersey,5994000,3954198,66.0,3788007,63.2,166191,4.2
6916,April 1987,New Mexico,1070000,674829,63.1,614243,57.4,60586,9.0
6917,April 1987,New York,13756000,8453220,61.5,8031202,58.4,422018,5.0
6918,April 1987,North Carolina,4790000,3249016,67.8,3094828,64.6,154188,4.7
6919,April 1987,North Dakota,484000,330184,68.2,313530,64.8,16654,5.0
6920,April 1987,Ohio,8148000,5260376,64.6,4862867,59.7,397509,7.6
6921,April 1987,Oklahoma,2406000,1567673,65.2,1449053,60.2,118620,7.6
6922,April 1987,Oregon,2078000,1376832,66.3,1291214,62.1,85618,6.2
6923,April 1987,Pennsylvania,9287000,5627385,60.6,5306236,57.1,321149,5.7
6924,April 1987,Rhode Island,761000,516114,67.8,496616,65.3,19498,3.8
6925,April 1987,South Carolina,2487000,1620542,65.2,1524512,61.3,96030,5.9
6926,April 1987,South Dakota,514000,351917,68.5,336977,65.6,14940,4.2
6927,April 1987,Tennessee,3670000,2332584,63.6,2168640,59.1,163944,7.0
6928,April 1987,Texas,12006000,8256519,68.8,7544050,62.8,712469,8.6
6929,April 1987,Utah,1085000,757391,69.8,707550,65.2,49841,6.6
6930,April 1987,Vermont,412000,293670,71.3,283007,68.7,10663,3.6
6931,April 1987,Virginia,4376000,2987931,68.3,2851944,65.2,135987,4.6
6932,April 1987,Washington,3383000,2233905,66.0,2064955,61.0,168950,7.6
6933,April 1987,West Virginia,1451000,746261,51.4,664613,45.8,81648,10.9
6934,April 1987,Wisconsin,3611000,2476334,68.6,2324183,64.4,152151,6.1
6935,April 1987,Wyoming,351000,242214,69.0,221280,63.0,20934,8.6
6936,May 1987,Alabama,3033000,1865893,61.5,1713872,56.5,152021,8.1
6937,May 1987,Alaska,345000,248425,72.0,222324,64.4,26101,10.5
6938,May 1987,Arizona,2503000,1612060,64.4,1507857,60.2,104203,6.5
6939,May 1987,Arkansas,1776000,1085875,61.1,997253,56.2,88622,8.2
6940,May 1987,California,20468000,13694397,66.9,12892730,63.0,801667,5.9
6941,May 1987,Colorado,2436000,1699924,69.8,1568279,64.4,131645,7.7
6942,May 1987,Connecticut,2504000,1750889,69.9,1691586,67.6,59303,3.4
6943,May 1987,Delaware,489000,331564,67.8,321402,65.7,10162,3.1
6944,May 1987,District of Columbia,475000,331393,69.8,310146,65.3,21247,6.4
6945,May 1987,Florida,9397000,5829436,62.0,5519464,58.7,309972,5.3
6946,May 1987,Georgia,4543000,3045771,67.0,2879325,63.4,166446,5.5
6947,May 1987,Hawaii,760000,508514,66.9,488382,64.3,20132,4.0
6948,May 1987,Idaho,711000,470782,66.2,434022,61.0,36760,7.8
6949,May 1987,Illinois,8735000,5748805,65.8,5307857,60.8,440948,7.7
6950,May 1987,Indiana,4154000,2759439,66.4,2579510,62.1,179929,6.5
6951,May 1987,Iowa,2137000,1450528,67.9,1369214,64.1,81314,5.6
6952,May 1987,Kansas,1830000,1260374,68.9,1198543,65.5,61831,4.9
6953,May 1987,Kentucky,2773000,1692667,61.0,1546565,55.8,146102,8.6
6954,May 1987,Louisiana,3200000,1949705,60.9,1712203,53.5,237502,12.2
6955,May 1987,Maine,896000,581622,64.9,556072,62.1,25550,4.4
6956,May 1987,Maryland,3442000,2399284,69.7,2295266,66.7,104018,4.3
6957,May 1987,Massachusetts,4584000,3087890,67.4,2985087,65.1,102803,3.3
6958,May 1987,Michigan,6926000,4515436,65.2,4134986,59.7,380450,8.4
6959,May 1987,Minnesota,3193000,2277845,71.3,2157685,67.6,120160,5.3
6960,May 1987,Mississippi,1876000,1148973,61.2,1032549,55.0,116424,10.1
6961,May 1987,Missouri,3862000,2585891,67.0,2417322,62.6,168569,6.5
6962,May 1987,Montana,598000,400051,66.9,370640,62.0,29411,7.4
6963,May 1987,Nebraska,1181000,809144,68.5,772464,65.4,36680,4.5
6964,May 1987,Nevada,760000,552882,72.7,519056,68.3,33826,6.1
6965,May 1987,New Hampshire,801000,580311,72.4,567497,70.8,12814,2.2
6966,May 1987,New Jersey,5998000,3963004,66.1,3796703,63.3,166301,4.2
6967,May 1987,New Mexico,1072000,674973,63.0,615293,57.4,59680,8.8
6968,May 1987,New York,13760000,8461149,61.5,8048381,58.5,412768,4.9
6969,May 1987,North Carolina,4797000,3256961,67.9,3106065,64.8,150896,4.6
6970,May 1987,North Dakota,484000,330295,68.2,313863,64.8,16432,5.0
6971,May 1987,Ohio,8154000,5257366,64.5,4870027,59.7,387339,7.4
6972,May 1987,Oklahoma,2404000,1563598,65.0,1448052,60.2,115546,7.4
6973,May 1987,Oregon,2080000,1380160,66.4,1295155,62.3,85005,6.2
6974,May 1987,Pennsylvania,9292000,5641052,60.7,5321707,57.3,319345,5.7
6975,May 1987,Rhode Island,762000,517207,67.9,497761,65.3,19446,3.8
6976,May 1987,South Carolina,2491000,1620510,65.1,1528375,61.4,92135,5.7
6977,May 1987,South Dakota,515000,352167,68.4,337227,65.5,14940,4.2
6978,May 1987,Tennessee,3675000,2335565,63.6,2175109,59.2,160456,6.9
6979,May 1987,Texas,12011000,8263718,68.8,7559154,62.9,704564,8.5
6980,May 1987,Utah,1086000,756360,69.6,707515,65.1,48845,6.5
6981,May 1987,Vermont,412000,294348,71.4,283760,68.9,10588,3.6
6982,May 1987,Virginia,4384000,2994786,68.3,2862637,65.3,132149,4.4
6983,May 1987,Washington,3389000,2241950,66.2,2075922,61.3,166028,7.4
6984,May 1987,West Virginia,1451000,746304,51.4,665095,45.8,81209,10.9
6985,May 1987,Wisconsin,3614000,2480973,68.6,2332016,64.5,148957,6.0
6986,May 1987,Wyoming,350000,240930,68.8,220841,63.1,20089,8.3
6987,June 1987,Alabama,3036000,1866624,61.5,1718838,56.6,147786,7.9
6988,June 1987,Alaska,345000,247922,71.9,222125,64.4,25797,10.4
6989,June 1987,Arizona,2511000,1616703,64.4,1514089,60.3,102614,6.3
6990,June 1987,Arkansas,1778000,1090060,61.3,1001625,56.3,88435,8.1
6991,June 1987,California,20508000,13724674,66.9,12937779,63.1,786895,5.7
6992,June 1987,Colorado,2437000,1697373,69.7,1569583,64.4,127790,7.5
6993,June 1987,Connecticut,2505000,1750085,69.9,1692565,67.6,57520,3.3
6994,June 1987,Delaware,490000,331806,67.7,321771,65.7,10035,3.0
6995,June 1987,District of Columbia,474000,331542,69.9,310683,65.5,20859,6.3
6996,June 1987,Florida,9419000,5851628,62.1,5544714,58.9,306914,5.2
6997,June 1987,Georgia,4552000,3052138,67.1,2886071,63.4,166067,5.4
6998,June 1987,Hawaii,762000,510318,67.0,490263,64.3,20055,3.9
6999,June 1987,Idaho,711000,471343,66.3,435194,61.2,36149,7.7
7000,June 1987,Illinois,8740000,5761512,65.9,5327448,61.0,434064,7.5
7001,June 1987,Indiana,4158000,2759516,66.4,2582590,62.1,176926,6.4
7002,June 1987,Iowa,2137000,1451152,67.9,1370474,64.1,80678,5.6
7003,June 1987,Kansas,1831000,1262784,69.0,1201659,65.6,61125,4.8
7004,June 1987,Kentucky,2774000,1690261,60.9,1548318,55.8,141943,8.4
7005,June 1987,Louisiana,3198000,1947816,60.9,1713254,53.6,234562,12.0
7006,June 1987,Maine,897000,585118,65.2,559571,62.4,25547,4.4
7007,June 1987,Maryland,3447000,2402774,69.7,2299839,66.7,102935,4.3
7008,June 1987,Massachusetts,4586000,3089409,67.4,2990072,65.2,99337,3.2
7009,June 1987,Michigan,6933000,4522235,65.2,4141561,59.7,380674,8.4
7010,June 1987,Minnesota,3195000,2280672,71.4,2161419,67.7,119253,5.2
7011,June 1987,Mississippi,1877000,1148704,61.2,1034382,55.1,114322,10.0
7012,June 1987,Missouri,3866000,2589334,67.0,2422620,62.7,166714,6.4
7013,June 1987,Montana,597000,400185,67.0,370726,62.1,29459,7.4
7014,June 1987,Nebraska,1181000,809956,68.6,773374,65.5,36582,4.5
7015,June 1987,Nevada,763000,555200,72.8,521152,68.3,34048,6.1
7016,June 1987,New Hampshire,803000,582459,72.5,569266,70.9,13193,2.3
7017,June 1987,New Jersey,6002000,3969545,66.1,3803891,63.4,165654,4.2
7018,June 1987,New Mexico,1073000,675225,62.9,616414,57.4,58811,8.7
7019,June 1987,New York,13765000,8471192,61.5,8064923,58.6,406269,4.8
7020,June 1987,North Carolina,4803000,3264822,68.0,3117121,64.9,147701,4.5
7021,June 1987,North Dakota,483000,330555,68.4,314232,65.1,16323,4.9
7022,June 1987,Ohio,8159000,5253495,64.4,4877266,59.8,376229,7.2
7023,June 1987,Oklahoma,2401000,1559562,65.0,1446973,60.3,112589,7.2
7024,June 1987,Oregon,2082000,1384757,66.5,1299680,62.4,85077,6.1
7025,June 1987,Pennsylvania,9296000,5655133,60.8,5336846,57.4,318287,5.6
7026,June 1987,Rhode Island,762000,518016,68.0,498747,65.5,19269,3.7
7027,June 1987,South Carolina,2494000,1620121,65.0,1532025,61.4,88096,5.4
7028,June 1987,South Dakota,515000,352513,68.4,337602,65.6,14911,4.2
7029,June 1987,Tennessee,3680000,2337349,63.5,2181083,59.3,156266,6.7
7030,June 1987,Texas,12016000,8271694,68.8,7573316,63.0,698378,8.4
7031,June 1987,Utah,1086000,755146,69.5,707436,65.1,47710,6.3
7032,June 1987,Vermont,413000,295192,71.5,284592,68.9,10600,3.6
7033,June 1987,Virginia,4392000,3000828,68.3,2872793,65.4,128035,4.3
7034,June 1987,Washington,3394000,2251413,66.3,2087635,61.5,163778,7.3
7035,June 1987,West Virginia,1450000,746475,51.5,665644,45.9,80831,10.8
7036,June 1987,Wisconsin,3616000,2484950,68.7,2338752,64.7,146198,5.9
7037,June 1987,Wyoming,349000,239858,68.7,220558,63.2,19300,8.0
7038,July 1987,Alabama,3039000,1868004,61.5,1723262,56.7,144742,7.7
7039,July 1987,Alaska,344000,247594,72.0,222109,64.6,25485,10.3
7040,July 1987,Arizona,2518000,1621164,64.4,1519613,60.4,101551,6.3
7041,July 1987,Arkansas,1779000,1094380,61.5,1006155,56.6,88225,8.1
7042,July 1987,California,20547000,13755585,66.9,12979060,63.2,776525,5.6
7043,July 1987,Colorado,2439000,1695845,69.5,1571576,64.4,124269,7.3
7044,July 1987,Connecticut,2507000,1749507,69.8,1693131,67.5,56376,3.2
7045,July 1987,Delaware,491000,332207,67.7,322280,65.6,9927,3.0
7046,July 1987,District of Columbia,474000,331290,69.9,310752,65.6,20538,6.2
7047,July 1987,Florida,9441000,5872944,62.2,5568142,59.0,304802,5.2
7048,July 1987,Georgia,4561000,3060334,67.1,2892711,63.4,167623,5.5
7049,July 1987,Hawaii,763000,512112,67.1,492241,64.5,19871,3.9
7050,July 1987,Idaho,711000,471677,66.3,436111,61.3,35566,7.5
7051,July 1987,Illinois,8745000,5771319,66.0,5345431,61.1,425888,7.4
7052,July 1987,Indiana,4161000,2758595,66.3,2585409,62.1,173186,6.3
7053,July 1987,Iowa,2137000,1452027,67.9,1371994,64.2,80033,5.5
7054,July 1987,Kansas,1832000,1264895,69.0,1204409,65.7,60486,4.8
7055,July 1987,Kentucky,2775000,1688204,60.8,1549859,55.9,138345,8.2
7056,July 1987,Louisiana,3195000,1946245,60.9,1713823,53.6,232422,11.9
7057,July 1987,Maine,898000,588366,65.5,562733,62.7,25633,4.4
7058,July 1987,Maryland,3452000,2406978,69.7,2304706,66.8,102272,4.2
7059,July 1987,Massachusetts,4588000,3091639,67.4,2995492,65.3,96147,3.1
7060,July 1987,Michigan,6940000,4525348,65.2,4146560,59.7,378788,8.4
7061,July 1987,Minnesota,3198000,2283641,71.4,2165301,67.7,118340,5.2
7062,July 1987,Mississippi,1878000,1148865,61.2,1036131,55.2,112734,9.8
7063,July 1987,Missouri,3870000,2591288,67.0,2426832,62.7,164456,6.3
7064,July 1987,Montana,597000,400532,67.1,370905,62.1,29627,7.4
7065,July 1987,Nebraska,1181000,810637,68.6,774368,65.6,36269,4.5
7066,July 1987,Nevada,765000,557482,72.9,523232,68.4,34250,6.1
7067,July 1987,New Hampshire,805000,584457,72.6,570762,70.9,13695,2.3
7068,July 1987,New Jersey,6006000,3973396,66.2,3809399,63.4,163997,4.1
7069,July 1987,New Mexico,1074000,675422,62.9,617389,57.5,58033,8.6
7070,July 1987,New York,13769000,8483495,61.6,8080162,58.7,403333,4.8
7071,July 1987,North Carolina,4810000,3272538,68.0,3127793,65.0,144745,4.4
7072,July 1987,North Dakota,483000,330909,68.5,314615,65.1,16294,4.9
7073,July 1987,Ohio,8165000,5250912,64.3,4885876,59.8,365036,7.0
7074,July 1987,Oklahoma,2399000,1555782,64.9,1445758,60.3,110024,7.1
7075,July 1987,Oregon,2084000,1390498,66.7,1304785,62.6,85713,6.2
7076,July 1987,Pennsylvania,9301000,5669405,61.0,5351786,57.5,317619,5.6
7077,July 1987,Rhode Island,763000,518439,67.9,499511,65.5,18928,3.7
7078,July 1987,South Carolina,2498000,1620623,64.9,1535836,61.5,84787,5.2
7079,July 1987,South Dakota,515000,353008,68.5,338170,65.7,14838,4.2
7080,July 1987,Tennessee,3685000,2338095,63.4,2186437,59.3,151658,6.5
7081,July 1987,Texas,12021000,8279326,68.9,7586330,63.1,692996,8.4
7082,July 1987,Utah,1087000,754113,69.4,707529,65.1,46584,6.2
7083,July 1987,Vermont,413000,296116,71.7,285485,69.1,10631,3.6
7084,July 1987,Virginia,4400000,3006399,68.3,2882251,65.5,124148,4.1
7085,July 1987,Washington,3400000,2261750,66.5,2099340,61.7,162410,7.2
7086,July 1987,West Virginia,1450000,746890,51.5,666319,46.0,80571,10.8
7087,July 1987,Wisconsin,3618000,2488812,68.8,2344559,64.8,144253,5.8
7088,July 1987,Wyoming,348000,239053,68.7,220438,63.3,18615,7.8
7089,August 1987,Alabama,3041000,1869646,61.5,1726755,56.8,142891,7.6
7090,August 1987,Alaska,344000,247465,71.9,222316,64.6,25149,10.2
7091,August 1987,Arizona,2523000,1625655,64.4,1524591,60.4,101064,6.2
7092,August 1987,Arkansas,1780000,1098556,61.7,1010550,56.8,88006,8.0
7093,August 1987,California,20585000,13788770,67.0,13017875,63.2,770895,5.6
7094,August 1987,Colorado,2440000,1695738,69.5,1574129,64.5,121609,7.2
7095,August 1987,Connecticut,2508000,1749238,69.7,1693403,67.5,55835,3.2
7096,August 1987,Delaware,492000,332935,67.7,323013,65.7,9922,3.0
7097,August 1987,District of Columbia,473000,330763,69.9,310556,65.7,20207,6.1
7098,August 1987,Florida,9460000,5894086,62.3,5589921,59.1,304165,5.2
7099,August 1987,Georgia,4568000,3070367,67.2,2899396,63.5,170971,5.6
7100,August 1987,Hawaii,764000,513927,67.3,494369,64.7,19558,3.8
7101,August 1987,Idaho,711000,471741,66.3,436720,61.4,35021,7.4
7102,August 1987,Illinois,8749000,5778520,66.0,5360287,61.3,418233,7.2
7103,August 1987,Indiana,4164000,2757462,66.2,2588639,62.2,168823,6.1
7104,August 1987,Iowa,2138000,1453310,68.0,1374276,64.3,79034,5.4
7105,August 1987,Kansas,1833000,1266573,69.1,1206707,65.8,59866,4.7
7106,August 1987,Kentucky,2776000,1687168,60.8,1551422,55.9,135746,8.0
7107,August 1987,Louisiana,3193000,1944858,60.9,1713869,53.7,230989,11.9
7108,August 1987,Maine,900000,591069,65.7,565388,62.8,25681,4.3
7109,August 1987,Maryland,3457000,2412190,69.8,2309942,66.8,102248,4.2
7110,August 1987,Massachusetts,4590000,3095139,67.4,3001302,65.4,93837,3.0
7111,August 1987,Michigan,6943000,4525727,65.2,4149799,59.8,375928,8.3
7112,August 1987,Minnesota,3202000,2286816,71.4,2169551,67.8,117265,5.1
7113,August 1987,Mississippi,1879000,1149257,61.2,1037909,55.2,111348,9.7
7114,August 1987,Missouri,3873000,2591510,66.9,2429601,62.7,161909,6.2
7115,August 1987,Montana,597000,401051,67.2,371233,62.2,29818,7.4
7116,August 1987,Nebraska,1182000,811091,68.6,775410,65.6,35681,4.4
7117,August 1987,Nevada,768000,559689,72.9,525291,68.4,34398,6.1
7118,August 1987,New Hampshire,807000,586207,72.6,572057,70.9,14150,2.4
7119,August 1987,New Jersey,6009000,3975294,66.2,3813492,63.5,161802,4.1
7120,August 1987,New Mexico,1075000,675545,62.8,618173,57.5,57372,8.5
7121,August 1987,New York,13772000,8497287,61.7,8094174,58.8,403113,4.7
7122,August 1987,North Carolina,4816000,3280094,68.1,3137428,65.1,142666,4.3
7123,August 1987,North Dakota,483000,331274,68.6,314965,65.2,16309,4.9
7124,August 1987,Ohio,8171000,5251002,64.3,4896483,59.9,354519,6.8
7125,August 1987,Oklahoma,2398000,1552547,64.7,1444357,60.2,108190,7.0
7126,August 1987,Oregon,2087000,1396751,66.9,1310088,62.8,86663,6.2
7127,August 1987,Pennsylvania,9305000,5683573,61.1,5366253,57.7,317320,5.6
7128,August 1987,Rhode Island,763000,518507,68.0,500019,65.5,18488,3.6
7129,August 1987,South Carolina,2501000,1622982,64.9,1539972,61.6,83010,5.1
7130,August 1987,South Dakota,515000,353672,68.7,338927,65.8,14745,4.2
7131,August 1987,Tennessee,3688000,2338489,63.4,2191174,59.4,147315,6.3
7132,August 1987,Texas,12025000,8286108,68.9,7598548,63.2,687560,8.3
7133,August 1987,Utah,1088000,753518,69.3,707976,65.1,45542,6.0
7134,August 1987,Vermont,414000,297001,71.7,286397,69.2,10604,3.6
7135,August 1987,Virginia,4407000,3012393,68.4,2891265,65.6,121128,4.0
7136,August 1987,Washington,3407000,2271983,66.7,2110163,61.9,161820,7.1
7137,August 1987,West Virginia,1449000,747518,51.6,667128,46.0,80390,10.8
7138,August 1987,Wisconsin,3621000,2492947,68.8,2349967,64.9,142980,5.7
7139,August 1987,Wyoming,348000,238505,68.5,220459,63.4,18046,7.6
7140,September 1987,Alabama,3042000,1871186,61.5,1729334,56.8,141852,7.6
7141,September 1987,Alaska,345000,247529,71.7,222745,64.6,24784,10.0
7142,September 1987,Arizona,2528000,1630182,64.5,1529206,60.5,100976,6.2
7143,September 1987,Arkansas,1780000,1102327,61.9,1014521,57.0,87806,8.0
7144,September 1987,California,20622000,13825180,67.0,13056839,63.3,768341,5.6
7145,September 1987,Colorado,2440000,1697164,69.6,1577023,64.6,120141,7.1
7146,September 1987,Connecticut,2509000,1749333,69.7,1693752,67.5,55581,3.2
7147,September 1987,Delaware,493000,334074,67.8,323997,65.7,10077,3.0
7148,September 1987,District of Columbia,473000,330157,69.8,310338,65.6,19819,6.0
7149,September 1987,Florida,9479000,5915859,62.4,5611170,59.2,304689,5.2
7150,September 1987,Georgia,4574000,3081435,67.4,2906422,63.5,175013,5.7
7151,September 1987,Hawaii,765000,515695,67.4,496555,64.9,19140,3.7
7152,September 1987,Idaho,712000,471651,66.2,437213,61.4,34438,7.3
7153,September 1987,Illinois,8753000,5784488,66.1,5372267,61.4,412221,7.1
7154,September 1987,Indiana,4166000,2757103,66.2,2593328,62.2,163775,5.9
7155,September 1987,Iowa,2139000,1455253,68.0,1377651,64.4,77602,5.3
7156,September 1987,Kansas,1835000,1268014,69.1,1208813,65.9,59201,4.7
7157,September 1987,Kentucky,2778000,1687564,60.7,1553321,55.9,134243,8.0
7158,September 1987,Louisiana,3190000,1943566,60.9,1713740,53.7,229826,11.8
7159,September 1987,Maine,901000,593003,65.8,567476,63.0,25527,4.3
7160,September 1987,Maryland,3463000,2418491,69.8,2315562,66.9,102929,4.3
7161,September 1987,Massachusetts,4593000,3100179,67.5,3007417,65.5,92762,3.0
7162,September 1987,Michigan,6945000,4524960,65.2,4151753,59.8,373207,8.2
7163,September 1987,Minnesota,3206000,2289373,71.4,2174088,67.8,115285,5.0
7164,September 1987,Mississippi,1879000,1149591,61.2,1039845,55.3,109746,9.5
7165,September 1987,Missouri,3875000,2589912,66.8,2431484,62.7,158428,6.1
7166,September 1987,Montana,597000,401646,67.3,371717,62.3,29929,7.5
7167,September 1987,Nebraska,1183000,811299,68.6,776456,65.6,34843,4.3
7168,September 1987,Nevada,771000,561793,72.9,527387,68.4,34406,6.1
7169,September 1987,New Hampshire,808000,587684,72.7,573258,70.9,14426,2.5
7170,September 1987,New Jersey,6011000,3976196,66.1,3816779,63.5,159417,4.0
7171,September 1987,New Mexico,1076000,675879,62.8,619022,57.5,56857,8.4
7172,September 1987,New York,13776000,8510594,61.8,8107825,58.9,402769,4.7
7173,September 1987,North Carolina,4822000,3287403,68.2,3145905,65.2,141498,4.3
7174,September 1987,North Dakota,483000,331602,68.7,315260,65.3,16342,4.9
7175,September 1987,Ohio,8177000,5254117,64.3,4908834,60.0,345283,6.6
7176,September 1987,Oklahoma,2396000,1550113,64.7,1442960,60.2,107153,6.9
7177,September 1987,Oregon,2091000,1402696,67.1,1315213,62.9,87483,6.2
7178,September 1987,Pennsylvania,9309000,5697441,61.2,5380410,57.8,317031,5.6
7179,September 1987,Rhode Island,764000,518403,67.9,500306,65.5,18097,3.5
7180,September 1987,South Carolina,2504000,1627215,65.0,1544472,61.7,82743,5.1
7181,September 1987,South Dakota,516000,354443,68.7,339763,65.8,14680,4.1
7182,September 1987,Tennessee,3691000,2339279,63.4,2195664,59.5,143615,6.1
7183,September 1987,Texas,12029000,8292290,68.9,7611143,63.3,681147,8.2
7184,September 1987,Utah,1089000,753436,69.2,708860,65.1,44576,5.9
7185,September 1987,Vermont,415000,297751,71.7,287275,69.2,10476,3.5
7186,September 1987,Virginia,4415000,3019812,68.4,2900552,65.7,119260,3.9
7187,September 1987,Washington,3414000,2281106,66.8,2119670,62.1,161436,7.1
7188,September 1987,West Virginia,1448000,748173,51.7,668053,46.1,80120,10.7
7189,September 1987,Wisconsin,3624000,2497450,68.9,2355877,65.0,141573,5.7
7190,September 1987,Wyoming,348000,238165,68.4,220613,63.4,17552,7.4
7191,October 1987,Alabama,3044000,1872110,61.5,1731169,56.9,140941,7.5
7192,October 1987,Alaska,345000,247735,71.8,223340,64.7,24395,9.8
7193,October 1987,Arizona,2532000,1634424,64.6,1533246,60.6,101178,6.2
7194,October 1987,Arkansas,1781000,1105475,62.1,1017858,57.2,87617,7.9
7195,October 1987,California,20660000,13862841,67.1,13095779,63.4,767062,5.5
7196,October 1987,Colorado,2441000,1699581,69.6,1579870,64.7,119711,7.0
7197,October 1987,Connecticut,2510000,1749560,69.7,1694334,67.5,55226,3.2
7198,October 1987,Delaware,493000,335575,68.1,325211,66.0,10364,3.1
7199,October 1987,District of Columbia,472000,329684,69.8,310299,65.7,19385,5.9
7200,October 1987,Florida,9498000,5937408,62.5,5631624,59.3,305784,5.2
7201,October 1987,Georgia,4581000,3092123,67.5,2913482,63.6,178641,5.8
7202,October 1987,Hawaii,766000,517210,67.5,498538,65.1,18672,3.6
7203,October 1987,Idaho,712000,471507,66.2,437707,61.5,33800,7.2
7204,October 1987,Illinois,8757000,5790428,66.1,5381636,61.5,408792,7.1
7205,October 1987,Indiana,4169000,2758270,66.2,2599612,62.4,158658,5.8
7206,October 1987,Iowa,2140000,1457677,68.1,1381897,64.6,75780,5.2
7207,October 1987,Kansas,1836000,1269411,69.1,1210823,65.9,58588,4.6
7208,October 1987,Kentucky,2779000,1689352,60.8,1555502,56.0,133850,7.9
7209,October 1987,Louisiana,3188000,1942201,60.9,1713561,53.8,228640,11.8
7210,October 1987,Maine,903000,594044,65.8,568953,63.0,25091,4.2
7211,October 1987,Maryland,3468000,2425476,69.9,2321367,66.9,104109,4.3
7212,October 1987,Massachusetts,4595000,3106271,67.6,3013346,65.6,92925,3.0
7213,October 1987,Michigan,6948000,4524446,65.1,4152840,59.8,371606,8.2
7214,October 1987,Minnesota,3210000,2290737,71.4,2178649,67.9,112088,4.9
7215,October 1987,Mississippi,1880000,1149524,61.1,1041835,55.4,107689,9.4
7216,October 1987,Missouri,3878000,2586516,66.7,2432708,62.7,153808,5.9
7217,October 1987,Montana,597000,402238,67.4,372343,62.4,29895,7.4
7218,October 1987,Nebraska,1183000,811340,68.6,777469,65.7,33871,4.2
7219,October 1987,Nevada,774000,563774,72.8,529557,68.4,34217,6.1
7220,October 1987,New Hampshire,810000,588950,72.7,574472,70.9,14478,2.5
7221,October 1987,New Jersey,6014000,3976318,66.1,3819113,63.5,157205,4.0
7222,October 1987,New Mexico,1076000,676635,62.9,620134,57.6,56501,8.4
7223,October 1987,New York,13779000,8520595,61.8,8120516,58.9,400079,4.7
7224,October 1987,North Carolina,4827000,3293871,68.2,3153161,65.3,140710,4.3
7225,October 1987,North Dakota,483000,331854,68.7,315478,65.3,16376,4.9
7226,October 1987,Ohio,8183000,5260060,64.3,4921268,60.1,338792,6.4
7227,October 1987,Oklahoma,2395000,1548062,64.6,1441547,60.2,106515,6.9
7228,October 1987,Oregon,2094000,1407644,67.2,1319839,63.0,87805,6.2
7229,October 1987,Pennsylvania,9312000,5710659,61.3,5394136,57.9,316523,5.5
7230,October 1987,Rhode Island,764000,518312,67.8,500510,65.5,17802,3.4
7231,October 1987,South Carolina,2507000,1632476,65.1,1549209,61.8,83267,5.1
7232,October 1987,South Dakota,516000,355227,68.8,340528,66.0,14699,4.1
7233,October 1987,Tennessee,3694000,2340619,63.4,2199556,59.5,141063,6.0
7234,October 1987,Texas,12032000,8298109,69.0,7623766,63.4,674343,8.1
7235,October 1987,Utah,1089000,753755,69.2,710072,65.2,43683,5.8
7236,October 1987,Vermont,415000,298300,71.9,288056,69.4,10244,3.4
7237,October 1987,Virginia,4422000,3028511,68.5,2910143,65.8,118368,3.9
7238,October 1987,Washington,3420000,2288255,66.9,2127520,62.2,160735,7.0
7239,October 1987,West Virginia,1448000,748617,51.7,668938,46.2,79679,10.6
7240,October 1987,Wisconsin,3626000,2502143,69.0,2362829,65.2,139314,5.6
7241,October 1987,Wyoming,347000,237956,68.6,220866,63.7,17090,7.2
7242,November 1987,Alabama,3046000,1872135,61.5,1732529,56.9,139606,7.5
7243,November 1987,Alaska,345000,248007,71.9,224015,64.9,23992,9.7
7244,November 1987,Arizona,2537000,1638283,64.6,1536677,60.6,101606,6.2
7245,November 1987,Arkansas,1781000,1107837,62.2,1020490,57.3,87347,7.9
7246,November 1987,California,20698000,13899418,67.2,13134912,63.5,764506,5.5
7247,November 1987,Colorado,2441000,1702207,69.7,1582433,64.8,119774,7.0
7248,November 1987,Connecticut,2511000,1749470,69.7,1695064,67.5,54406,3.1
7249,November 1987,Delaware,494000,337285,68.3,326611,66.1,10674,3.2
7250,November 1987,District of Columbia,471000,329515,70.0,310560,65.9,18955,5.8
7251,November 1987,Florida,9517000,5958287,62.6,5651434,59.4,306853,5.2
7252,November 1987,Georgia,4587000,3101711,67.6,2920626,63.7,181085,5.8
7253,November 1987,Hawaii,768000,518247,67.5,500043,65.1,18204,3.5
7254,November 1987,Idaho,713000,471404,66.1,438316,61.5,33088,7.0
7255,November 1987,Illinois,8761000,5796888,66.2,5389223,61.5,407665,7.0
7256,November 1987,Indiana,4172000,2761088,66.2,2607094,62.5,153994,5.6
7257,November 1987,Iowa,2141000,1460565,68.2,1386858,64.8,73707,5.0
7258,November 1987,Kansas,1837000,1270839,69.2,1212753,66.0,58086,4.6
7259,November 1987,Kentucky,2780000,1692101,60.9,1557947,56.0,134154,7.9
7260,November 1987,Louisiana,3186000,1940673,60.9,1713636,53.8,227037,11.7
7261,November 1987,Maine,904000,594274,65.7,569907,63.0,24367,4.1
7262,November 1987,Maryland,3473000,2432500,70.0,2327141,67.0,105359,4.3
7263,November 1987,Massachusetts,4597000,3112936,67.7,3018929,65.7,94007,3.0
7264,November 1987,Michigan,6950000,4525787,65.1,4154335,59.8,371452,8.2
7265,November 1987,Minnesota,3214000,2291012,71.3,2183011,67.9,108001,4.7
7266,November 1987,Mississippi,1881000,1148903,61.1,1043839,55.5,105064,9.1
7267,November 1987,Missouri,3880000,2582189,66.6,2433878,62.7,148311,5.7
7268,November 1987,Montana,597000,402766,67.5,373058,62.5,29708,7.4
7269,November 1987,Nebraska,1184000,811386,68.5,778415,65.7,32971,4.1
7270,November 1987,Nevada,777000,565706,72.8,531895,68.5,33811,6.0
7271,November 1987,New Hampshire,811000,590124,72.8,575799,71.0,14325,2.4
7272,November 1987,New Jersey,6016000,3975772,66.1,3820656,63.5,155116,3.9
7273,November 1987,New Mexico,1077000,677878,62.9,621657,57.7,56221,8.3
7274,November 1987,New York,13782000,8525703,61.9,8132516,59.0,393187,4.6
7275,November 1987,North Carolina,4833000,3298949,68.3,3159526,65.4,139423,4.2
7276,November 1987,North Dakota,483000,331975,68.7,315623,65.3,16352,4.9
7277,November 1987,Ohio,8190000,5268896,64.3,4932926,60.2,335970,6.4
7278,November 1987,Oklahoma,2394000,1545967,64.6,1440155,60.2,105812,6.8
7279,November 1987,Oregon,2097000,1411379,67.3,1324029,63.1,87350,6.2
7280,November 1987,Pennsylvania,9316000,5722266,61.4,5407142,58.0,315124,5.5
7281,November 1987,Rhode Island,765000,518311,67.8,500798,65.5,17513,3.4
7282,November 1987,South Carolina,2510000,1637604,65.2,1553995,61.9,83609,5.1
7283,November 1987,South Dakota,516000,355915,69.0,341120,66.1,14795,4.2
7284,November 1987,Tennessee,3698000,2342313,63.3,2202915,59.6,139398,6.0
7285,November 1987,Texas,12036000,8303798,69.0,7636645,63.4,667153,8.0
7286,November 1987,Utah,1090000,754277,69.2,711446,65.3,42831,5.7
7287,November 1987,Vermont,416000,298631,71.8,288708,69.4,9923,3.3
7288,November 1987,Virginia,4429000,3037986,68.6,2920116,65.9,117870,3.9
7289,November 1987,Washington,3427000,2293369,66.9,2134015,62.3,159354,6.9
7290,November 1987,West Virginia,1447000,748712,51.7,669674,46.3,79038,10.6
7291,November 1987,Wisconsin,3629000,2507239,69.1,2371273,65.3,135966,5.4
7292,November 1987,Wyoming,347000,237826,68.5,221176,63.7,16650,7.0
7293,December 1987,Alabama,3047000,1871070,61.4,1733249,56.9,137821,7.4
7294,December 1987,Alaska,345000,248213,71.9,224610,65.1,23603,9.5
7295,December 1987,Arizona,2542000,1641486,64.6,1539153,60.5,102333,6.2
7296,December 1987,Arkansas,1782000,1109182,62.2,1022145,57.4,87037,7.8
7297,December 1987,California,20735000,13932138,67.2,13171698,63.5,760440,5.5
7298,December 1987,Colorado,2442000,1704007,69.8,1584252,64.9,119755,7.0
7299,December 1987,Connecticut,2512000,1748576,69.6,1695516,67.5,53060,3.0
7300,December 1987,Delaware,495000,338997,68.5,328125,66.3,10872,3.2
7301,December 1987,District of Columbia,471000,329733,70.0,311161,66.1,18572,5.6
7302,December 1987,Florida,9536000,5976792,62.7,5668999,59.4,307793,5.1
7303,December 1987,Georgia,4594000,3110161,67.7,2927267,63.7,182894,5.9
7304,December 1987,Hawaii,769000,518647,67.4,500880,65.1,17767,3.4
7305,December 1987,Idaho,713000,471445,66.1,439107,61.6,32338,6.9
7306,December 1987,Illinois,8765000,5802000,66.2,5394076,61.5,407924,7.0
7307,December 1987,Indiana,4174000,2764624,66.2,2614458,62.6,150166,5.4
7308,December 1987,Iowa,2142000,1463824,68.3,1392143,65.0,71681,4.9
7309,December 1987,Kansas,1838000,1272116,69.2,1214303,66.1,57813,4.5
7310,December 1987,Kentucky,2781000,1695094,61.0,1560402,56.1,134692,7.9
7311,December 1987,Louisiana,3183000,1938653,60.9,1713641,53.8,225012,11.6
7312,December 1987,Maine,906000,593912,65.6,570487,63.0,23425,3.9
7313,December 1987,Maryland,3479000,2439011,70.1,2332512,67.0,106499,4.4
7314,December 1987,Massachusetts,4599000,3119105,67.8,3023595,65.7,95510,3.1
7315,December 1987,Michigan,6953000,4528905,65.1,4156818,59.8,372087,8.2
7316,December 1987,Minnesota,3218000,2290842,71.2,2186921,68.0,103921,4.5
7317,December 1987,Mississippi,1881000,1147644,61.0,1045582,55.6,102062,8.9
7318,December 1987,Missouri,3883000,2577749,66.4,2434637,62.7,143112,5.6
7319,December 1987,Montana,597000,403164,67.5,373740,62.6,29424,7.3
7320,December 1987,Nebraska,1185000,811523,68.5,779236,65.8,32287,4.0
7321,December 1987,Nevada,780000,567613,72.8,534404,68.5,33209,5.9
7322,December 1987,New Hampshire,813000,591285,72.7,577243,71.0,14042,2.4
7323,December 1987,New Jersey,6019000,3974316,66.0,3821127,63.5,153189,3.9
7324,December 1987,New Mexico,1078000,679450,63.0,623523,57.8,55927,8.2
7325,December 1987,New York,13786000,8524333,61.8,8142148,59.1,382185,4.5
7326,December 1987,North Carolina,4839000,3302039,68.2,3164720,65.4,137319,4.2
7327,December 1987,North Dakota,483000,331920,68.7,315680,65.4,16240,4.9
7328,December 1987,Ohio,8196000,5279385,64.4,4942876,60.3,336509,6.4
7329,December 1987,Oklahoma,2392000,1543257,64.5,1438502,60.1,104755,6.8
7330,December 1987,Oregon,2101000,1414035,67.3,1327699,63.2,86336,6.1
7331,December 1987,Pennsylvania,9320000,5730397,61.5,5417842,58.1,312555,5.5
7332,December 1987,Rhode Island,765000,518495,67.8,501322,65.5,17173,3.3
7333,December 1987,South Carolina,2513000,1641761,65.3,1558375,62.0,83386,5.1
7334,December 1987,South Dakota,517000,356424,68.9,341495,66.1,14929,4.2
7335,December 1987,Tennessee,3701000,2343309,63.3,2205199,59.6,138110,5.9
7336,December 1987,Texas,12040000,8308284,69.0,7648563,63.5,659721,7.9
7337,December 1987,Utah,1091000,754785,69.2,712787,65.3,41998,5.6
7338,December 1987,Vermont,417000,298782,71.7,289235,69.4,9547,3.2
7339,December 1987,Virginia,4436000,3047011,68.7,2929467,66.0,117544,3.9
7340,December 1987,Washington,3434000,2296446,66.9,2139234,62.3,157212,6.8
7341,December 1987,West Virginia,1446000,748506,51.8,670170,46.3,78336,10.5
7342,December 1987,Wisconsin,3632000,2512633,69.2,2380915,65.6,131718,5.2
7343,December 1987,Wyoming,347000,237732,68.5,221473,63.8,16259,6.8
7344,January 1988,Alabama,3049000,1869264,61.3,1733592,56.9,135672,7.3
7345,January 1988,Alaska,346000,248216,71.7,224991,65.0,23225,9.4
7346,January 1988,Arizona,2547000,1643937,64.5,1540561,60.5,103376,6.3
7347,January 1988,Arkansas,1782000,1109527,62.3,1022813,57.4,86714,7.8
7348,January 1988,California,20773000,13960181,67.2,13204699,63.6,755482,5.4
7349,January 1988,Colorado,2442000,1704329,69.8,1585136,64.9,119193,7.0
7350,January 1988,Connecticut,2513000,1746826,69.5,1695410,67.5,51416,2.9
7351,January 1988,Delaware,496000,340594,68.7,329707,66.5,10887,3.2
7352,January 1988,District of Columbia,470000,330308,70.3,312074,66.4,18234,5.5
7353,January 1988,Florida,9555000,5991482,62.7,5683304,59.5,308178,5.1
7354,January 1988,Georgia,4600000,3117340,67.8,2933077,63.8,184263,5.9
7355,January 1988,Hawaii,770000,518394,67.3,501049,65.1,17345,3.3
7356,January 1988,Idaho,713000,471771,66.2,440128,61.7,31643,6.7
7357,January 1988,Illinois,8769000,5803724,66.2,5395933,61.5,407791,7.0
7358,January 1988,Indiana,4177000,2767973,66.3,2620899,62.7,147074,5.3
7359,January 1988,Iowa,2143000,1467413,68.5,1397465,65.2,69948,4.8
7360,January 1988,Kansas,1840000,1272991,69.2,1215216,66.0,57775,4.5
7361,January 1988,Kentucky,2783000,1697572,61.0,1562699,56.2,134873,7.9
7362,January 1988,Louisiana,3181000,1935857,60.9,1713253,53.9,222604,11.5
7363,January 1988,Maine,907000,593268,65.4,570875,62.9,22393,3.8
7364,January 1988,Maryland,3484000,2444552,70.2,2337273,67.1,107279,4.4
7365,January 1988,Massachusetts,4602000,3124068,67.9,3027096,65.8,96972,3.1
7366,January 1988,Michigan,6955000,4532310,65.2,4160827,59.8,371483,8.2
7367,January 1988,Minnesota,3221000,2290812,71.1,2190303,68.0,100509,4.4
7368,January 1988,Mississippi,1882000,1145718,60.9,1046799,55.6,98919,8.6
7369,January 1988,Missouri,3885000,2574227,66.3,2434597,62.7,139630,5.4
7370,January 1988,Montana,597000,403497,67.6,374396,62.7,29101,7.2
7371,January 1988,Nebraska,1186000,811650,68.4,779943,65.8,31707,3.9
7372,January 1988,Nevada,783000,569534,72.7,537012,68.6,32522,5.7
7373,January 1988,New Hampshire,814000,592472,72.8,578767,71.1,13705,2.3
7374,January 1988,New Jersey,6021000,3972027,66.0,3820548,63.5,151479,3.8
7375,January 1988,New Mexico,1079000,681036,63.1,625539,58.0,55497,8.1
7376,January 1988,New York,13789000,8516679,61.8,8148513,59.1,368166,4.3
7377,January 1988,North Carolina,4845000,3302693,68.2,3168621,65.4,134072,4.1
7378,January 1988,North Dakota,483000,331708,68.7,315651,65.4,16057,4.8
7379,January 1988,Ohio,8202000,5288997,64.5,4950802,60.4,338195,6.4
7380,January 1988,Oklahoma,2391000,1539604,64.4,1436480,60.1,103124,6.7
7381,January 1988,Oregon,2104000,1415989,67.3,1330767,63.2,85222,6.0
7382,January 1988,Pennsylvania,9324000,5734216,61.5,5425491,58.2,308725,5.4
7383,January 1988,Rhode Island,765000,518819,67.8,502068,65.6,16751,3.2
7384,January 1988,South Carolina,2516000,1644589,65.4,1562023,62.1,82566,5.0
7385,January 1988,South Dakota,517000,356760,69.0,341717,66.1,15043,4.2
7386,January 1988,Tennessee,3704000,2342464,63.2,2205784,59.6,136680,5.8
7387,January 1988,Texas,12044000,8310417,69.0,7658622,63.6,651795,7.8
7388,January 1988,Utah,1092000,755148,69.2,714013,65.4,41135,5.4
7389,January 1988,Vermont,418000,298843,71.5,289690,69.3,9153,3.1
7390,January 1988,Virginia,4444000,3054715,68.7,2937397,66.1,117318,3.8
7391,January 1988,Washington,3441000,2297847,66.8,2143290,62.3,154557,6.7
7392,January 1988,West Virginia,1445000,748123,51.8,670423,46.4,77700,10.4
7393,January 1988,Wisconsin,3635000,2518027,69.3,2391209,65.8,126818,5.0
7394,January 1988,Wyoming,347000,237640,68.5,221728,63.9,15912,6.7
7395,February 1988,Alabama,3051000,1867903,61.2,1734381,56.8,133522,7.1
7396,February 1988,Alaska,346000,248045,71.7,225170,65.1,22875,9.2
7397,February 1988,Arizona,2552000,1646116,64.5,1541497,60.4,104619,6.4
7398,February 1988,Arkansas,1783000,1109327,62.2,1022955,57.4,86372,7.8
7399,February 1988,California,20811000,13986655,67.2,13236242,63.6,750413,5.4
7400,February 1988,Colorado,2443000,1703519,69.7,1585551,64.9,117968,6.9
7401,February 1988,Connecticut,2514000,1744762,69.4,1694889,67.4,49873,2.9
7402,February 1988,Delaware,497000,342076,68.8,331353,66.7,10723,3.1
7403,February 1988,District of Columbia,469000,331081,70.6,313171,66.8,17910,5.4
7404,February 1988,Florida,9575000,6002867,62.7,5695192,59.5,307675,5.1
7405,February 1988,Georgia,4607000,3123405,67.8,2938581,63.8,184824,5.9
7406,February 1988,Hawaii,771000,517728,67.2,500780,65.0,16948,3.3
7407,February 1988,Idaho,714000,472459,66.2,441445,61.8,31014,6.6
7408,February 1988,Illinois,8773000,5802656,66.1,5396509,61.5,406147,7.0
7409,February 1988,Indiana,4180000,2771375,66.3,2626638,62.8,144737,5.2
7410,February 1988,Iowa,2145000,1471544,68.6,1402867,65.4,68677,4.7
7411,February 1988,Kansas,1841000,1273345,69.2,1215502,66.0,57843,4.5
7412,February 1988,Kentucky,2784000,1699496,61.0,1564977,56.2,134519,7.9
7413,February 1988,Louisiana,3179000,1932607,60.8,1712672,53.9,219935,11.4
7414,February 1988,Maine,909000,592874,65.2,571355,62.9,21519,3.6
7415,February 1988,Maryland,3489000,2449100,70.2,2341634,67.1,107466,4.4
7416,February 1988,Massachusetts,4604000,3127986,67.9,3029828,65.8,98158,3.1
7417,February 1988,Michigan,6958000,4534678,65.2,4167495,59.9,367183,8.1
7418,February 1988,Minnesota,3225000,2291582,71.1,2193384,68.0,98198,4.3
7419,February 1988,Mississippi,1883000,1143557,60.7,1047510,55.6,96047,8.4
7420,February 1988,Missouri,3888000,2572940,66.2,2434307,62.6,138633,5.4
7421,February 1988,Montana,596000,403818,67.8,375026,62.9,28792,7.1
7422,February 1988,Nebraska,1186000,811809,68.4,780615,65.8,31194,3.8
7423,February 1988,Nevada,786000,571552,72.7,539683,68.7,31869,5.6
7424,February 1988,New Hampshire,816000,593683,72.8,580263,71.1,13420,2.3
7425,February 1988,New Jersey,6024000,3969859,65.9,3819777,63.4,150082,3.8
7426,February 1988,New Mexico,1080000,682452,63.2,627559,58.1,54893,8.0
7427,February 1988,New York,13792000,8506600,61.7,8152981,59.1,353619,4.2
7428,February 1988,North Carolina,4850000,3301744,68.1,3172100,65.4,129644,3.9
7429,February 1988,North Dakota,482000,331401,68.8,315569,65.5,15832,4.8
7430,February 1988,Ohio,8208000,5296278,64.5,4957946,60.4,338332,6.4
7431,February 1988,Oklahoma,2390000,1535314,64.2,1434231,60.0,101083,6.6
7432,February 1988,Oregon,2107000,1417779,67.3,1333390,63.3,84389,6.0
7433,February 1988,Pennsylvania,9327000,5735139,61.5,5431253,58.2,303886,5.3
7434,February 1988,Rhode Island,766000,519194,67.8,502915,65.7,16279,3.1
7435,February 1988,South Carolina,2520000,1646568,65.3,1565257,62.1,81311,4.9
7436,February 1988,South Dakota,517000,356951,69.0,341884,66.1,15067,4.2
7437,February 1988,Tennessee,3707000,2340326,63.1,2205003,59.5,135323,5.8
7438,February 1988,Texas,12048000,8310909,69.0,7667981,63.6,642928,7.7
7439,February 1988,Utah,1093000,755396,69.1,715191,65.4,40205,5.3
7440,February 1988,Vermont,419000,298952,71.3,290148,69.2,8804,2.9
7441,February 1988,Virginia,4451000,3061386,68.8,2943971,66.1,117415,3.8
7442,February 1988,Washington,3447000,2298829,66.7,2146914,62.3,151915,6.6
7443,February 1988,West Virginia,1444000,747674,51.8,670554,46.4,77120,10.3
7444,February 1988,Wisconsin,3638000,2523725,69.4,2401851,66.0,121874,4.8
7445,February 1988,Wyoming,346000,237575,68.7,221973,64.2,15602,6.6
7446,March 1988,Alabama,3052000,1867489,61.2,1735716,56.9,131773,7.1
7447,March 1988,Alaska,346000,247825,71.6,225224,65.1,22601,9.1
7448,March 1988,Arizona,2557000,1648211,64.5,1542409,60.3,105802,6.4
7449,March 1988,Arkansas,1783000,1109023,62.2,1023003,57.4,86020,7.8
7450,March 1988,California,20848000,14014830,67.2,13267702,63.6,747128,5.3
7451,March 1988,Colorado,2444000,1702169,69.6,1585775,64.9,116394,6.8
7452,March 1988,Connecticut,2515000,1743261,69.3,1694234,67.4,49027,2.8
7453,March 1988,Delaware,498000,343523,69.0,333053,66.9,10470,3.0
7454,March 1988,District of Columbia,469000,331832,70.8,314260,67.0,17572,5.3
7455,March 1988,Florida,9594000,6011087,62.7,5704687,59.5,306400,5.1
7456,March 1988,Georgia,4614000,3128378,67.8,2943898,63.8,184480,5.9
7457,March 1988,Hawaii,772000,517010,67.0,500398,64.8,16612,3.2
7458,March 1988,Idaho,714000,473485,66.3,443065,62.1,30420,6.4
7459,March 1988,Illinois,8777000,5800805,66.1,5397563,61.5,403242,7.0
7460,March 1988,Indiana,4182000,2775225,66.4,2631760,62.9,143465,5.2
7461,March 1988,Iowa,2146000,1476188,68.8,1408198,65.6,67990,4.6
7462,March 1988,Kansas,1842000,1273250,69.1,1215287,66.0,57963,4.6
7463,March 1988,Kentucky,2785000,1701192,61.1,1567320,56.3,133872,7.9
7464,March 1988,Louisiana,3176000,1929188,60.7,1711859,53.9,217329,11.3
7465,March 1988,Maine,910000,593120,65.2,572067,62.9,21053,3.5
7466,March 1988,Maryland,3495000,2453073,70.2,2345867,67.1,107206,4.4
7467,March 1988,Massachusetts,4606000,3130894,68.0,3031884,65.8,99010,3.2
7468,March 1988,Michigan,6961000,4535238,65.2,4176206,60.0,359032,7.9
7469,March 1988,Minnesota,3229000,2293690,71.0,2196387,68.0,97303,4.2
7470,March 1988,Mississippi,1883000,1141513,60.6,1047672,55.6,93841,8.2
7471,March 1988,Missouri,3890000,2574017,66.2,2433786,62.6,140231,5.4
7472,March 1988,Montana,596000,404039,67.8,375514,63.0,28525,7.1
7473,March 1988,Nebraska,1187000,812045,68.4,781313,65.8,30732,3.8
7474,March 1988,Nevada,789000,573702,72.7,542363,68.7,31339,5.5
7475,March 1988,New Hampshire,818000,594865,72.7,581552,71.1,13313,2.2
7476,March 1988,New Jersey,6026000,3968330,65.9,3819077,63.4,149253,3.8
7477,March 1988,New Mexico,1081000,683586,63.2,629402,58.2,54184,7.9
7478,March 1988,New York,13796000,8498645,61.6,8156087,59.1,342558,4.0
7479,March 1988,North Carolina,4856000,3300211,68.0,3175650,65.4,124561,3.8
7480,March 1988,North Dakota,482000,331082,68.7,315459,65.4,15623,4.7
7481,March 1988,Ohio,8214000,5300644,64.5,4965103,60.4,335541,6.3
7482,March 1988,Oklahoma,2388000,1530890,64.1,1431648,60.0,99242,6.5
7483,March 1988,Oregon,2111000,1419663,67.3,1335676,63.3,83987,5.9
7484,March 1988,Pennsylvania,9331000,5735656,61.5,5436693,58.3,298963,5.2
7485,March 1988,Rhode Island,766000,519642,67.8,503791,65.8,15851,3.1
7486,March 1988,South Carolina,2523000,1648506,65.3,1568427,62.2,80079,4.9
7487,March 1988,South Dakota,518000,357022,68.9,342050,66.0,14972,4.2
7488,March 1988,Tennessee,3710000,2337764,63.0,2203262,59.4,134502,5.8
7489,March 1988,Texas,12052000,8310563,69.0,7677058,63.7,633505,7.6
7490,March 1988,Utah,1094000,755700,69.1,716393,65.5,39307,5.2
7491,March 1988,Vermont,420000,299184,71.2,290632,69.2,8552,2.9
7492,March 1988,Virginia,4458000,3066894,68.8,2948838,66.1,118056,3.8
7493,March 1988,Washington,3454000,2300391,66.6,2150611,62.3,149780,6.5
7494,March 1988,West Virginia,1443000,747260,51.8,670710,46.5,76550,10.2
7495,March 1988,Wisconsin,3641000,2529901,69.5,2412293,66.3,117608,4.6
7496,March 1988,Wyoming,346000,237599,68.7,222250,64.2,15349,6.5
7497,April 1988,Alabama,3054000,1868204,61.2,1737319,56.9,130885,7.0
7498,April 1988,Alaska,346000,247679,71.6,225279,65.1,22400,9.0
7499,April 1988,Arizona,2561000,1650654,64.5,1543974,60.3,106680,6.5
7500,April 1988,Arkansas,1784000,1109022,62.2,1023357,57.4,85665,7.7
7501,April 1988,California,20886000,14047062,67.3,13300242,63.7,746820,5.3
7502,April 1988,Colorado,2444000,1700919,69.6,1586045,64.9,114874,6.8
7503,April 1988,Connecticut,2516000,1743034,69.3,1693761,67.3,49273,2.8
7504,April 1988,Delaware,498000,345050,69.3,334763,67.2,10287,3.0
7505,April 1988,District of Columbia,468000,332372,71.0,315162,67.3,17210,5.2
7506,April 1988,Florida,9613000,6017900,62.6,5712872,59.4,305028,5.1
7507,April 1988,Georgia,4620000,3132811,67.8,2949311,63.8,183500,5.9
7508,April 1988,Hawaii,773000,516564,66.8,500212,64.7,16352,3.2
7509,April 1988,Idaho,715000,474812,66.4,444957,62.2,29855,6.3
7510,April 1988,Illinois,8781000,5801559,66.1,5402075,61.5,399484,6.9
7511,April 1988,Indiana,4185000,2780128,66.4,2636730,63.0,143398,5.2
7512,April 1988,Iowa,2147000,1481236,69.0,1413454,65.8,67782,4.6
7513,April 1988,Kansas,1843000,1273059,69.1,1214972,65.9,58087,4.6
7514,April 1988,Kentucky,2786000,1703342,61.1,1570154,56.4,133188,7.8
7515,April 1988,Louisiana,3174000,1926089,60.7,1711081,53.9,215008,11.2
7516,April 1988,Maine,912000,593965,65.1,572975,62.8,20990,3.5
7517,April 1988,Maryland,3500000,2457152,70.2,2350289,67.2,106863,4.3
7518,April 1988,Massachusetts,4608000,3133219,68.0,3033574,65.8,99645,3.2
7519,April 1988,Michigan,6963000,4535430,65.1,4185874,60.1,349556,7.7
7520,April 1988,Minnesota,3233000,2297153,71.1,2199532,68.0,97621,4.2
7521,April 1988,Mississippi,1884000,1140045,60.5,1047404,55.6,92641,8.1
7522,April 1988,Missouri,3893000,2577151,66.2,2433201,62.5,143950,5.6
7523,April 1988,Montana,596000,404172,67.8,375897,63.1,28275,7.0
7524,April 1988,Nebraska,1188000,812388,68.4,782085,65.8,30303,3.7
7525,April 1988,Nevada,792000,576017,72.7,545019,68.8,30998,5.4
7526,April 1988,New Hampshire,819000,596109,72.8,582670,71.1,13439,2.3
7527,April 1988,New Jersey,6029000,3967780,65.8,3818724,63.3,149056,3.8
7528,April 1988,New Mexico,1081000,684396,63.3,631010,58.4,53386,7.8
7529,April 1988,New York,13799000,8497368,61.6,8158999,59.1,338369,4.0
7530,April 1988,North Carolina,4862000,3299753,67.9,3180087,65.4,119666,3.6
7531,April 1988,North Dakota,482000,330848,68.6,315362,65.4,15486,4.7
7532,April 1988,Ohio,8220000,5303601,64.5,4973053,60.5,330548,6.2
7533,April 1988,Oklahoma,2387000,1527150,64.0,1429009,59.9,98141,6.4
7534,April 1988,Oregon,2114000,1421881,67.3,1337895,63.3,83986,5.9
7535,April 1988,Pennsylvania,9335000,5738521,61.5,5443609,58.3,294912,5.1
7536,April 1988,Rhode Island,767000,520170,67.8,504633,65.8,15537,3.0
7537,April 1988,South Carolina,2526000,1650860,65.4,1571689,62.2,79171,4.8
7538,April 1988,South Dakota,518000,357044,68.9,342263,66.1,14781,4.1
7539,April 1988,Tennessee,3713000,2335995,62.9,2201565,59.3,134430,5.8
7540,April 1988,Texas,12055000,8311114,68.9,7686700,63.8,624414,7.5
7541,April 1988,Utah,1094000,756360,69.1,717782,65.6,38578,5.1
7542,April 1988,Vermont,420000,299584,71.3,291158,69.3,8426,2.8
7543,April 1988,Virginia,4465000,3071576,68.8,2952363,66.1,119213,3.9
7544,April 1988,Washington,3461000,2303667,66.6,2155104,62.3,148563,6.4
7545,April 1988,West Virginia,1443000,746966,51.8,671050,46.5,75916,10.2
7546,April 1988,Wisconsin,3643000,2536654,69.6,2422292,66.5,114362,4.5
7547,April 1988,Wyoming,346000,237707,68.7,222536,64.3,15171,6.4
7548,May 1988,Alabama,3056000,1869857,61.2,1738884,56.9,130973,7.0
7549,May 1988,Alaska,347000,247706,71.4,225466,65.0,22240,9.0
7550,May 1988,Arizona,2566000,1654021,64.5,1546882,60.3,107139,6.5
7551,May 1988,Arkansas,1784000,1109435,62.2,1024102,57.4,85333,7.7
7552,May 1988,California,20924000,14083126,67.3,13334410,63.7,748716,5.3
7553,May 1988,Colorado,2445000,1700062,69.5,1586547,64.9,113515,6.7
7554,May 1988,Connecticut,2517000,1744031,69.3,1693656,67.3,50375,2.9
7555,May 1988,Delaware,499000,346697,69.5,336403,67.4,10294,3.0
7556,May 1988,District of Columbia,467000,332560,71.2,315713,67.6,16847,5.1
7557,May 1988,Florida,9632000,6025697,62.6,5721503,59.4,304194,5.0
7558,May 1988,Georgia,4627000,3137178,67.8,2955075,63.9,182103,5.8
7559,May 1988,Hawaii,775000,516538,66.7,500363,64.6,16175,3.1
7560,May 1988,Idaho,715000,476370,66.6,447024,62.5,29346,6.2
7561,May 1988,Illinois,8785000,5807182,66.1,5412010,61.6,395172,6.8
7562,May 1988,Indiana,4188000,2786784,66.5,2642423,63.1,144361,5.2
7563,May 1988,Iowa,2148000,1486451,69.2,1418679,66.0,67772,4.6
7564,May 1988,Kansas,1845000,1273139,69.0,1215016,65.9,58123,4.6
7565,May 1988,Kentucky,2788000,1706404,61.2,1573799,56.4,132605,7.8
7566,May 1988,Louisiana,3172000,1923531,60.6,1710648,53.9,212883,11.1
7567,May 1988,Maine,913000,595332,65.2,574057,62.9,21275,3.6
7568,May 1988,Maryland,3505000,2461765,70.2,2355096,67.2,106669,4.3
7569,May 1988,Massachusetts,4611000,3135481,68.0,3035301,65.8,100180,3.2
7570,May 1988,Michigan,6966000,4536945,65.1,4195865,60.2,341080,7.5
7571,May 1988,Minnesota,3237000,2301552,71.1,2202900,68.1,98652,4.3
7572,May 1988,Mississippi,1885000,1139551,60.5,1046961,55.5,92590,8.1
7573,May 1988,Missouri,3895000,2581231,66.3,2432954,62.5,148277,5.7
7574,May 1988,Montana,596000,404246,67.8,376261,63.1,27985,6.9
7575,May 1988,Nebraska,1189000,812811,68.4,782920,65.8,29891,3.7
7576,May 1988,Nevada,795000,578536,72.8,547721,68.9,30815,5.3
7577,May 1988,New Hampshire,821000,597483,72.8,583723,71.1,13760,2.3
7578,May 1988,New Jersey,6031000,3968195,65.8,3818867,63.3,149328,3.8
7579,May 1988,New Mexico,1082000,684929,63.3,632373,58.4,52556,7.7
7580,May 1988,New York,13802000,8505117,61.6,8163322,59.1,341795,4.0
7581,May 1988,North Carolina,4868000,3301861,67.8,3185849,65.4,116012,3.5
7582,May 1988,North Dakota,482000,330759,68.6,315306,65.4,15453,4.7
7583,May 1988,Ohio,8227000,5307022,64.5,4982223,60.6,324799,6.1
7584,May 1988,Oklahoma,2386000,1524506,63.9,1426761,59.8,97745,6.4
7585,May 1988,Oregon,2117000,1424334,67.3,1340282,63.3,84052,5.9
7586,May 1988,Pennsylvania,9339000,5745073,61.5,5452778,58.4,292295,5.1
7587,May 1988,Rhode Island,767000,520766,67.9,505360,65.9,15406,3.0
7588,May 1988,South Carolina,2529000,1653508,65.4,1574957,62.3,78551,4.8
7589,May 1988,South Dakota,518000,357058,68.9,342488,66.1,14570,4.1
7590,May 1988,Tennessee,3717000,2336149,62.9,2201047,59.2,135102,5.8
7591,May 1988,Texas,12059000,8314445,68.9,7698019,63.8,616426,7.4
7592,May 1988,Utah,1095000,757584,69.2,719534,65.7,38050,5.0
7593,May 1988,Vermont,421000,300141,71.3,291695,69.3,8446,2.8
7594,May 1988,Virginia,4473000,3076240,68.8,2955428,66.1,120812,3.9
7595,May 1988,Washington,3468000,2309146,66.6,2161037,62.3,148109,6.4
7596,May 1988,West Virginia,1442000,746795,51.8,671622,46.6,75173,10.1
7597,May 1988,Wisconsin,3646000,2544076,69.8,2431931,66.7,112145,4.4
7598,May 1988,Wyoming,346000,237837,68.7,222753,64.4,15084,6.3
7599,June 1988,Alabama,3057000,1872410,61.2,1740456,56.9,131954,7.0
7600,June 1988,Alaska,347000,247954,71.5,225850,65.1,22104,8.9
7601,June 1988,Arizona,2571000,1658497,64.5,1551235,60.3,107262,6.5
7602,June 1988,Arkansas,1785000,1110097,62.2,1025117,57.4,84980,7.7
7603,June 1988,California,20961000,14121334,67.4,13370143,63.8,751191,5.3
7604,June 1988,Colorado,2445000,1699374,69.5,1587186,64.9,112188,6.6
7605,June 1988,Connecticut,2518000,1745674,69.3,1693918,67.3,51756,3.0
7606,June 1988,Delaware,500000,348386,69.7,337876,67.6,10510,3.0
7607,June 1988,District of Columbia,467000,332285,71.2,315780,67.6,16505,5.0
7608,June 1988,Florida,9651000,6036287,62.5,5731943,59.4,304344,5.0
7609,June 1988,Georgia,4633000,3141577,67.8,2961181,63.9,180396,5.7
7610,June 1988,Hawaii,776000,516864,66.6,500768,64.5,16096,3.1
7611,June 1988,Idaho,716000,478063,66.8,449162,62.7,28901,6.0
7612,June 1988,Illinois,8789000,5818407,66.2,5427535,61.8,390872,6.7
7613,June 1988,Indiana,4190000,2795543,66.7,2649546,63.2,145997,5.2
7614,June 1988,Iowa,2149000,1491470,69.4,1423776,66.3,67694,4.5
7615,June 1988,Kansas,1846000,1273769,69.0,1215720,65.9,58049,4.6
7616,June 1988,Kentucky,2789000,1710187,61.3,1578180,56.6,132007,7.7
7617,June 1988,Louisiana,3169000,1921247,60.6,1710651,54.0,210596,11.0
7618,June 1988,Maine,915000,597172,65.3,575387,62.9,21785,3.6
7619,June 1988,Maryland,3511000,2466861,70.3,2360274,67.2,106587,4.3
7620,June 1988,Massachusetts,4613000,3138041,68.0,3037261,65.8,100780,3.2
7621,June 1988,Michigan,6968000,4541028,65.2,4206260,60.4,334768,7.4
7622,June 1988,Minnesota,3241000,2306060,71.2,2206413,68.1,99647,4.3
7623,June 1988,Mississippi,1885000,1140286,60.5,1046715,55.5,93571,8.2
7624,June 1988,Missouri,3898000,2584787,66.3,2433353,62.4,151434,5.9
7625,June 1988,Montana,596000,404352,67.8,376774,63.2,27578,6.8
7626,June 1988,Nebraska,1189000,813292,68.4,783795,65.9,29497,3.6
7627,June 1988,Nevada,798000,581245,72.8,550557,69.0,30688,5.3
7628,June 1988,New Hampshire,822000,599000,72.9,584796,71.1,14204,2.4
7629,June 1988,New Jersey,6034000,3969135,65.8,3819320,63.3,149815,3.8
7630,June 1988,New Mexico,1083000,685358,63.3,633669,58.5,51689,7.5
7631,June 1988,New York,13806000,8520534,61.7,8170127,59.2,350407,4.1
7632,June 1988,North Carolina,4873000,3306933,67.9,3192655,65.5,114278,3.5
7633,June 1988,North Dakota,482000,330794,68.6,315302,65.4,15492,4.7
7634,June 1988,Ohio,8233000,5311600,64.5,4992026,60.6,319574,6.0
7635,June 1988,Oklahoma,2384000,1523082,63.9,1425261,59.8,97821,6.4
7636,June 1988,Oregon,2121000,1426923,67.3,1343062,63.3,83861,5.9
7637,June 1988,Pennsylvania,9342000,5754821,61.6,5463768,58.5,291053,5.1
7638,June 1988,Rhode Island,768000,521433,67.9,505935,65.9,15498,3.0
7639,June 1988,South Carolina,2532000,1656191,65.4,1578169,62.3,78022,4.7
7640,June 1988,South Dakota,519000,357111,68.8,342689,66.0,14422,4.0
7641,June 1988,Tennessee,3720000,2338301,62.9,2202047,59.2,136254,5.8
7642,June 1988,Texas,12063000,8321207,69.0,7711522,63.9,609685,7.3
7643,June 1988,Utah,1096000,759286,69.3,721615,65.8,37671,5.0
7644,June 1988,Vermont,422000,300776,71.3,292162,69.2,8614,2.9
7645,June 1988,Virginia,4480000,3081230,68.8,2958624,66.0,122606,4.0
7646,June 1988,Washington,3474000,2316681,66.7,2168737,62.4,147944,6.4
7647,June 1988,West Virginia,1441000,746754,51.8,672445,46.7,74309,10.0
7648,June 1988,Wisconsin,3649000,2551847,69.9,2441301,66.9,110546,4.3
7649,June 1988,Wyoming,345000,237969,69.0,222881,64.6,15088,6.3
7650,July 1988,Alabama,3059000,1875827,61.3,1742204,57.0,133623,7.1
7651,July 1988,Alaska,347000,248425,71.6,226462,65.3,21963,8.8
7652,July 1988,Arizona,2576000,1664176,64.6,1556895,60.4,107281,6.4
7653,July 1988,Arkansas,1785000,1110900,62.2,1026348,57.5,84552,7.6
7654,July 1988,California,20999000,14159613,67.4,13406558,63.8,753055,5.3
7655,July 1988,Colorado,2446000,1698386,69.4,1587729,64.9,110657,6.5
7656,July 1988,Connecticut,2519000,1747350,69.4,1694437,67.3,52913,3.0
7657,July 1988,Delaware,501000,349974,69.9,339104,67.7,10870,3.1
7658,July 1988,District of Columbia,466000,331552,71.1,315350,67.7,16202,4.9
7659,July 1988,Florida,9670000,6050327,62.6,5744565,59.4,305762,5.1
7660,July 1988,Georgia,4640000,3146110,67.8,2967420,64.0,178690,5.7
7661,July 1988,Hawaii,777000,517355,66.6,501229,64.5,16126,3.1
7662,July 1988,Idaho,716000,479808,67.0,451307,63.0,28501,5.9
7663,July 1988,Illinois,8793000,5835653,66.4,5448491,62.0,387162,6.6
7664,July 1988,Indiana,4193000,2806139,66.9,2658163,63.4,147976,5.3
7665,July 1988,Iowa,2150000,1495922,69.6,1428534,66.4,67388,4.5
7666,July 1988,Kansas,1847000,1275092,69.0,1217115,65.9,57977,4.5
7667,July 1988,Kentucky,2790000,1714294,61.4,1582980,56.7,131314,7.7
7668,July 1988,Louisiana,3167000,1919061,60.6,1711120,54.0,207941,10.8
7669,July 1988,Maine,916000,599303,65.4,576976,63.0,22327,3.7
7670,July 1988,Maryland,3516000,2472195,70.3,2365696,67.3,106499,4.3
7671,July 1988,Massachusetts,4615000,3141178,68.1,3039485,65.9,101693,3.2
7672,July 1988,Michigan,6971000,4548271,65.2,4216900,60.5,331371,7.3
7673,July 1988,Minnesota,3245000,2310012,71.2,2209998,68.1,100014,4.3
7674,July 1988,Mississippi,1886000,1142284,60.6,1046987,55.5,95297,8.3
7675,July 1988,Missouri,3900000,2587303,66.3,2434437,62.4,152866,5.9
7676,July 1988,Montana,596000,404554,67.9,377539,63.3,27015,6.7
7677,July 1988,Nebraska,1190000,813809,68.4,784699,65.9,29110,3.6
7678,July 1988,Nevada,801000,583965,72.9,553496,69.1,30469,5.2
7679,July 1988,New Hampshire,824000,600625,72.9,585932,71.1,14693,2.4
7680,July 1988,New Jersey,6036000,3970604,65.8,3819959,63.3,150645,3.8
7681,July 1988,New Mexico,1084000,685881,63.3,635087,58.6,50794,7.4
7682,July 1988,New York,13809000,8540340,61.8,8179165,59.2,361175,4.2
7683,July 1988,North Carolina,4879000,3314702,67.9,3200153,65.6,114549,3.5
7684,July 1988,North Dakota,482000,330891,68.6,315348,65.4,15543,4.7
7685,July 1988,Ohio,8239000,5317450,64.5,5001330,60.7,316120,5.9
7686,July 1988,Oklahoma,2383000,1522954,63.9,1424768,59.8,98186,6.4
7687,July 1988,Oregon,2124000,1429798,67.3,1346545,63.4,83253,5.8
7688,July 1988,Pennsylvania,9346000,5766095,61.7,5475643,58.6,290452,5.0
7689,July 1988,Rhode Island,768000,522074,68.0,506300,65.9,15774,3.0
7690,July 1988,South Carolina,2535000,1658628,65.4,1581294,62.4,77334,4.7
7691,July 1988,South Dakota,519000,357242,68.8,342867,66.1,14375,4.0
7692,July 1988,Tennessee,3723000,2341969,62.9,2204389,59.2,137580,5.9
7693,July 1988,Texas,12067000,8330911,69.0,7726706,64.0,604205,7.3
7694,July 1988,Utah,1097000,761231,69.4,723874,66.0,37357,4.9
7695,July 1988,Vermont,423000,301394,71.3,292506,69.2,8888,2.9
7696,July 1988,Virginia,4487000,3086252,68.8,2962029,66.0,124223,4.0
7697,July 1988,Washington,3481000,2325710,66.8,2178218,62.6,147492,6.3
7698,July 1988,West Virginia,1440000,746889,51.9,673546,46.8,73343,9.8
7699,July 1988,Wisconsin,3652000,2559525,70.1,2450309,67.1,109216,4.3
7700,July 1988,Wyoming,345000,238087,69.0,222924,64.6,15163,6.4
7701,August 1988,Alabama,3060000,1880127,61.4,1744160,57.0,135967,7.2
7702,August 1988,Alaska,347000,249041,71.8,227265,65.5,21776,8.7
7703,August 1988,Arizona,2580000,1671095,64.8,1563678,60.6,107417,6.4
7704,August 1988,Arkansas,1786000,1111945,62.3,1027967,57.6,83978,7.6
7705,August 1988,California,21039000,14197171,67.5,13443131,63.9,754040,5.3
7706,August 1988,Colorado,2447000,1696657,69.3,1587964,64.9,108693,6.4
7707,August 1988,Connecticut,2519000,1748587,69.4,1695009,67.3,53578,3.1
7708,August 1988,Delaware,502000,351328,70.0,340080,67.7,11248,3.2
7709,August 1988,District of Columbia,465000,330457,71.1,314488,67.6,15969,4.8
7710,August 1988,Florida,9689000,6067411,62.6,5758678,59.4,308733,5.1
7711,August 1988,Georgia,4645000,3150936,67.8,2973618,64.0,177318,5.6
7712,August 1988,Hawaii,778000,517892,66.6,501614,64.5,16278,3.1
7713,August 1988,Idaho,717000,481552,67.2,453432,63.2,28120,5.8
7714,August 1988,Illinois,8796000,5857983,66.6,5473537,62.2,384446,6.6
7715,August 1988,Indiana,4195000,2817870,67.2,2667865,63.6,150005,5.3
7716,August 1988,Iowa,2150000,1499684,69.8,1432817,66.6,66867,4.5
7717,August 1988,Kansas,1848000,1276918,69.1,1218980,66.0,57938,4.5
7718,August 1988,Kentucky,2791000,1718259,61.6,1587906,56.9,130353,7.6
7719,August 1988,Louisiana,3166000,1917028,60.6,1711938,54.1,205090,10.7
7720,August 1988,Maine,917000,601405,65.6,578693,63.1,22712,3.8
7721,August 1988,Maryland,3520000,2477282,70.4,2371258,67.4,106024,4.3
7722,August 1988,Massachusetts,4615000,3145041,68.1,3041985,65.9,103056,3.3
7723,August 1988,Michigan,6972000,4558014,65.4,4227535,60.6,330479,7.3
7724,August 1988,Minnesota,3247000,2313683,71.3,2213642,68.2,100041,4.3
7725,August 1988,Mississippi,1887000,1145334,60.7,1047918,55.5,97416,8.5
7726,August 1988,Missouri,3901000,2589313,66.4,2436132,62.4,153181,5.9
7727,August 1988,Montana,596000,404819,67.9,378480,63.5,26339,6.5
7728,August 1988,Nebraska,1190000,814293,68.4,785635,66.0,28658,3.5
7729,August 1988,Nevada,804000,586472,72.9,556362,69.2,30110,5.1
7730,August 1988,New Hampshire,825000,602284,73.0,587140,71.2,15144,2.5
7731,August 1988,New Jersey,6036000,3972802,65.8,3821033,63.3,151769,3.8
7732,August 1988,New Mexico,1085000,686506,63.3,636573,58.7,49933,7.3
7733,August 1988,New York,13809000,8561839,62.0,8189447,59.3,372392,4.3
7734,August 1988,North Carolina,4884000,3324416,68.1,3208084,65.7,116332,3.5
7735,August 1988,North Dakota,482000,330986,68.7,315432,65.4,15554,4.7
7736,August 1988,Ohio,8241000,5324762,64.6,5009895,60.8,314867,5.9
7737,August 1988,Oklahoma,2383000,1523688,63.9,1425344,59.8,98344,6.5
7738,August 1988,Oregon,2127000,1433322,67.4,1351057,63.5,82265,5.7
7739,August 1988,Pennsylvania,9348000,5776958,61.8,5487474,58.7,289484,5.0
7740,August 1988,Rhode Island,768000,522626,68.1,506488,65.9,16138,3.1
7741,August 1988,South Carolina,2538000,1660837,65.4,1584445,62.4,76392,4.6
7742,August 1988,South Dakota,519000,357453,68.9,343047,66.1,14406,4.0
7743,August 1988,Tennessee,3726000,2346809,63.0,2207827,59.3,138982,5.9
7744,August 1988,Texas,12080000,8343121,69.1,7742732,64.1,600389,7.2
7745,August 1988,Utah,1098000,763251,69.5,726221,66.1,37030,4.9
7746,August 1988,Vermont,424000,301939,71.2,292745,69.0,9194,3.0
7747,August 1988,Virginia,4492000,3090841,68.8,2965575,66.0,125266,4.1
7748,August 1988,Washington,3487000,2335533,67.0,2189093,62.8,146440,6.3
7749,August 1988,West Virginia,1439000,747305,51.9,674963,46.9,72342,9.7
7750,August 1988,Wisconsin,3654000,2566994,70.3,2458789,67.3,108205,4.2
7751,August 1988,Wyoming,345000,238159,69.0,222904,64.6,15255,6.4
7752,September 1988,Alabama,3061000,1884846,61.6,1746368,57.1,138478,7.3
7753,September 1988,Alaska,348000,249695,71.8,228176,65.6,21519,8.6
7754,September 1988,Arizona,2583000,1678977,65.0,1571515,60.8,107462,6.4
7755,September 1988,Arkansas,1786000,1113411,62.3,1030126,57.7,83285,7.5
7756,September 1988,California,21079000,14234140,67.5,13480410,64.0,753730,5.3
7757,September 1988,Colorado,2449000,1694097,69.2,1587768,64.8,106329,6.3
7758,September 1988,Connecticut,2518000,1749248,69.5,1695515,67.3,53733,3.1
7759,September 1988,Delaware,503000,352390,70.1,340876,67.8,11514,3.3
7760,September 1988,District of Columbia,464000,329097,70.9,313269,67.5,15828,4.8
7761,September 1988,Florida,9708000,6086434,62.7,5773281,59.5,313153,5.1
7762,September 1988,Georgia,4650000,3156254,67.9,2979951,64.1,176303,5.6
7763,September 1988,Hawaii,779000,518414,66.5,501939,64.4,16475,3.2
7764,September 1988,Idaho,718000,483292,67.3,455491,63.4,27801,5.8
7765,September 1988,Illinois,8800000,5882772,66.8,5500643,62.5,382129,6.5
7766,September 1988,Indiana,4197000,2829632,67.4,2678062,63.8,151570,5.4
7767,September 1988,Iowa,2151000,1502821,69.9,1436654,66.8,66167,4.4
7768,September 1988,Kansas,1848000,1278866,69.2,1220986,66.1,57880,4.5
7769,September 1988,Kentucky,2791000,1721656,61.7,1592798,57.1,128858,7.5
7770,September 1988,Louisiana,3165000,1915198,60.5,1712967,54.1,202231,10.6
7771,September 1988,Maine,918000,603165,65.7,580368,63.2,22797,3.8
7772,September 1988,Maryland,3523000,2481759,70.4,2376998,67.5,104761,4.2
7773,September 1988,Massachusetts,4616000,3149355,68.2,3044637,66.0,104718,3.3
7774,September 1988,Michigan,6973000,4568302,65.5,4238129,60.8,330173,7.2
7775,September 1988,Minnesota,3249000,2317501,71.3,2217417,68.2,100084,4.3
7776,September 1988,Mississippi,1887000,1148889,60.9,1049546,55.6,99343,8.6
7777,September 1988,Missouri,3902000,2591456,66.4,2438362,62.5,153094,5.9
7778,September 1988,Montana,596000,405117,68.0,379468,63.7,25649,6.3
7779,September 1988,Nebraska,1191000,814673,68.4,786609,66.0,28064,3.4
7780,September 1988,Nevada,808000,588619,72.8,558935,69.2,29684,5.0
7781,September 1988,New Hampshire,826000,603872,73.1,588398,71.2,15474,2.6
7782,September 1988,New Jersey,6035000,3976074,65.9,3823152,63.3,152922,3.8
7783,September 1988,New Mexico,1086000,687105,63.3,637955,58.7,49150,7.2
7784,September 1988,New York,13808000,8583153,62.2,8199978,59.4,383175,4.5
7785,September 1988,North Carolina,4889000,3334933,68.2,3216184,65.8,118749,3.6
7786,September 1988,North Dakota,481000,331011,68.8,315525,65.6,15486,4.7
7787,September 1988,Ohio,8243000,5332888,64.7,5018570,60.9,314318,5.9
7788,September 1988,Oklahoma,2384000,1524647,64.0,1426738,59.8,97909,6.4
7789,September 1988,Oregon,2130000,1437798,67.5,1356634,63.7,81164,5.6
7790,September 1988,Pennsylvania,9350000,5785989,61.9,5498728,58.8,287261,5.0
7791,September 1988,Rhode Island,768000,523078,68.1,506620,66.0,16458,3.1
7792,September 1988,South Carolina,2540000,1663191,65.5,1587886,62.5,75305,4.5
7793,September 1988,South Dakota,519000,357736,68.9,343275,66.1,14461,4.0
7794,September 1988,Tennessee,3728000,2351906,63.1,2212118,59.3,139788,5.9
7795,September 1988,Texas,12093000,8357125,69.1,7759256,64.2,597869,7.2
7796,September 1988,Utah,1099000,765216,69.6,728600,66.3,36616,4.8
7797,September 1988,Vermont,424000,302428,71.3,292985,69.1,9443,3.1
7798,September 1988,Virginia,4497000,3094761,68.8,2969314,66.0,125447,4.1
7799,September 1988,Washington,3494000,2345732,67.1,2200725,63.0,145007,6.2
7800,September 1988,West Virginia,1439000,748148,52.0,676743,47.0,71405,9.5
7801,September 1988,Wisconsin,3655000,2574305,70.4,2466569,67.5,107736,4.2
7802,September 1988,Wyoming,345000,238169,69.0,222842,64.6,15327,6.4
7803,October 1988,Alabama,3062000,1889098,61.7,1748949,57.1,140149,7.4
7804,October 1988,Alaska,348000,250252,71.9,229094,65.8,21158,8.5
7805,October 1988,Arizona,2587000,1687096,65.2,1580209,61.1,106887,6.3
7806,October 1988,Arkansas,1787000,1115337,62.4,1032759,57.8,82578,7.4
7807,October 1988,California,21119000,14269974,67.6,13519951,64.0,750023,5.3
7808,October 1988,Colorado,2450000,1691004,69.0,1587220,64.8,103784,6.1
7809,October 1988,Connecticut,2518000,1749531,69.5,1696000,67.4,53531,3.1
7810,October 1988,Delaware,503000,353192,70.2,341598,67.9,11594,3.3
7811,October 1988,District of Columbia,463000,327496,70.7,311744,67.3,15752,4.8
7812,October 1988,Florida,9727000,6105757,62.8,5788029,59.5,317728,5.2
7813,October 1988,Georgia,4655000,3161933,67.9,2986775,64.2,175158,5.5
7814,October 1988,Hawaii,780000,518899,66.5,502346,64.4,16553,3.2
7815,October 1988,Idaho,718000,484997,67.5,457469,63.7,27528,5.7
7816,October 1988,Illinois,8803000,5906870,67.1,5528359,62.8,378511,6.4
7817,October 1988,Indiana,4199000,2839623,67.6,2688270,64.0,151353,5.3
7818,October 1988,Iowa,2151000,1505511,70.0,1440209,67.0,65302,4.3
7819,October 1988,Kansas,1849000,1280664,69.3,1222951,66.1,57713,4.5
7820,October 1988,Kentucky,2792000,1724133,61.8,1597641,57.2,126492,7.3
7821,October 1988,Louisiana,3164000,1913293,60.5,1714221,54.2,199072,10.4
7822,October 1988,Maine,919000,604354,65.8,581877,63.3,22477,3.7
7823,October 1988,Maryland,3527000,2485600,70.5,2383037,67.6,102563,4.1
7824,October 1988,Massachusetts,4616000,3153665,68.3,3047280,66.0,106385,3.4
7825,October 1988,Michigan,6974000,4576375,65.6,4248230,60.9,328145,7.2
7826,October 1988,Minnesota,3251000,2321106,71.4,2221344,68.3,99762,4.3
7827,October 1988,Mississippi,1888000,1152164,61.0,1051753,55.7,100411,8.7
7828,October 1988,Missouri,3903000,2593977,66.5,2441259,62.5,152718,5.9
7829,October 1988,Montana,596000,405357,68.0,380320,63.8,25037,6.2
7830,October 1988,Nebraska,1191000,814873,68.4,787572,66.1,27301,3.4
7831,October 1988,Nevada,811000,590377,72.8,561111,69.2,29266,5.0
7832,October 1988,New Hampshire,827000,605278,73.2,589682,71.3,15596,2.6
7833,October 1988,New Jersey,6035000,3980504,66.0,3826988,63.4,153516,3.9
7834,October 1988,New Mexico,1087000,687678,63.3,639217,58.8,48461,7.0
7835,October 1988,New York,13808000,8602025,62.3,8210585,59.5,391440,4.6
7836,October 1988,North Carolina,4894000,3344973,68.3,3224300,65.9,120673,3.6
7837,October 1988,North Dakota,481000,330926,68.8,315606,65.6,15320,4.6
7838,October 1988,Ohio,8245000,5340410,64.8,5028765,61.0,311645,5.8
7839,October 1988,Oklahoma,2384000,1525344,64.0,1428530,59.9,96814,6.3
7840,October 1988,Oregon,2133000,1443220,67.7,1363009,63.9,80211,5.6
7841,October 1988,Pennsylvania,9351000,5792357,61.9,5509398,58.9,282959,4.9
7842,October 1988,Rhode Island,768000,523514,68.2,506806,66.0,16708,3.2
7843,October 1988,South Carolina,2543000,1665817,65.5,1591674,62.6,74143,4.5
7844,October 1988,South Dakota,519000,358028,69.0,343543,66.2,14485,4.0
7845,October 1988,Tennessee,3731000,2355980,63.1,2217152,59.4,138828,5.9
7846,October 1988,Texas,12106000,8371253,69.1,7776661,64.2,594592,7.1
7847,October 1988,Utah,1100000,767055,69.7,730968,66.5,36087,4.7
7848,October 1988,Vermont,425000,302938,71.3,293369,69.0,9569,3.2
7849,October 1988,Virginia,4502000,3098021,68.8,2973566,66.0,124455,4.0
7850,October 1988,Washington,3500000,2355866,67.3,2212543,63.2,143323,6.1
7851,October 1988,West Virginia,1438000,749395,52.1,678920,47.2,70475,9.4
7852,October 1988,Wisconsin,3657000,2581096,70.6,2473551,67.6,107545,4.2
7853,October 1988,Wyoming,345000,238131,69.0,222776,64.6,15355,6.4
7854,November 1988,Alabama,3064000,1892528,61.8,1751991,57.2,140537,7.4
7855,November 1988,Alaska,348000,250628,72.0,229956,66.1,20672,8.2
7856,November 1988,Arizona,2591000,1694620,65.4,1589185,61.3,105435,6.2
7857,November 1988,Arkansas,1787000,1117660,62.5,1035711,58.0,81949,7.3
7858,November 1988,California,21159000,14305473,67.6,13562221,64.1,743252,5.2
7859,November 1988,Colorado,2451000,1687969,68.9,1586577,64.7,101392,6.0
7860,November 1988,Connecticut,2518000,1749922,69.5,1696621,67.4,53301,3.0
7861,November 1988,Delaware,504000,353844,70.2,342348,67.9,11496,3.2
7862,November 1988,District of Columbia,462000,325653,70.5,309956,67.1,15697,4.8
7863,November 1988,Florida,9747000,6124035,62.8,5802480,59.5,321555,5.3
7864,November 1988,Georgia,4661000,3167822,68.0,2993935,64.2,173887,5.5
7865,November 1988,Hawaii,781000,519363,66.5,502976,64.4,16387,3.2
7866,November 1988,Idaho,719000,486565,67.7,459311,63.9,27254,5.6
7867,November 1988,Illinois,8807000,5928582,67.3,5555740,63.1,372842,6.3
7868,November 1988,Indiana,4201000,2846730,67.8,2698106,64.2,148624,5.2
7869,November 1988,Iowa,2151000,1507809,70.1,1443458,67.1,64351,4.3
7870,November 1988,Kansas,1849000,1282163,69.3,1224817,66.2,57346,4.5
7871,November 1988,Kentucky,2792000,1725731,61.8,1602351,57.4,123380,7.1
7872,November 1988,Louisiana,3163000,1911353,60.4,1715836,54.2,195517,10.2
7873,November 1988,Maine,920000,604936,65.8,583125,63.4,21811,3.6
7874,November 1988,Maryland,3530000,2489141,70.5,2389283,67.7,99858,4.0
7875,November 1988,Massachusetts,4616000,3157723,68.4,3049682,66.1,108041,3.4
7876,November 1988,Michigan,6976000,4580584,65.7,4257113,61.0,323471,7.1
7877,November 1988,Minnesota,3253000,2324362,71.5,2225332,68.4,99030,4.3
7878,November 1988,Mississippi,1889000,1154759,61.1,1054310,55.8,100449,8.7
7879,November 1988,Missouri,3904000,2596668,66.5,2444753,62.6,151915,5.9
7880,November 1988,Montana,596000,405509,68.0,380944,63.9,24565,6.1
7881,November 1988,Nebraska,1191000,814971,68.4,788489,66.2,26482,3.2
7882,November 1988,Nevada,815000,591841,72.6,562918,69.1,28923,4.9
7883,November 1988,New Hampshire,829000,606446,73.2,590891,71.3,15555,2.6
7884,November 1988,New Jersey,6035000,3985494,66.0,3832168,63.5,153326,3.8
7885,November 1988,New Mexico,1088000,688226,63.3,640391,58.9,47835,7.0
7886,November 1988,New York,13807000,8617868,62.4,8220962,59.5,396906,4.6
7887,November 1988,North Carolina,4899000,3354065,68.5,3232535,66.0,121530,3.6
7888,November 1988,North Dakota,480000,330771,68.9,315664,65.8,15107,4.6
7889,November 1988,Ohio,8247000,5346076,64.8,5040728,61.1,305348,5.7
7890,November 1988,Oklahoma,2384000,1525473,64.0,1430284,60.0,95189,6.2
7891,November 1988,Oregon,2136000,1449379,67.9,1369706,64.1,79673,5.5
7892,November 1988,Pennsylvania,9353000,5796932,62.0,5519945,59.0,276987,4.8
7893,November 1988,Rhode Island,769000,523993,68.1,507052,65.9,16941,3.2
7894,November 1988,South Carolina,2546000,1668611,65.5,1595658,62.7,72953,4.4
7895,November 1988,South Dakota,519000,358298,69.0,343828,66.2,14470,4.0
7896,November 1988,Tennessee,3733000,2358537,63.2,2222679,59.5,135858,5.8
7897,November 1988,Texas,12119000,8384619,69.2,7794632,64.3,589987,7.0
7898,November 1988,Utah,1101000,768899,69.8,733345,66.6,35554,4.6
7899,November 1988,Vermont,425000,303528,71.4,293949,69.2,9579,3.2
7900,November 1988,Virginia,4507000,3101112,68.8,2978606,66.1,122506,4.0
7901,November 1988,Washington,3507000,2365990,67.5,2224214,63.4,141776,6.0
7902,November 1988,West Virginia,1437000,750961,52.3,681439,47.4,69522,9.3
7903,November 1988,Wisconsin,3658000,2587048,70.7,2479510,67.8,107538,4.2
7904,November 1988,Wyoming,345000,238072,69.0,222761,64.6,15311,6.4
7905,December 1988,Alabama,3065000,1894728,61.8,1755322,57.3,139406,7.4
7906,December 1988,Alaska,348000,250849,72.1,230790,66.3,20059,8.0
7907,December 1988,Arizona,2594000,1700717,65.6,1597683,61.6,103034,6.1
7908,December 1988,Arkansas,1788000,1120121,62.6,1038683,58.1,81438,7.3
7909,December 1988,California,21199000,14339994,67.6,13605181,64.2,734813,5.1
7910,December 1988,Colorado,2452000,1685520,68.7,1586067,64.7,99453,5.9
7911,December 1988,Connecticut,2517000,1750842,69.6,1697464,67.4,53378,3.0
7912,December 1988,Delaware,505000,354475,70.2,343178,68.0,11297,3.2
7913,December 1988,District of Columbia,461000,323596,70.2,307955,66.8,15641,4.8
7914,December 1988,Florida,9766000,6140063,62.9,5815616,59.5,324447,5.3
7915,December 1988,Georgia,4666000,3173269,68.0,3000767,64.3,172502,5.4
7916,December 1988,Hawaii,782000,519854,66.5,503918,64.4,15936,3.1
7917,December 1988,Idaho,720000,487864,67.8,460887,64.0,26977,5.5
7918,December 1988,Illinois,8810000,5947157,67.5,5581684,63.4,365473,6.1
7919,December 1988,Indiana,4203000,2850767,67.8,2707064,64.4,143703,5.0
7920,December 1988,Iowa,2152000,1509514,70.1,1446085,67.2,63429,4.2
7921,December 1988,Kansas,1850000,1283200,69.4,1226515,66.3,56685,4.4
7922,December 1988,Kentucky,2793000,1726576,61.8,1606568,57.5,120008,7.0
7923,December 1988,Louisiana,3162000,1909286,60.4,1717800,54.3,191486,10.0
7924,December 1988,Maine,921000,605119,65.7,584051,63.4,21068,3.5
7925,December 1988,Maryland,3534000,2492749,70.5,2395448,67.8,97301,3.9
7926,December 1988,Massachusetts,4616000,3161312,68.5,3051534,66.1,109778,3.5
7927,December 1988,Michigan,6977000,4580413,65.7,4263836,61.1,316577,6.9
7928,December 1988,Minnesota,3255000,2327380,71.5,2229224,68.5,98156,4.2
7929,December 1988,Mississippi,1889000,1156512,61.2,1056944,56.0,99568,8.6
7930,December 1988,Missouri,3905000,2598449,66.5,2448309,62.7,150140,5.8
7931,December 1988,Montana,596000,405595,68.1,381336,64.0,24259,6.0
7932,December 1988,Nebraska,1192000,815052,68.4,789306,66.2,25746,3.2
7933,December 1988,Nevada,818000,593141,72.5,564457,69.0,28684,4.8
7934,December 1988,New Hampshire,830000,607352,73.2,591844,71.3,15508,2.6
7935,December 1988,New Jersey,6034000,3989500,66.1,3837159,63.6,152341,3.8
7936,December 1988,New Mexico,1089000,688752,63.2,641498,58.9,47254,6.9
7937,December 1988,New York,13807000,8631431,62.5,8230468,59.6,400963,4.6
7938,December 1988,North Carolina,4904000,3362135,68.6,3240766,66.1,121369,3.6
7939,December 1988,North Dakota,480000,330612,68.9,315714,65.8,14898,4.5
7940,December 1988,Ohio,8249000,5349172,64.8,5052919,61.3,296253,5.5
7941,December 1988,Oklahoma,2384000,1524858,64.0,1431578,60.0,93280,6.1
7942,December 1988,Oregon,2139000,1455655,68.1,1376063,64.3,79592,5.5
7943,December 1988,Pennsylvania,9355000,5800898,62.0,5530293,59.1,270605,4.7
7944,December 1988,Rhode Island,769000,524465,68.2,507262,66.0,17203,3.3
7945,December 1988,South Carolina,2548000,1671234,65.6,1599486,62.8,71748,4.3
7946,December 1988,South Dakota,519000,358528,69.1,344096,66.3,14432,4.0
7947,December 1988,Tennessee,3736000,2359453,63.2,2228116,59.6,131337,5.6
7948,December 1988,Texas,12132000,8395820,69.2,7811712,64.4,584108,7.0
7949,December 1988,Utah,1102000,770954,70.0,735783,66.8,35171,4.6
7950,December 1988,Vermont,426000,304183,71.4,294664,69.2,9519,3.1
7951,December 1988,Virginia,4512000,3104481,68.8,2984377,66.1,120104,3.9
7952,December 1988,Washington,3513000,2376345,67.6,2235559,63.6,140786,5.9
7953,December 1988,West Virginia,1436000,752657,52.4,684046,47.6,68611,9.1
7954,December 1988,Wisconsin,3660000,2591958,70.8,2484067,67.9,107891,4.2
7955,December 1988,Wyoming,345000,238007,69.0,222816,64.6,15191,6.4
7956,January 1989,Alabama,3066000,1895757,61.8,1758398,57.4,137359,7.2
7957,January 1989,Alaska,349000,251026,71.9,231682,66.4,19344,7.7
7958,January 1989,Arizona,2598000,1705106,65.6,1605182,61.8,99924,5.9
7959,January 1989,Arkansas,1788000,1122542,62.8,1041488,58.2,81054,7.2
7960,January 1989,California,21238000,14373960,67.7,13647116,64.3,726844,5.1
7961,January 1989,Colorado,2454000,1684245,68.6,1586092,64.6,98153,5.8
7962,January 1989,Connecticut,2517000,1752502,69.6,1698510,67.5,53992,3.1
7963,January 1989,Delaware,506000,355187,70.2,344068,68.0,11119,3.1
7964,January 1989,District of Columbia,460000,321437,69.9,305854,66.5,15583,4.8
7965,January 1989,Florida,9785000,6154514,62.9,5827427,59.6,327087,5.3
7966,January 1989,Georgia,4671000,3178585,68.0,3006819,64.4,171766,5.4
7967,January 1989,Hawaii,783000,520494,66.5,505245,64.5,15249,2.9
7968,January 1989,Idaho,721000,488777,67.8,462088,64.1,26689,5.5
7969,January 1989,Illinois,8813000,5963500,67.7,5605659,63.6,357841,6.0
7970,January 1989,Indiana,4205000,2852800,67.8,2715047,64.6,137753,4.8
7971,January 1989,Iowa,2152000,1510464,70.2,1447868,67.3,62596,4.1
7972,January 1989,Kansas,1850000,1283877,69.4,1228061,66.4,55816,4.3
7973,January 1989,Kentucky,2793000,1727199,61.8,1610284,57.7,116915,6.8
7974,January 1989,Louisiana,3161000,1907154,60.3,1720327,54.4,186827,9.8
7975,January 1989,Maine,922000,605279,65.6,584732,63.4,20547,3.4
7976,January 1989,Maryland,3537000,2496907,70.6,2401369,67.9,95538,3.8
7977,January 1989,Massachusetts,4617000,3164383,68.5,3052664,66.1,111719,3.5
7978,January 1989,Michigan,6978000,4577317,65.6,4267830,61.2,309487,6.8
7979,January 1989,Minnesota,3257000,2330493,71.6,2233045,68.6,97448,4.2
7980,January 1989,Mississippi,1890000,1157777,61.3,1059713,56.1,98064,8.5
7981,January 1989,Missouri,3905000,2599161,66.6,2451725,62.8,147436,5.7
7982,January 1989,Montana,596000,405684,68.1,381592,64.0,24092,5.9
7983,January 1989,Nebraska,1192000,815161,68.4,789984,66.3,25177,3.1
7984,January 1989,Nevada,821000,594464,72.4,565930,68.9,28534,4.8
7985,January 1989,New Hampshire,831000,608090,73.2,592451,71.3,15639,2.6
7986,January 1989,New Jersey,6034000,3991253,66.1,3840649,63.7,150604,3.8
7987,January 1989,New Mexico,1090000,689340,63.2,642603,59.0,46737,6.8
7988,January 1989,New York,13807000,8644324,62.6,8239246,59.7,405078,4.7
7989,January 1989,North Carolina,4909000,3369727,68.6,3249017,66.2,120710,3.6
7990,January 1989,North Dakota,480000,330509,68.9,315807,65.8,14702,4.4
7991,January 1989,Ohio,8250000,5350945,64.9,5063983,61.4,286962,5.4
7992,January 1989,Oklahoma,2385000,1523775,63.9,1432394,60.1,91381,6.0
7993,January 1989,Oregon,2142000,1461376,68.2,1381604,64.5,79772,5.5
7994,January 1989,Pennsylvania,9357000,5805335,62.0,5540228,59.2,265107,4.6
7995,January 1989,Rhode Island,769000,525012,68.3,507492,66.0,17520,3.3
7996,January 1989,South Carolina,2551000,1673777,65.6,1602930,62.8,70847,4.2
7997,January 1989,South Dakota,519000,358749,69.1,344359,66.4,14390,4.0
7998,January 1989,Tennessee,3738000,2359339,63.1,2233365,59.7,125974,5.3
7999,January 1989,Texas,12144000,8404227,69.2,7827072,64.5,577155,6.9
8000,January 1989,Utah,1103000,773427,70.1,738397,66.9,35030,4.5
8001,January 1989,Vermont,426000,304852,71.6,295403,69.3,9449,3.1
8002,January 1989,Virginia,4517000,3109002,68.8,2991010,66.2,117992,3.8
8003,January 1989,Washington,3519000,2387452,67.8,2246919,63.9,140533,5.9
8004,January 1989,West Virginia,1436000,754327,52.5,686493,47.8,67834,9.0
8005,January 1989,Wisconsin,3661000,2595902,70.9,2487171,67.9,108731,4.2
8006,January 1989,Wyoming,345000,237957,69.0,222920,64.6,15037,6.3
8007,February 1989,Alabama,3067000,1895748,61.8,1760225,57.4,135523,7.1
8008,February 1989,Alaska,349000,251303,72.0,232682,66.7,18621,7.4
8009,February 1989,Arizona,2602000,1707866,65.6,1611023,61.9,96843,5.7
8010,February 1989,Arkansas,1789000,1124625,62.9,1043776,58.3,80849,7.2
8011,February 1989,California,21278000,14407606,67.7,13684399,64.3,723207,5.0
8012,February 1989,Colorado,2455000,1684232,68.6,1586753,64.6,97479,5.8
8013,February 1989,Connecticut,2517000,1754759,69.7,1699535,67.5,55224,3.1
8014,February 1989,Delaware,506000,356032,70.4,344913,68.2,11119,3.1
8015,February 1989,District of Columbia,458000,319259,69.7,303734,66.3,15525,4.9
8016,February 1989,Florida,9804000,6167773,62.9,5837274,59.5,330499,5.4
8017,February 1989,Georgia,4676000,3184080,68.1,3011377,64.4,172703,5.4
8018,February 1989,Hawaii,785000,521355,66.4,506892,64.6,14463,2.8
8019,February 1989,Idaho,722000,489220,67.8,462815,64.1,26405,5.4
8020,February 1989,Illinois,8817000,5977693,67.8,5625843,63.8,351850,5.9
8021,February 1989,Indiana,4207000,2854168,67.8,2721741,64.7,132427,4.6
8022,February 1989,Iowa,2152000,1510420,70.2,1448484,67.3,61936,4.1
8023,February 1989,Kansas,1851000,1284203,69.4,1229245,66.4,54958,4.3
8024,February 1989,Kentucky,2794000,1728158,61.9,1613504,57.7,114654,6.6
8025,February 1989,Louisiana,3160000,1904715,60.3,1723028,54.5,181687,9.5
8026,February 1989,Maine,923000,605767,65.6,585224,63.4,20543,3.4
8027,February 1989,Maryland,3541000,2501986,70.7,2406883,68.0,95103,3.8
8028,February 1989,Massachusetts,4617000,3166818,68.6,3052799,66.1,114019,3.6
8029,February 1989,Michigan,6979000,4573285,65.5,4268239,61.2,305046,6.7
8030,February 1989,Minnesota,3259000,2334032,71.6,2236703,68.6,97329,4.2
8031,February 1989,Mississippi,1891000,1158978,61.3,1062654,56.2,96324,8.3
8032,February 1989,Missouri,3906000,2599001,66.5,2454335,62.8,144666,5.6
8033,February 1989,Montana,596000,405938,68.1,381928,64.1,24010,5.9
8034,February 1989,Nebraska,1192000,815342,68.4,790517,66.3,24825,3.0
8035,February 1989,Nevada,825000,595921,72.2,567459,68.8,28462,4.8
8036,February 1989,New Hampshire,832000,608792,73.2,592697,71.2,16095,2.6
8037,February 1989,New Jersey,6034000,3989994,66.1,3841107,63.7,148887,3.7
8038,February 1989,New Mexico,1091000,690023,63.2,643696,59.0,46327,6.7
8039,February 1989,New York,13806000,8656545,62.7,8246117,59.7,410428,4.7
8040,February 1989,North Carolina,4915000,3376653,68.7,3256431,66.3,120222,3.6
8041,February 1989,North Dakota,479000,330493,69.0,315954,66.0,14539,4.4
8042,February 1989,Ohio,8252000,5352865,64.9,5072227,61.5,280638,5.2
8043,February 1989,Oklahoma,2385000,1522614,63.8,1432832,60.1,89782,5.9
8044,February 1989,Oregon,2146000,1465915,68.3,1385804,64.6,80111,5.5
8045,February 1989,Pennsylvania,9358000,5810413,62.1,5548611,59.3,261802,4.5
8046,February 1989,Rhode Island,769000,525540,68.3,507630,66.0,17910,3.4
8047,February 1989,South Carolina,2554000,1676648,65.6,1605876,62.9,70772,4.2
8048,February 1989,South Dakota,519000,359022,69.2,344636,66.4,14386,4.0
8049,February 1989,Tennessee,3741000,2358804,63.1,2237852,59.8,120952,5.1
8050,February 1989,Texas,12157000,8409931,69.2,7839021,64.5,570910,6.8
8051,February 1989,Utah,1105000,776345,70.3,741203,67.1,35142,4.5
8052,February 1989,Vermont,427000,305454,71.5,296030,69.3,9424,3.1
8053,February 1989,Virginia,4523000,3115015,68.9,2998017,66.3,116998,3.8
8054,February 1989,Washington,3526000,2399229,68.0,2258134,64.0,141095,5.9
8055,February 1989,West Virginia,1435000,755816,52.7,688465,48.0,67351,8.9
8056,February 1989,Wisconsin,3663000,2598831,70.9,2488630,67.9,110201,4.2
8057,February 1989,Wyoming,344000,237920,69.2,223021,64.8,14899,6.3
8058,March 1989,Alabama,3068000,1895381,61.8,1760889,57.4,134492,7.1
8059,March 1989,Alaska,349000,251827,72.2,233853,67.0,17974,7.1
8060,March 1989,Arizona,2605000,1709895,65.6,1615431,62.0,94464,5.5
8061,March 1989,Arkansas,1789000,1126180,63.0,1045480,58.4,80700,7.2
8062,March 1989,California,21318000,14441014,67.7,13716858,64.3,724156,5.0
8063,March 1989,Colorado,2456000,1685541,68.6,1588488,64.7,97053,5.8
8064,March 1989,Connecticut,2516000,1757437,69.9,1700549,67.6,56888,3.2
8065,March 1989,Delaware,507000,357021,70.4,345649,68.2,11372,3.2
8066,March 1989,District of Columbia,457000,317170,69.4,301712,66.0,15458,4.9
8067,March 1989,Florida,9823000,6181208,62.9,5846542,59.5,334666,5.4
8068,March 1989,Georgia,4681000,3189612,68.1,3014807,64.4,174805,5.5
8069,March 1989,Hawaii,786000,522435,66.5,508744,64.7,13691,2.6
8070,March 1989,Idaho,723000,489206,67.7,463056,64.0,26150,5.3
8071,March 1989,Illinois,8820000,5988792,67.9,5641204,64.0,347588,5.8
8072,March 1989,Indiana,4209000,2855935,67.9,2727341,64.8,128594,4.5
8073,March 1989,Iowa,2153000,1509767,70.1,1448133,67.3,61634,4.1
8074,March 1989,Kansas,1852000,1284108,69.3,1229932,66.4,54176,4.2
8075,March 1989,Kentucky,2795000,1729654,61.9,1616469,57.8,113185,6.5
8076,March 1989,Louisiana,3159000,1901668,60.2,1725801,54.6,175867,9.2
8077,March 1989,Maine,924000,606864,65.7,585693,63.4,21171,3.5
8078,March 1989,Maryland,3544000,2507624,70.8,2411952,68.1,95672,3.8
8079,March 1989,Massachusetts,4617000,3169212,68.6,3052392,66.1,116820,3.7
8080,March 1989,Michigan,6980000,4570198,65.5,4266143,61.1,304055,6.7
8081,March 1989,Minnesota,3261000,2337986,71.7,2240184,68.7,97802,4.2
8082,March 1989,Mississippi,1891000,1160377,61.4,1065878,56.4,94499,8.1
8083,March 1989,Missouri,3907000,2598867,66.5,2456651,62.9,142216,5.5
8084,March 1989,Montana,596000,406512,68.2,382547,64.2,23965,5.9
8085,March 1989,Nebraska,1193000,815622,68.4,790963,66.3,24659,3.0
8086,March 1989,Nevada,828000,597528,72.2,569127,68.7,28401,4.8
8087,March 1989,New Hampshire,833000,609582,73.2,592690,71.2,16892,2.8
8088,March 1989,New Jersey,6033000,3986549,66.1,3838497,63.6,148052,3.7
8089,March 1989,New Mexico,1092000,690827,63.3,644784,59.0,46043,6.7
8090,March 1989,New York,13806000,8667962,62.8,8251902,59.8,416060,4.8
8091,March 1989,North Carolina,4920000,3382648,68.8,3262641,66.3,120007,3.5
8092,March 1989,North Dakota,479000,330554,69.0,316151,66.0,14403,4.4
8093,March 1989,Ohio,8254000,5355800,64.9,5077685,61.5,278115,5.2
8094,March 1989,Oklahoma,2385000,1521826,63.8,1433339,60.1,88487,5.8
8095,March 1989,Oregon,2149000,1469014,68.4,1388546,64.6,80468,5.5
8096,March 1989,Pennsylvania,9360000,5815765,62.1,5554934,59.3,260831,4.5
8097,March 1989,Rhode Island,769000,525703,68.4,507338,66.0,18365,3.5
8098,March 1989,South Carolina,2556000,1680203,65.7,1608734,62.9,71469,4.3
8099,March 1989,South Dakota,519000,359389,69.2,344953,66.5,14436,4.0
8100,March 1989,Tennessee,3744000,2358678,63.0,2241480,59.9,117198,5.0
8101,March 1989,Texas,12170000,8414266,69.1,7848129,64.5,566137,6.7
8102,March 1989,Utah,1106000,779508,70.5,744150,67.3,35358,4.5
8103,March 1989,Vermont,428000,305932,71.5,296425,69.3,9507,3.1
8104,March 1989,Virginia,4528000,3122765,69.0,3005610,66.4,117155,3.8
8105,March 1989,Washington,3532000,2411648,68.3,2269423,64.3,142225,5.9
8106,March 1989,West Virginia,1434000,756939,52.8,689825,48.1,67114,8.9
8107,March 1989,Wisconsin,3664000,2600731,71.0,2488798,67.9,111933,4.3
8108,March 1989,Wyoming,344000,237866,69.1,223058,64.8,14808,6.2
8109,April 1989,Alabama,3069000,1895503,61.8,1761067,57.4,134436,7.1
8110,April 1989,Alaska,349000,252699,72.4,235209,67.4,17490,6.9
8111,April 1989,Arizona,2609000,1711947,65.6,1618792,62.0,93155,5.4
8112,April 1989,Arkansas,1790000,1127208,63.0,1046781,58.5,80427,7.1
8113,April 1989,California,21358000,14474319,67.8,13745527,64.4,728792,5.0
8114,April 1989,Colorado,2457000,1688108,68.7,1591591,64.8,96517,5.7
8115,April 1989,Connecticut,2516000,1760420,70.0,1701585,67.6,58835,3.3
8116,April 1989,Delaware,508000,358110,70.5,346291,68.2,11819,3.3
8117,April 1989,District of Columbia,456000,315360,69.2,299994,65.8,15366,4.9
8118,April 1989,Florida,9842000,6195415,62.9,5856276,59.5,339139,5.5
8119,April 1989,Georgia,4686000,3194771,68.2,3017710,64.4,177061,5.5
8120,April 1989,Hawaii,787000,523727,66.5,510655,64.9,13072,2.5
8121,April 1989,Idaho,723000,488856,67.6,462933,64.0,25923,5.3
8122,April 1989,Illinois,8824000,5996460,68.0,5651070,64.0,345390,5.8
8123,April 1989,Indiana,4211000,2858230,67.9,2731348,64.9,126882,4.4
8124,April 1989,Iowa,2153000,1508946,70.1,1447123,67.2,61823,4.1
8125,April 1989,Kansas,1852000,1283588,69.3,1230088,66.4,53500,4.2
8126,April 1989,Kentucky,2795000,1731704,62.0,1619195,57.9,112509,6.5
8127,April 1989,Louisiana,3158000,1897679,60.1,1728500,54.7,169179,8.9
8128,April 1989,Maine,925000,608742,65.8,586403,63.4,22339,3.7
8129,April 1989,Maryland,3548000,2513091,70.8,2416523,68.1,96568,3.8
8130,April 1989,Massachusetts,4617000,3171743,68.7,3051541,66.1,120202,3.8
8131,April 1989,Michigan,6981000,4569208,65.5,4262999,61.1,306209,6.7
8132,April 1989,Minnesota,3263000,2342265,71.8,2243495,68.8,98770,4.2
8133,April 1989,Mississippi,1892000,1161998,61.4,1069269,56.5,92729,8.0
8134,April 1989,Missouri,3908000,2599763,66.5,2459090,62.9,140673,5.4
8135,April 1989,Montana,596000,407380,68.4,383449,64.3,23931,5.9
8136,April 1989,Nebraska,1193000,815999,68.4,791408,66.3,24591,3.0
8137,April 1989,Nevada,832000,599187,72.0,570896,68.6,28291,4.7
8138,April 1989,New Hampshire,834000,610515,73.2,592553,71.0,17962,2.9
8139,April 1989,New Jersey,6033000,3982983,66.0,3833913,63.5,149070,3.7
8140,April 1989,New Mexico,1093000,691807,63.3,645882,59.1,45925,6.6
8141,April 1989,New York,13805000,8677599,62.9,8256538,59.8,421061,4.9
8142,April 1989,North Carolina,4925000,3387693,68.8,3267427,66.3,120266,3.6
8143,April 1989,North Dakota,478000,330647,69.2,316358,66.2,14289,4.3
8144,April 1989,Ohio,8256000,5359867,64.9,5080978,61.5,278889,5.2
8145,April 1989,Oklahoma,2385000,1521522,63.8,1433992,60.1,87530,5.8
8146,April 1989,Oregon,2152000,1470520,68.3,1389940,64.6,80580,5.5
8147,April 1989,Pennsylvania,9362000,5821145,62.2,5559202,59.4,261943,4.5
8148,April 1989,Rhode Island,769000,525408,68.3,506511,65.9,18897,3.6
8149,April 1989,South Carolina,2559000,1684455,65.8,1611854,63.0,72601,4.3
8150,April 1989,South Dakota,519000,359825,69.3,345302,66.5,14523,4.0
8151,April 1989,Tennessee,3746000,2359509,63.0,2244143,59.9,115366,4.9
8152,April 1989,Texas,12183000,8418409,69.1,7855400,64.5,563009,6.7
8153,April 1989,Utah,1107000,782636,70.7,747080,67.5,35556,4.5
8154,April 1989,Vermont,428000,306238,71.6,296499,69.3,9739,3.2
8155,April 1989,Virginia,4533000,3131741,69.1,3013541,66.5,118200,3.8
8156,April 1989,Washington,3539000,2424353,68.5,2280867,64.4,143486,5.9
8157,April 1989,West Virginia,1433000,757594,52.9,690668,48.2,66926,8.8
8158,April 1989,Wisconsin,3666000,2601526,71.0,2488004,67.9,113522,4.4
8159,April 1989,Wyoming,344000,237777,69.1,222998,64.8,14779,6.2
8160,May 1989,Alabama,3071000,1896426,61.8,1761200,57.3,135226,7.1
8161,May 1989,Alaska,350000,253871,72.5,236647,67.6,17224,6.8
8162,May 1989,Arizona,2613000,1714131,65.6,1621443,62.1,92688,5.4
8163,May 1989,Arkansas,1790000,1127880,63.0,1047948,58.5,79932,7.1
8164,May 1989,California,21398000,14508099,67.8,13771623,64.4,736476,5.1
8165,May 1989,Colorado,2459000,1691793,68.8,1595907,64.9,95886,5.7
8166,May 1989,Connecticut,2516000,1763835,70.1,1702697,67.7,61138,3.5
8167,May 1989,Delaware,509000,359231,70.6,346869,68.1,12362,3.4
8168,May 1989,District of Columbia,455000,314026,69.0,298778,65.7,15248,4.9
8169,May 1989,Florida,9862000,6210110,63.0,5866481,59.5,343629,5.5
8170,May 1989,Georgia,4692000,3199454,68.2,3020649,64.4,178805,5.6
8171,May 1989,Hawaii,788000,525177,66.6,512481,65.0,12696,2.4
8172,May 1989,Idaho,724000,488381,67.5,462650,63.9,25731,5.3
8173,May 1989,Illinois,8827000,6001567,68.0,5655388,64.1,346179,5.8
8174,May 1989,Indiana,4213000,2860534,67.9,2732711,64.9,127823,4.5
8175,May 1989,Iowa,2153000,1508173,70.0,1445745,67.2,62428,4.1
8176,May 1989,Kansas,1853000,1282972,69.2,1229837,66.4,53135,4.1
8177,May 1989,Kentucky,2796000,1734003,62.0,1621653,58.0,112350,6.5
8178,May 1989,Louisiana,3157000,1892484,59.9,1730762,54.8,161722,8.5
8179,May 1989,Maine,926000,611235,66.0,587441,63.4,23794,3.9
8180,May 1989,Maryland,3551000,2518022,70.9,2420685,68.2,97337,3.9
8181,May 1989,Massachusetts,4618000,3174207,68.7,3050054,66.0,124153,3.9
8182,May 1989,Michigan,6983000,4571591,65.5,4259753,61.0,311838,6.8
8183,May 1989,Minnesota,3265000,2346710,71.9,2246599,68.8,100111,4.3
8184,May 1989,Mississippi,1893000,1163676,61.5,1072524,56.7,91152,7.8
8185,May 1989,Missouri,3909000,2602159,66.6,2461581,63.0,140578,5.4
8186,May 1989,Montana,596000,408390,68.5,384493,64.5,23897,5.9
8187,May 1989,Nebraska,1193000,816432,68.4,791892,66.4,24540,3.0
8188,May 1989,Nevada,835000,600807,72.0,572625,68.6,28182,4.7
8189,May 1989,New Hampshire,836000,611560,73.2,592363,70.9,19197,3.1
8190,May 1989,New Jersey,6033000,3981613,66.0,3829010,63.5,152603,3.8
8191,May 1989,New Mexico,1094000,693058,63.4,647035,59.1,46023,6.6
8192,May 1989,New York,13805000,8684836,62.9,8259412,59.8,425424,4.9
8193,May 1989,North Carolina,4930000,3391836,68.8,3270836,66.3,121000,3.6
8194,May 1989,North Dakota,478000,330722,69.2,316511,66.2,14211,4.3
8195,May 1989,Ohio,8258000,5365453,65.0,5082588,61.5,282865,5.3
8196,May 1989,Oklahoma,2386000,1521375,63.8,1434587,60.1,86788,5.7
8197,May 1989,Oregon,2155000,1470501,68.2,1390149,64.5,80352,5.5
8198,May 1989,Pennsylvania,9364000,5826009,62.2,5561493,59.4,264516,4.5
8199,May 1989,Rhode Island,770000,524811,68.2,505259,65.6,19552,3.7
8200,May 1989,South Carolina,2562000,1689486,65.9,1615102,63.0,74384,4.4
8201,May 1989,South Dakota,519000,360297,69.4,345670,66.6,14627,4.1
8202,May 1989,Tennessee,3749000,2361397,63.0,2245812,59.9,115585,4.9
8203,May 1989,Texas,12196000,8423286,69.1,7861654,64.5,561632,6.7
8204,May 1989,Utah,1108000,785534,70.9,749810,67.7,35724,4.5
8205,May 1989,Vermont,429000,306350,71.4,296239,69.1,10111,3.3
8206,May 1989,Virginia,4538000,3141034,69.2,3021154,66.6,119880,3.8
8207,May 1989,Washington,3545000,2436815,68.7,2292125,64.7,144690,5.9
8208,May 1989,West Virginia,1433000,757874,52.9,691215,48.2,66659,8.8
8209,May 1989,Wisconsin,3667000,2601211,70.9,2486476,67.8,114735,4.4
8210,May 1989,Wyoming,344000,237701,69.1,222908,64.8,14793,6.2
8211,June 1989,Alabama,3072000,1897804,61.8,1761519,57.3,136285,7.2
8212,June 1989,Alaska,350000,255190,72.9,238018,68.0,17172,6.7
8213,June 1989,Arizona,2616000,1716515,65.6,1624082,62.1,92433,5.4
8214,June 1989,Arkansas,1791000,1128429,63.0,1049176,58.6,79253,7.0
8215,June 1989,California,21438000,14542130,67.8,13796845,64.4,745285,5.1
8216,June 1989,Colorado,2460000,1696528,69.0,1601194,65.1,95334,5.6
8217,June 1989,Connecticut,2515000,1767844,70.3,1704025,67.8,63819,3.6
8218,June 1989,Delaware,509000,360290,70.8,347412,68.3,12878,3.6
8219,June 1989,District of Columbia,454000,313226,69.0,298097,65.7,15129,4.8
8220,June 1989,Florida,9881000,6225307,63.0,5877415,59.5,347892,5.6
8221,June 1989,Georgia,4697000,3204276,68.2,3024316,64.4,179960,5.6
8222,June 1989,Hawaii,789000,526707,66.8,514165,65.2,12542,2.4
8223,June 1989,Idaho,725000,488054,67.3,462441,63.8,25613,5.2
8224,June 1989,Illinois,8831000,6004903,68.0,5654824,64.0,350079,5.8
8225,June 1989,Indiana,4215000,2862325,67.9,2730999,64.8,131326,4.6
8226,June 1989,Iowa,2154000,1507728,70.0,1444423,67.1,63305,4.2
8227,June 1989,Kansas,1853000,1282546,69.2,1229443,66.3,53103,4.1
8228,June 1989,Kentucky,2796000,1736253,62.1,1624110,58.1,112143,6.5
8229,June 1989,Louisiana,3156000,1886356,59.8,1732500,54.9,153856,8.2
8230,June 1989,Maine,927000,613915,66.2,588696,63.5,25219,4.1
8231,June 1989,Maryland,3555000,2522473,71.0,2424797,68.2,97676,3.9
8232,June 1989,Massachusetts,4618000,3176582,68.8,3047981,66.0,128601,4.0
8233,June 1989,Michigan,6984000,4577806,65.5,4257333,61.0,320473,7.0
8234,June 1989,Minnesota,3267000,2350913,72.0,2249490,68.9,101423,4.3
8235,June 1989,Mississippi,1893000,1165265,61.6,1075326,56.8,89939,7.7
8236,June 1989,Missouri,3910000,2606209,66.7,2464270,63.0,141939,5.4
8237,June 1989,Montana,596000,409298,68.7,385436,64.7,23862,5.8
8238,June 1989,Nebraska,1194000,816797,68.4,792401,66.4,24396,3.0
8239,June 1989,Nevada,839000,602354,71.8,574197,68.4,28157,4.7
8240,June 1989,New Hampshire,837000,612624,73.2,592169,70.7,20455,3.3
8241,June 1989,New Jersey,6032000,3983899,66.0,3825415,63.4,158484,4.0
8242,June 1989,New Mexico,1095000,694595,63.4,648230,59.2,46365,6.7
8243,June 1989,New York,13804000,8690808,63.0,8260707,59.8,430101,4.9
8244,June 1989,North Carolina,4935000,3395362,68.8,3273706,66.3,121656,3.6
8245,June 1989,North Dakota,477000,330739,69.3,316567,66.4,14172,4.3
8246,June 1989,Ohio,8260000,5373356,65.1,5083535,61.5,289821,5.4
8247,June 1989,Oklahoma,2386000,1521013,63.7,1434983,60.1,86030,5.7
8248,June 1989,Oregon,2158000,1469399,68.1,1389367,64.4,80032,5.4
8249,June 1989,Pennsylvania,9365000,5829814,62.3,5562141,59.4,267673,4.6
8250,June 1989,Rhode Island,770000,524134,68.1,503779,65.4,20355,3.9
8251,June 1989,South Carolina,2564000,1695229,66.1,1618250,63.1,76979,4.5
8252,June 1989,South Dakota,519000,360754,69.5,346063,66.7,14691,4.1
8253,June 1989,Tennessee,3751000,2364477,63.0,2247024,59.9,117453,5.0
8254,June 1989,Texas,12209000,8430102,69.0,7868305,64.4,561797,6.7
8255,June 1989,Utah,1109000,788234,71.1,752360,67.8,35874,4.6
8256,June 1989,Vermont,429000,306296,71.4,295724,68.9,10572,3.5
8257,June 1989,Virginia,4543000,3150143,69.3,3028251,66.7,121892,3.9
8258,June 1989,Washington,3552000,2448832,68.9,2302928,64.8,145904,6.0
8259,June 1989,West Virginia,1432000,757892,52.9,691665,48.3,66227,8.7
8260,June 1989,Wisconsin,3669000,2600065,70.9,2484608,67.7,115457,4.4
8261,June 1989,Wyoming,344000,237653,69.1,222843,64.8,14810,6.2
8262,July 1989,Alabama,3073000,1898750,61.8,1762020,57.3,136730,7.2
8263,July 1989,Alaska,350000,256437,73.3,239151,68.3,17286,6.7
8264,July 1989,Arizona,2620000,1718665,65.6,1626975,62.1,91690,5.3
8265,July 1989,Arkansas,1791000,1128966,63.0,1050383,58.6,78583,7.0
8266,July 1989,California,21478000,14574877,67.9,13821784,64.4,753093,5.2
8267,July 1989,Colorado,2461000,1701988,69.2,1606883,65.3,95105,5.6
8268,July 1989,Connecticut,2515000,1772432,70.5,1705576,67.8,66856,3.8
8269,July 1989,Delaware,510000,361173,70.8,347936,68.2,13237,3.7
8270,July 1989,District of Columbia,453000,312837,69.1,297787,65.7,15050,4.8
8271,July 1989,Florida,9900000,6240543,63.0,5888927,59.5,351616,5.6
8272,July 1989,Georgia,4702000,3209447,68.3,3028941,64.4,180506,5.6
8273,July 1989,Hawaii,790000,528230,66.9,515689,65.3,12541,2.4
8274,July 1989,Idaho,726000,488098,67.2,462492,63.7,25606,5.2
8275,July 1989,Illinois,8834000,6006284,68.0,5649410,64.0,356874,5.9
8276,July 1989,Indiana,4217000,2862604,67.9,2726054,64.6,136550,4.8
8277,July 1989,Iowa,2154000,1507663,70.0,1443449,67.0,64214,4.3
8278,July 1989,Kansas,1854000,1282471,69.2,1229198,66.3,53273,4.2
8279,July 1989,Kentucky,2797000,1738079,62.1,1626633,58.2,111446,6.4
8280,July 1989,Louisiana,3155000,1879563,59.6,1733606,54.9,145957,7.8
8281,July 1989,Maine,928000,616414,66.4,590031,63.6,26383,4.3
8282,July 1989,Maryland,3558000,2526405,71.0,2429034,68.3,97371,3.9
8283,July 1989,Massachusetts,4618000,3178348,68.8,3045125,65.9,133223,4.2
8284,July 1989,Michigan,6985000,4586262,65.7,4256433,60.9,329829,7.2
8285,July 1989,Minnesota,3269000,2354622,72.0,2252096,68.9,102526,4.4
8286,July 1989,Mississippi,1894000,1166579,61.6,1077465,56.9,89114,7.6
8287,July 1989,Missouri,3911000,2611070,66.8,2466967,63.1,144103,5.5
8288,July 1989,Montana,596000,409954,68.8,386134,64.8,23820,5.8
8289,July 1989,Nebraska,1194000,817044,68.4,792877,66.4,24167,3.0
8290,July 1989,Nevada,842000,603937,71.7,575645,68.4,28292,4.7
8291,July 1989,New Hampshire,838000,613712,73.2,592037,70.6,21675,3.5
8292,July 1989,New Jersey,6032000,3989301,66.1,3823825,63.4,165476,4.1
8293,July 1989,New Mexico,1096000,696384,63.5,649529,59.3,46855,6.7
8294,July 1989,New York,13804000,8696915,63.0,8261118,59.8,435797,5.0
8295,July 1989,North Carolina,4940000,3398265,68.8,3276594,66.3,121671,3.6
8296,July 1989,North Dakota,477000,330678,69.3,316514,66.4,14164,4.3
8297,July 1989,Ohio,8262000,5382871,65.2,5084291,61.5,298580,5.5
8298,July 1989,Oklahoma,2386000,1519909,63.7,1434868,60.1,85041,5.6
8299,July 1989,Oregon,2161000,1467584,67.9,1387785,64.2,79799,5.4
8300,July 1989,Pennsylvania,9367000,5832433,62.3,5561067,59.4,271366,4.7
8301,July 1989,Rhode Island,770000,523698,68.0,502338,65.2,21360,4.1
8302,July 1989,South Carolina,2567000,1701194,66.3,1621055,63.1,80139,4.7
8303,July 1989,South Dakota,519000,361162,69.6,346469,66.8,14693,4.1
8304,July 1989,Tennessee,3754000,2368099,63.1,2248095,59.9,120004,5.1
8305,July 1989,Texas,12222000,8439188,69.0,7876342,64.4,562846,6.7
8306,July 1989,Utah,1110000,790813,71.2,754791,68.0,36022,4.6
8307,July 1989,Vermont,430000,306150,71.2,295093,68.6,11057,3.6
8308,July 1989,Virginia,4548000,3158362,69.4,3034479,66.7,123883,3.9
8309,July 1989,Washington,3558000,2460189,69.1,2313096,65.0,147093,6.0
8310,July 1989,West Virginia,1431000,757703,52.9,692109,48.4,65594,8.7
8311,July 1989,Wisconsin,3670000,2597959,70.8,2482551,67.6,115408,4.4
8312,July 1989,Wyoming,344000,237654,69.1,222853,64.8,14801,6.2
8313,August 1989,Alabama,3075000,1898557,61.7,1762936,57.3,135621,7.1
8314,August 1989,Alaska,350000,257491,73.6,239976,68.6,17515,6.8
8315,August 1989,Arizona,2624000,1720625,65.6,1630335,62.1,90290,5.2
8316,August 1989,Arkansas,1791000,1129576,63.1,1051615,58.7,77961,6.9
8317,August 1989,California,21518000,14605479,67.9,13846993,64.4,758486,5.2
8318,August 1989,Colorado,2462000,1707760,69.4,1612545,65.5,95215,5.6
8319,August 1989,Connecticut,2515000,1777441,70.7,1707336,67.9,70105,3.9
8320,August 1989,Delaware,510000,361783,70.9,348377,68.3,13406,3.7
8321,August 1989,District of Columbia,452000,312717,69.2,297679,65.9,15038,4.8
8322,August 1989,Florida,9919000,6256379,63.1,5901911,59.5,354468,5.7
8323,August 1989,Georgia,4708000,3214885,68.3,3034748,64.5,180137,5.6
8324,August 1989,Hawaii,791000,529641,67.0,516989,65.4,12652,2.4
8325,August 1989,Idaho,727000,488611,67.2,462928,63.7,25683,5.3
8326,August 1989,Illinois,8837000,6005738,68.0,5640768,63.8,364970,6.1
8327,August 1989,Indiana,4219000,2860860,67.8,2718897,64.4,141963,5.0
8328,August 1989,Iowa,2154000,1507796,70.0,1442964,67.0,64832,4.3
8329,August 1989,Kansas,1854000,1282922,69.2,1229437,66.3,53485,4.2
8330,August 1989,Kentucky,2798000,1739490,62.2,1629305,58.2,110185,6.3
8331,August 1989,Louisiana,3154000,1872456,59.4,1734342,55.0,138114,7.4
8332,August 1989,Maine,929000,618585,66.6,591414,63.7,27171,4.4
8333,August 1989,Maryland,3562000,2530328,71.0,2433521,68.3,96807,3.8
8334,August 1989,Massachusetts,4618000,3179368,68.8,3041667,65.9,137701,4.3
8335,August 1989,Michigan,6987000,4595846,65.8,4257130,60.9,338716,7.4
8336,August 1989,Minnesota,3272000,2357812,72.1,2254503,68.9,103309,4.4
8337,August 1989,Mississippi,1894000,1167824,61.7,1079120,57.0,88704,7.6
8338,August 1989,Missouri,3912000,2615941,66.9,2469865,63.1,146076,5.6
8339,August 1989,Montana,596000,410333,68.8,386625,64.9,23708,5.8
8340,August 1989,Nebraska,1194000,817208,68.4,793331,66.4,23877,2.9
8341,August 1989,Nevada,846000,605830,71.6,577284,68.2,28546,4.7
8342,August 1989,New Hampshire,839000,614831,73.3,591960,70.6,22871,3.7
8343,August 1989,New Jersey,6032000,3996287,66.3,3824296,63.4,171991,4.3
8344,August 1989,New Mexico,1097000,698415,63.7,651118,59.4,47297,6.8
8345,August 1989,New York,13804000,8704437,63.1,8262776,59.9,441661,5.1
8346,August 1989,North Carolina,4945000,3400844,68.8,3280093,66.3,120751,3.6
8347,August 1989,North Dakota,477000,330535,69.3,316382,66.3,14153,4.3
8348,August 1989,Ohio,8264000,5392631,65.3,5084712,61.5,307919,5.7
8349,August 1989,Oklahoma,2387000,1518283,63.6,1434186,60.1,84097,5.5
8350,August 1989,Oregon,2164000,1465501,67.7,1386022,64.0,79479,5.4
8351,August 1989,Pennsylvania,9369000,5833935,62.3,5558360,59.3,275575,4.7
8352,August 1989,Rhode Island,770000,523671,68.0,501099,65.1,22572,4.3
8353,August 1989,South Carolina,2570000,1706675,66.4,1623573,63.2,83102,4.9
8354,August 1989,South Dakota,519000,361553,69.7,346910,66.8,14643,4.1
8355,August 1989,Tennessee,3756000,2371246,63.1,2249240,59.9,122006,5.1
8356,August 1989,Texas,12235000,8449365,69.1,7886829,64.5,562536,6.7
8357,August 1989,Utah,1112000,793347,71.3,757197,68.1,36150,4.6
8358,August 1989,Vermont,431000,306001,71.0,294498,68.3,11503,3.8
8359,August 1989,Virginia,4553000,3165612,69.5,3040022,66.8,125590,4.0
8360,August 1989,Washington,3564000,2470770,69.3,2323074,65.2,147696,6.0
8361,August 1989,West Virginia,1430000,757448,53.0,692638,48.4,64810,8.6
8362,August 1989,Wisconsin,3671000,2595277,70.7,2480624,67.6,114653,4.4
8363,August 1989,Wyoming,344000,237692,69.1,222974,64.8,14718,6.2
8364,September 1989,Alabama,3076000,1897353,61.7,1764275,57.4,133078,7.0
8365,September 1989,Alaska,351000,258373,73.6,240573,68.5,17800,6.9
8366,September 1989,Arizona,2627000,1723378,65.6,1634548,62.2,88830,5.2
8367,September 1989,Arkansas,1792000,1130304,63.1,1052983,58.8,77321,6.8
8368,September 1989,California,21560000,14634001,67.9,13872633,64.3,761368,5.2
8369,September 1989,Colorado,2463000,1713449,69.6,1618094,65.7,95355,5.6
8370,September 1989,Connecticut,2515000,1782578,70.9,1709205,68.0,73373,4.1
8371,September 1989,Delaware,511000,362071,70.9,348626,68.2,13445,3.7
8372,September 1989,District of Columbia,451000,312780,69.4,297649,66.0,15131,4.8
8373,September 1989,Florida,9939000,6274065,63.1,5917542,59.5,356523,5.7
8374,September 1989,Georgia,4713000,3220799,68.3,3041816,64.5,178983,5.6
8375,September 1989,Hawaii,793000,530904,66.9,518038,65.3,12866,2.4
8376,September 1989,Idaho,728000,489513,67.2,463760,63.7,25753,5.3
8377,September 1989,Illinois,8841000,6003405,67.9,5631272,63.7,372133,6.2
8378,September 1989,Indiana,4222000,2857692,67.7,2711314,64.2,146378,5.1
8379,September 1989,Iowa,2155000,1507853,70.0,1442954,67.0,64899,4.3
8380,September 1989,Kansas,1855000,1283883,69.2,1230360,66.3,53523,4.2
8381,September 1989,Kentucky,2798000,1740746,62.2,1632219,58.3,108527,6.2
8382,September 1989,Louisiana,3153000,1865666,59.2,1735141,55.0,130525,7.0
8383,September 1989,Maine,930000,620413,66.7,592811,63.7,27602,4.4
8384,September 1989,Maryland,3566000,2534898,71.1,2438391,68.4,96507,3.8
8385,September 1989,Massachusetts,4618000,3180320,68.9,3038252,65.8,142068,4.5
8386,September 1989,Michigan,6988000,4605649,65.9,4258388,60.9,347261,7.5
8387,September 1989,Minnesota,3274000,2360970,72.1,2256959,68.9,104011,4.4
8388,September 1989,Mississippi,1895000,1169464,61.7,1080609,57.0,88855,7.6
8389,September 1989,Missouri,3913000,2620615,67.0,2473255,63.2,147360,5.6
8390,September 1989,Montana,597000,410421,68.7,386931,64.8,23490,5.7
8391,September 1989,Nebraska,1195000,817362,68.4,793866,66.4,23496,2.9
8392,September 1989,Nevada,849000,608234,71.6,579453,68.3,28781,4.7
8393,September 1989,New Hampshire,840000,615914,73.3,591827,70.5,24087,3.9
8394,September 1989,New Jersey,6032000,4003458,66.4,3826460,63.4,176998,4.4
8395,September 1989,New Mexico,1098000,700502,63.8,652974,59.5,47528,6.8
8396,September 1989,New York,13805000,8715162,63.1,8268108,59.9,447054,5.1
8397,September 1989,North Carolina,4951000,3403965,68.8,3284745,66.3,119220,3.5
8398,September 1989,North Dakota,477000,330339,69.3,316241,66.3,14098,4.3
8399,September 1989,Ohio,8266000,5401220,65.3,5084741,61.5,316479,5.9
8400,September 1989,Oklahoma,2387000,1516711,63.5,1433271,60.0,83440,5.5
8401,September 1989,Oregon,2168000,1463869,67.5,1384843,63.9,79026,5.4
8402,September 1989,Pennsylvania,9372000,5834687,62.3,5554512,59.3,280175,4.8
8403,September 1989,Rhode Island,770000,524033,68.1,500069,64.9,23964,4.6
8404,September 1989,South Carolina,2573000,1711165,66.5,1626043,63.2,85122,5.0
8405,September 1989,South Dakota,519000,361949,69.7,347415,66.9,14534,4.0
8406,September 1989,Tennessee,3759000,2373669,63.1,2250744,59.9,122925,5.2
8407,September 1989,Texas,12249000,8459907,69.1,7900223,64.5,559684,6.6
8408,September 1989,Utah,1113000,795941,71.5,759721,68.3,36220,4.6
8409,September 1989,Vermont,431000,305906,71.0,294029,68.2,11877,3.9
8410,September 1989,Virginia,4558000,3172338,69.6,3045582,66.8,126756,4.0
8411,September 1989,Washington,3571000,2480510,69.5,2333517,65.3,146993,5.9
8412,September 1989,West Virginia,1429000,757219,53.0,693268,48.5,63951,8.4
8413,September 1989,Wisconsin,3673000,2592777,70.6,2479188,67.5,113589,4.4
8414,September 1989,Wyoming,344000,237705,69.1,223185,64.9,14520,6.1
8415,October 1989,Alabama,3078000,1896234,61.6,1765879,57.4,130355,6.9
8416,October 1989,Alaska,351000,259214,73.9,241131,68.7,18083,7.0
8417,October 1989,Arizona,2631000,1728286,65.7,1640261,62.3,88025,5.1
8418,October 1989,Arkansas,1793000,1131280,63.1,1054598,58.8,76682,6.8
8419,October 1989,California,21602000,14663391,67.9,13900384,64.3,763007,5.2
8420,October 1989,Colorado,2465000,1719132,69.7,1623891,65.9,95241,5.5
8421,October 1989,Connecticut,2515000,1787830,71.1,1711219,68.0,76611,4.3
8422,October 1989,Delaware,512000,362043,70.7,348613,68.1,13430,3.7
8423,October 1989,District of Columbia,450000,312998,69.6,297601,66.1,15397,4.9
8424,October 1989,Florida,9959000,6295683,63.2,5937336,59.6,358347,5.7
8425,October 1989,Georgia,4719000,3227715,68.4,3050536,64.6,177179,5.5
8426,October 1989,Hawaii,794000,532121,67.0,518943,65.4,13178,2.5
8427,October 1989,Idaho,729000,490651,67.3,464909,63.8,25742,5.2
8428,October 1989,Illinois,8845000,6000211,67.8,5623373,63.6,376838,6.3
8429,October 1989,Indiana,4224000,2854759,67.6,2705303,64.0,149456,5.2
8430,October 1989,Iowa,2156000,1507947,69.9,1443521,67.0,64426,4.3
8431,October 1989,Kansas,1856000,1285364,69.3,1232107,66.4,53257,4.1
8432,October 1989,Kentucky,2799000,1742277,62.2,1635780,58.4,106497,6.1
8433,October 1989,Louisiana,3153000,1860225,59.0,1736583,55.1,123642,6.6
8434,October 1989,Maine,931000,622015,66.8,594205,63.8,27810,4.5
8435,October 1989,Maryland,3570000,2540355,71.2,2443983,68.5,96372,3.8
8436,October 1989,Massachusetts,4619000,3182335,68.9,3035814,65.7,146521,4.6
8437,October 1989,Michigan,6990000,4614798,66.0,4260219,60.9,354579,7.7
8438,October 1989,Minnesota,3276000,2364936,72.2,2259807,69.0,105129,4.4
8439,October 1989,Mississippi,1896000,1171858,61.8,1082446,57.1,89412,7.6
8440,October 1989,Missouri,3914000,2626023,67.1,2478057,63.3,147966,5.6
8441,October 1989,Montana,597000,410360,68.7,387174,64.9,23186,5.7
8442,October 1989,Nebraska,1195000,817574,68.4,794624,66.5,22950,2.8
8443,October 1989,Nevada,853000,611232,71.7,582310,68.3,28922,4.7
8444,October 1989,New Hampshire,842000,616988,73.3,591566,70.3,25422,4.1
8445,October 1989,New Jersey,6032000,4010333,66.5,3830272,63.5,180061,4.5
8446,October 1989,New Mexico,1099000,702431,63.9,654950,59.6,47481,6.8
8447,October 1989,New York,13806000,8731611,63.2,8279526,60.0,452085,5.2
8448,October 1989,North Carolina,4956000,3409109,68.8,3291374,66.4,117735,3.5
8449,October 1989,North Dakota,476000,330156,69.4,316188,66.4,13968,4.2
8450,October 1989,Ohio,8269000,5406978,65.4,5085249,61.5,321729,6.0
8451,October 1989,Oklahoma,2388000,1515902,63.5,1432882,60.0,83020,5.5
8452,October 1989,Oregon,2171000,1463364,67.4,1384869,63.8,78495,5.4
8453,October 1989,Pennsylvania,9374000,5835963,62.3,5550882,59.2,285081,4.9
8454,October 1989,Rhode Island,770000,524531,68.1,499242,64.8,25289,4.8
8455,October 1989,South Carolina,2576000,1714788,66.6,1629045,63.2,85743,5.0
8456,October 1989,South Dakota,519000,362384,69.8,348028,67.1,14356,4.0
8457,October 1989,Tennessee,3762000,2375918,63.2,2253324,59.9,122594,5.2
8458,October 1989,Texas,12263000,8472561,69.1,7917719,64.6,554842,6.5
8459,October 1989,Utah,1114000,798678,71.7,762463,68.4,36215,4.5
8460,October 1989,Vermont,432000,305909,70.8,293710,68.0,12199,4.0
8461,October 1989,Virginia,4564000,3179602,69.7,3052453,66.9,127149,4.0
8462,October 1989,Washington,3577000,2489990,69.6,2345063,65.6,144927,5.8
8463,October 1989,West Virginia,1429000,757061,53.0,694036,48.6,63025,8.3
8464,October 1989,Wisconsin,3675000,2591204,70.5,2478571,67.4,112633,4.3
8465,October 1989,Wyoming,344000,237645,69.1,223438,65.0,14207,6.0
8466,November 1989,Alabama,3079000,1895789,61.6,1767521,57.4,128268,6.8
8467,November 1989,Alaska,351000,260171,74.1,241829,68.9,18342,7.0
8468,November 1989,Arizona,2635000,1735793,65.9,1647543,62.5,88250,5.1
8469,November 1989,Arkansas,1793000,1132401,63.2,1056246,58.9,76155,6.7
8470,November 1989,California,21642000,14694027,67.9,13929078,64.4,764949,5.2
8471,November 1989,Colorado,2466000,1724800,69.9,1630010,66.1,94790,5.5
8472,November 1989,Connecticut,2515000,1793157,71.3,1713325,68.1,79832,4.5
8473,November 1989,Delaware,513000,361747,70.5,348323,67.9,13424,3.7
8474,November 1989,District of Columbia,449000,313279,69.8,297395,66.2,15884,5.1
8475,November 1989,Florida,9979000,6321170,63.3,5960660,59.7,360510,5.7
8476,November 1989,Georgia,4724000,3235443,68.5,3060663,64.8,174780,5.4
8477,November 1989,Hawaii,795000,533499,67.1,519925,65.4,13574,2.5
8478,November 1989,Idaho,730000,491843,67.4,466170,63.9,25673,5.2
8479,November 1989,Illinois,8849000,5995716,67.8,5617681,63.5,378035,6.3
8480,November 1989,Indiana,4226000,2852671,67.5,2701340,63.9,151331,5.3
8481,November 1989,Iowa,2156000,1508303,70.0,1444640,67.0,63663,4.2
8482,November 1989,Kansas,1856000,1287285,69.4,1234482,66.5,52803,4.1
8483,November 1989,Kentucky,2800000,1744219,62.3,1639910,58.6,104309,6.0
8484,November 1989,Louisiana,3152000,1856445,58.9,1738633,55.2,117812,6.3
8485,November 1989,Maine,932000,623498,66.9,595590,63.9,27908,4.5
8486,November 1989,Maryland,3573000,2546513,71.3,2450376,68.6,96137,3.8
8487,November 1989,Massachusetts,4619000,3185799,69.0,3034507,65.7,151292,4.7
8488,November 1989,Michigan,6991000,4621376,66.1,4262099,61.0,359277,7.8
8489,November 1989,Minnesota,3278000,2369848,72.3,2263155,69.0,106693,4.5
8490,November 1989,Mississippi,1897000,1174820,61.9,1084854,57.2,89966,7.7
8491,November 1989,Missouri,3915000,2632445,67.2,2484325,63.5,148120,5.6
8492,November 1989,Montana,597000,410326,68.7,387480,64.9,22846,5.6
8493,November 1989,Nebraska,1195000,817950,68.4,795697,66.6,22253,2.7
8494,November 1989,Nevada,856000,614660,71.8,585709,68.4,28951,4.7
8495,November 1989,New Hampshire,843000,618056,73.3,591167,70.1,26889,4.4
8496,November 1989,New Jersey,6032000,4016782,66.6,3835248,63.6,181534,4.5
8497,November 1989,New Mexico,1100000,704107,64.0,656906,59.7,47201,6.7
8498,November 1989,New York,13806000,8752551,63.4,8296356,60.1,456195,5.2
8499,November 1989,North Carolina,4961000,3416638,68.9,3299819,66.5,116819,3.4
8500,November 1989,North Dakota,476000,330041,69.3,316293,66.4,13748,4.2
8501,November 1989,Ohio,8271000,5409178,65.4,5086895,61.5,322283,6.0
8502,November 1989,Oklahoma,2388000,1516251,63.5,1433415,60.0,82836,5.5
8503,November 1989,Oregon,2174000,1464019,67.3,1386256,63.8,77763,5.3
8504,November 1989,Pennsylvania,9376000,5837975,62.3,5548052,59.2,289923,5.0
8505,November 1989,Rhode Island,770000,524865,68.2,498533,64.7,26332,5.0
8506,November 1989,South Carolina,2579000,1717887,66.6,1632929,63.3,84958,4.9
8507,November 1989,South Dakota,519000,362879,69.9,348756,67.2,14123,3.9
8508,November 1989,Tennessee,3764000,2378097,63.2,2256924,60.0,121173,5.1
8509,November 1989,Texas,12276000,8487907,69.1,7939082,64.7,548825,6.5
8510,November 1989,Utah,1115000,801508,71.9,765378,68.6,36130,4.5
8511,November 1989,Vermont,433000,306021,70.7,293532,67.8,12489,4.1
8512,November 1989,Virginia,4569000,3187536,69.8,3060811,67.0,126725,4.0
8513,November 1989,Washington,3584000,2499262,69.7,2357408,65.8,141854,5.7
8514,November 1989,West Virginia,1428000,756909,53.0,694885,48.7,62024,8.2
8515,November 1989,Wisconsin,3677000,2590536,70.5,2478651,67.4,111885,4.3
8516,November 1989,Wyoming,344000,237515,69.0,223673,65.0,13842,5.8
8517,December 1989,Alabama,3080000,1896617,61.6,1769292,57.4,127325,6.7
8518,December 1989,Alaska,351000,261339,74.5,242756,69.2,18583,7.1
8519,December 1989,Arizona,2638000,1745692,66.2,1656055,62.8,89637,5.1
8520,December 1989,Arkansas,1794000,1133443,63.2,1057621,59.0,75822,6.7
8521,December 1989,California,21680000,14726368,67.9,13957119,64.4,769249,5.2
8522,December 1989,Colorado,2467000,1730593,70.1,1636478,66.3,94115,5.4
8523,December 1989,Connecticut,2514000,1798515,71.5,1715489,68.2,83026,4.6
8524,December 1989,Delaware,513000,361266,70.4,347809,67.8,13457,3.7
8525,December 1989,District of Columbia,448000,313492,70.0,296923,66.3,16569,5.3
8526,December 1989,Florida,9997000,6349625,63.5,5986289,59.9,363336,5.7
8527,December 1989,Georgia,4729000,3243908,68.6,3071636,65.0,172272,5.3
8528,December 1989,Hawaii,796000,535275,67.2,521242,65.5,14033,2.6
8529,December 1989,Idaho,730000,492845,67.5,467251,64.0,25594,5.2
8530,December 1989,Illinois,8851000,5989706,67.7,5614040,63.4,375666,6.3
8531,December 1989,Indiana,4228000,2850949,67.4,2698662,63.8,152287,5.3
8532,December 1989,Iowa,2156000,1509266,70.0,1446332,67.1,62934,4.2
8533,December 1989,Kansas,1856000,1289559,69.5,1237199,66.7,52360,4.1
8534,December 1989,Kentucky,2800000,1746569,62.4,1644234,58.7,102335,5.9
8535,December 1989,Louisiana,3150000,1854383,58.9,1741129,55.3,113254,6.1
8536,December 1989,Maine,933000,624902,67.0,596968,64.0,27934,4.5
8537,December 1989,Maryland,3577000,2553028,71.4,2457293,68.7,95735,3.7
8538,December 1989,Massachusetts,4619000,3190800,69.1,3034102,65.7,156698,4.9
8539,December 1989,Michigan,6992000,4624637,66.1,4263778,61.0,360859,7.8
8540,December 1989,Minnesota,3280000,2375231,72.4,2266859,69.1,108372,4.6
8541,December 1989,Mississippi,1897000,1178012,62.1,1087790,57.3,90222,7.7
8542,December 1989,Missouri,3916000,2639876,67.4,2491836,63.6,148040,5.6
8543,December 1989,Montana,597000,410493,68.8,387942,65.0,22551,5.5
8544,December 1989,Nebraska,1195000,818625,68.5,797132,66.7,21493,2.6
8545,December 1989,Nevada,859000,618205,72.0,589296,68.6,28909,4.7
8546,December 1989,New Hampshire,844000,619090,73.4,590684,70.0,28406,4.6
8547,December 1989,New Jersey,6031000,4023291,66.7,3840952,63.7,182339,4.5
8548,December 1989,New Mexico,1101000,705620,64.1,658818,59.8,46802,6.6
8549,December 1989,New York,13804000,8775180,63.6,8316742,60.2,458438,5.2
8550,December 1989,North Carolina,4966000,3426505,69.0,3309591,66.6,116914,3.4
8551,December 1989,North Dakota,475000,330041,69.5,316586,66.6,13455,4.1
8552,December 1989,Ohio,8272000,5409696,65.4,5090695,61.5,319001,5.9
8553,December 1989,Oklahoma,2388000,1517849,63.6,1434940,60.1,82909,5.5
8554,December 1989,Oregon,2177000,1465798,67.3,1388940,63.8,76858,5.2
8555,December 1989,Pennsylvania,9377000,5840537,62.3,5546309,59.1,294228,5.0
8556,December 1989,Rhode Island,770000,524916,68.2,497782,64.6,27134,5.2
8557,December 1989,South Carolina,2581000,1721004,66.7,1637819,63.5,83185,4.8
8558,December 1989,South Dakota,519000,363430,70.0,349562,67.4,13868,3.8
8559,December 1989,Tennessee,3767000,2381015,63.2,2261152,60.0,119863,5.0
8560,December 1989,Texas,12288000,8506920,69.2,7963451,64.8,543469,6.4
8561,December 1989,Utah,1116000,804375,72.1,768336,68.8,36039,4.5
8562,December 1989,Vermont,433000,306236,70.7,293448,67.8,12788,4.2
8563,December 1989,Virginia,4574000,3196039,69.9,3070269,67.1,125770,3.9
8564,December 1989,Washington,3590000,2508205,69.9,2369661,66.0,138544,5.5
8565,December 1989,West Virginia,1427000,756772,53.0,695832,48.8,60940,8.1
8566,December 1989,Wisconsin,3678000,2590304,70.4,2479236,67.4,111068,4.3
8567,December 1989,Wyoming,343000,237327,69.2,223842,65.3,13485,5.7
8568,January 1990,Alabama,3038768,1898813,62.5,1771490,58.3,127323,6.7
8569,January 1990,Alaska,373447,262727,70.4,243924,65.3,18803,7.2
8570,January 1990,Arizona,2760367,1757053,63.7,1665261,60.3,91792,5.2
8571,January 1990,Arkansas,1764477,1134088,64.3,1058429,60.0,75659,6.7
8572,January 1990,California,22570807,15006699,66.5,14230583,63.0,776116,5.2
8573,January 1990,Colorado,2485722,1736587,69.9,1643233,66.1,93354,5.4
8574,January 1990,Connecticut,2565499,1803791,70.3,1717774,67.0,86017,4.8
8575,January 1990,Delaware,507890,360679,71.0,347179,68.4,13500,3.7
8576,January 1990,District of Columbia,479027,327071,68.3,309690,64.6,17381,5.3
8577,January 1990,Florida,10226482,6379104,62.4,6012545,58.8,366559,5.7
8578,January 1990,Georgia,4828841,3252551,67.4,3082738,63.8,169813,5.2
8579,January 1990,Hawaii,796692,537573,67.5,523060,65.7,14513,2.7
8580,January 1990,Idaho,723300,493461,68.2,467890,64.7,25571,5.2
8581,January 1990,Illinois,8626256,5981491,69.3,5611552,65.1,369939,6.2
8582,January 1990,Indiana,4124937,2848060,69.0,2695795,65.4,152265,5.3
8583,January 1990,Iowa,2077928,1459352,70.2,1396876,67.2,62476,4.3
8584,January 1990,Kansas,1816636,1269120,69.9,1217134,67.0,51986,4.1
8585,January 1990,Kentucky,2773133,1749107,63.1,1648168,59.4,100939,5.8
8586,January 1990,Louisiana,3036885,1853830,61.0,1743894,57.4,109936,5.9
8587,January 1990,Maine,932425,626301,67.2,598373,64.2,27928,4.5
8588,January 1990,Maryland,3682846,2559517,69.5,2464193,66.9,95324,3.7
8589,January 1990,Massachusetts,4698654,3196828,68.0,3034108,64.6,162720,5.1
8590,January 1990,Michigan,6983323,4624898,66.2,4265990,61.1,358908,7.8
8591,January 1990,Minnesota,3252901,2380233,73.2,2270552,69.8,109681,4.6
8592,January 1990,Mississippi,1866450,1180822,63.3,1090888,58.4,89934,7.6
8593,January 1990,Missouri,3836961,2603785,67.9,2456764,64.0,147021,5.6
8594,January 1990,Montana,595182,410956,69.0,388570,65.3,22386,5.4
8595,January 1990,Nebraska,1154685,819635,71.0,798886,69.2,20749,2.5
8596,January 1990,Nevada,925103,645004,69.7,616135,66.6,28869,4.5
8597,January 1990,New Hampshire,841184,620015,73.7,590121,70.2,29894,4.8
8598,January 1990,New Jersey,6006438,4030356,67.1,3847050,64.0,183306,4.5
8599,January 1990,New Mexico,1113854,707122,63.5,660756,59.3,46366,6.6
8600,January 1990,New York,14020363,8796154,62.7,8338055,59.5,458099,5.2
8601,January 1990,North Carolina,5048269,3438340,68.1,3320147,65.8,118193,3.4
8602,January 1990,North Dakota,458611,319500,69.7,306343,66.8,13157,4.1
8603,January 1990,Ohio,8167481,5410159,66.2,5097238,62.4,312921,5.8
8604,January 1990,Oklahoma,2344080,1520402,64.9,1437244,61.3,83158,5.5
8605,January 1990,Oregon,2183240,1468594,67.3,1392572,63.8,76022,5.2
8606,January 1990,Pennsylvania,9160306,5842753,63.8,5545385,60.5,297368,5.1
8607,January 1990,Rhode Island,768664,524615,68.3,496819,64.6,27796,5.3
8608,January 1990,South Carolina,2582219,1724440,66.8,1643521,63.6,80919,4.7
8609,January 1990,South Dakota,499520,349916,70.1,336272,67.3,13644,3.9
8610,January 1990,Tennessee,3732787,2385072,63.9,2265627,60.7,119445,5.0
8611,January 1990,Texas,12560553,8529504,67.9,7989578,63.6,539926,6.3
8612,January 1990,Utah,1137579,807244,71.0,771214,67.8,36030,4.5
8613,January 1990,Vermont,425968,306484,72.0,293354,68.9,13130,4.3
8614,January 1990,Virginia,4627910,3204724,69.2,3080123,66.6,124601,3.9
8615,January 1990,Washington,3662087,2516450,68.7,2380798,65.0,135652,5.4
8616,January 1990,West Virginia,1388368,756778,54.5,696912,50.2,59866,7.9
8617,January 1990,Wisconsin,3667541,2589848,70.6,2480063,67.6,109785,4.2
8618,January 1990,Wyoming,328885,237095,72.1,223927,68.1,13168,5.6
8619,February 1990,Alabama,3045733,1901623,62.4,1774243,58.3,127380,6.7
8620,February 1990,Alaska,372728,264210,70.9,245251,65.8,18959,7.2
8621,February 1990,Arizona,2762292,1768282,64.0,1674430,60.6,93852,5.3
8622,February 1990,Arkansas,1767783,1134049,64.2,1058445,59.9,75604,6.7
8623,February 1990,California,22571608,15108068,66.9,14324311,63.5,783757,5.2
8624,February 1990,Colorado,2484872,1742520,70.1,1649883,66.4,92637,5.3
8625,February 1990,Connecticut,2567518,1808708,70.4,1720219,67.0,88489,4.9
8626,February 1990,Delaware,508657,360040,70.8,346529,68.1,13511,3.8
8627,February 1990,District of Columbia,480831,330951,68.8,312719,65.0,18232,5.5
8628,February 1990,Florida,10228063,6406451,62.6,6037024,59.0,369427,5.8
8629,February 1990,Georgia,4836665,3260568,67.4,3093035,63.9,167533,5.1
8630,February 1990,Hawaii,799281,540295,67.6,525377,65.7,14918,2.8
8631,February 1990,Idaho,723900,493645,68.2,467899,64.6,25746,5.2
8632,February 1990,Illinois,8640004,5970712,69.1,5608796,64.9,361916,6.1
8633,February 1990,Indiana,4137185,2842186,68.7,2691320,65.1,150866,5.3
8634,February 1990,Iowa,2080050,1446315,69.5,1383963,66.5,62352,4.3
8635,February 1990,Kansas,1818062,1264830,69.6,1213146,66.7,51684,4.1
8636,February 1990,Kentucky,2778542,1751226,63.0,1651095,59.4,100131,5.7
8637,February 1990,Louisiana,3044932,1854176,60.9,1746617,57.4,107559,5.8
8638,February 1990,Maine,933974,627771,67.2,599773,64.2,27998,4.5
8639,February 1990,Maryland,3683761,2565516,69.6,2470292,67.1,95224,3.7
8640,February 1990,Massachusetts,4702832,3202665,68.1,3033607,64.5,169058,5.3
8641,February 1990,Michigan,6989062,4622389,66.1,4269178,61.1,353211,7.6
8642,February 1990,Minnesota,3256108,2384131,73.2,2273917,69.8,110214,4.6
8643,February 1990,Mississippi,1872674,1182578,63.1,1093558,58.4,89020,7.5
8644,February 1990,Missouri,3841940,2596432,67.6,2452145,63.8,144287,5.6
8645,February 1990,Montana,595108,411632,69.2,389242,65.4,22390,5.4
8646,February 1990,Nebraska,1156221,820807,71.0,800747,69.3,20060,2.4
8647,February 1990,Nevada,926839,654981,70.7,626096,67.6,28885,4.4
8648,February 1990,New Hampshire,842794,620670,73.6,589429,69.9,31241,5.0
8649,February 1990,New Jersey,6015130,4037576,67.1,3853073,64.1,184503,4.6
8650,February 1990,New Mexico,1114321,708698,63.6,662718,59.5,45980,6.5
8651,February 1990,New York,14034141,8812167,62.8,8357217,59.5,454950,5.2
8652,February 1990,North Carolina,5057141,3451053,68.2,3330473,65.9,120580,3.5
8653,February 1990,North Dakota,459770,316586,68.9,303670,66.0,12916,4.1
8654,February 1990,Ohio,8181026,5411178,66.1,5105580,62.4,305598,5.6
8655,February 1990,Oklahoma,2344196,1523080,65.0,1439841,61.4,83239,5.5
8656,February 1990,Oregon,2184235,1472037,67.4,1396470,63.9,75567,5.1
8657,February 1990,Pennsylvania,9169848,5842817,63.7,5543913,60.5,298904,5.1
8658,February 1990,Rhode Island,770338,524135,68.0,495652,64.3,28483,5.4
8659,February 1990,South Carolina,2587870,1728145,66.8,1649295,63.7,78850,4.6
8660,February 1990,South Dakota,499716,346289,69.3,332805,66.6,13484,3.9
8661,February 1990,Tennessee,3739096,2389427,63.9,2269721,60.7,119706,5.0
8662,February 1990,Texas,12564976,8553003,68.1,8015501,63.8,537502,6.3
8663,February 1990,Utah,1141565,810108,71.0,773972,67.8,36136,4.5
8664,February 1990,Vermont,426722,306632,71.9,293126,68.7,13506,4.4
8665,February 1990,Virginia,4632891,3212907,69.3,3089238,66.7,123669,3.8
8666,February 1990,Washington,3662922,2523159,68.9,2389817,65.2,133342,5.3
8667,February 1990,West Virginia,1390496,757036,54.4,698084,50.2,58952,7.8
8668,February 1990,Wisconsin,3668543,2588564,70.6,2480669,67.6,107895,4.2
8669,February 1990,Wyoming,328932,236832,72.0,223934,68.1,12898,5.4
8670,March 1990,Alabama,3052698,1904161,62.4,1776963,58.2,127198,6.7
8671,March 1990,Alaska,372009,265624,71.4,246568,66.3,19056,7.2
8672,March 1990,Arizona,2764216,1777760,64.3,1682513,60.9,95247,5.4
8673,March 1990,Arkansas,1771089,1133273,64.0,1057603,59.7,75670,6.7
8674,March 1990,California,22572409,15148896,67.1,14355989,63.6,792907,5.2
8675,March 1990,Colorado,2484023,1748100,70.4,1655884,66.7,92216,5.3
8676,March 1990,Connecticut,2569537,1812946,70.6,1722644,67.0,90302,5.0
8677,March 1990,Delaware,509424,359394,70.5,345894,67.9,13500,3.8
8678,March 1990,District of Columbia,482635,331744,68.7,312709,64.8,19035,5.7
8679,March 1990,Florida,10229645,6429132,62.8,6056901,59.2,372231,5.8
8680,March 1990,Georgia,4844489,3268015,67.5,3101438,64.0,166577,5.1
8681,March 1990,Hawaii,801869,543173,67.7,528019,65.8,15154,2.8
8682,March 1990,Idaho,724500,493389,68.1,467246,64.5,26143,5.3
8683,March 1990,Illinois,8653751,5958987,68.9,5604177,64.8,354810,6.0
8684,March 1990,Indiana,4149433,2833401,68.3,2684675,64.7,148726,5.2
8685,March 1990,Iowa,2082172,1444423,69.4,1381965,66.4,62458,4.3
8686,March 1990,Kansas,1819488,1265392,69.5,1213745,66.7,51647,4.1
8687,March 1990,Kentucky,2783951,1752597,63.0,1652741,59.4,99856,5.7
8688,March 1990,Louisiana,3052979,1855174,60.8,1748988,57.3,106186,5.7
8689,March 1990,Maine,935523,629208,67.3,600946,64.2,28262,4.5
8690,March 1990,Maryland,3684675,2571178,69.8,2474975,67.2,96203,3.7
8691,March 1990,Massachusetts,4707010,3207107,68.1,3031505,64.4,175602,5.5
8692,March 1990,Michigan,6994801,4618661,66.0,4272819,61.1,345842,7.5
8693,March 1990,Minnesota,3259315,2386911,73.2,2276830,69.9,110081,4.6
8694,March 1990,Mississippi,1878898,1183051,63.0,1095262,58.3,87789,7.4
8695,March 1990,Missouri,3846919,2595984,67.5,2455164,63.8,140820,5.4
8696,March 1990,Montana,595034,412411,69.3,389869,65.5,22542,5.5
8697,March 1990,Nebraska,1157757,822001,71.0,802490,69.3,19511,2.4
8698,March 1990,Nevada,928575,659761,71.1,630714,67.9,29047,4.4
8699,March 1990,New Hampshire,844405,620979,73.5,588591,69.7,32388,5.2
8700,March 1990,New Jersey,6023822,4044060,67.1,3858139,64.0,185921,4.6
8701,March 1990,New Mexico,1114788,710328,63.7,664615,59.6,45713,6.4
8702,March 1990,New York,14047919,8821532,62.8,8370923,59.6,450609,5.1
8703,March 1990,North Carolina,5066013,3462977,68.4,3339097,65.9,123880,3.6
8704,March 1990,North Dakota,460928,316037,68.6,303267,65.8,12770,4.0
8705,March 1990,Ohio,8194571,5413372,66.1,5113518,62.4,299854,5.5
8706,March 1990,Oklahoma,2344311,1525256,65.1,1442057,61.5,83199,5.5
8707,March 1990,Oregon,2185230,1475847,67.5,1400049,64.1,75798,5.1
8708,March 1990,Pennsylvania,9179390,5839359,63.6,5540124,60.4,299235,5.1
8709,March 1990,Rhode Island,772012,523855,67.9,494496,64.1,29359,5.6
8710,March 1990,South Carolina,2593522,1732049,66.8,1654199,63.8,77850,4.5
8711,March 1990,South Dakota,499911,345632,69.1,332241,66.5,13391,3.9
8712,March 1990,Tennessee,3745405,2393113,63.9,2272678,60.7,120435,5.0
8713,March 1990,Texas,12569399,8574321,68.2,8038318,64.0,536003,6.3
8714,March 1990,Utah,1145552,812954,71.0,776622,67.8,36332,4.5
8715,March 1990,Vermont,427476,306573,71.7,292692,68.5,13881,4.5
8716,March 1990,Virginia,4637872,3220412,69.4,3096440,66.8,123972,3.8
8717,March 1990,Washington,3663757,2527619,69.0,2395894,65.4,131725,5.2
8718,March 1990,West Virginia,1392624,757598,54.4,699146,50.2,58452,7.7
8719,March 1990,Wisconsin,3669545,2586408,70.5,2480465,67.6,105943,4.1
8720,March 1990,Wyoming,328979,236566,71.9,223892,68.1,12674,5.4
8721,April 1990,Alabama,3060000,1905779,62.3,1778934,58.1,126845,6.7
8722,April 1990,Alaska,371000,266823,71.9,247705,66.8,19118,7.2
8723,April 1990,Arizona,2764000,1784680,64.6,1688857,61.1,95823,5.4
8724,April 1990,Arkansas,1774000,1132017,63.8,1056117,59.5,75900,6.7
8725,April 1990,California,22577000,15164991,67.2,14359864,63.6,805127,5.3
8726,April 1990,Colorado,2482000,1753317,70.6,1661077,66.9,92240,5.3
8727,April 1990,Connecticut,2571000,1816413,70.7,1724853,67.1,91560,5.0
8728,April 1990,Delaware,510000,358801,70.4,345258,67.7,13543,3.8
8729,April 1990,District of Columbia,484000,331398,68.5,311663,64.4,19735,6.0
8730,April 1990,Florida,10226000,6446148,63.0,6070381,59.4,375767,5.8
8731,April 1990,Georgia,4851000,3275245,67.5,3107290,64.1,167955,5.1
8732,April 1990,Hawaii,804000,545920,67.9,530714,66.0,15206,2.8
8733,April 1990,Idaho,725000,492735,68.0,466100,64.3,26635,5.4
8734,April 1990,Illinois,8666000,5948328,68.6,5596690,64.6,351638,5.9
8735,April 1990,Indiana,4161000,2823273,67.9,2676492,64.3,146781,5.2
8736,April 1990,Iowa,2084000,1445676,69.4,1383013,66.4,62663,4.3
8737,April 1990,Kansas,1821000,1267366,69.6,1215356,66.7,52010,4.1
8738,April 1990,Kentucky,2789000,1753152,62.9,1653222,59.3,99930,5.7
8739,April 1990,Louisiana,3061000,1857028,60.7,1750812,57.2,106216,5.7
8740,April 1990,Maine,937000,630411,67.3,601578,64.2,28833,4.6
8741,April 1990,Maryland,3686000,2577098,69.9,2478121,67.2,98977,3.8
8742,April 1990,Massachusetts,4710000,3209594,68.1,3027271,64.3,182323,5.7
8743,April 1990,Michigan,7001000,4615492,65.9,4276018,61.1,339474,7.4
8744,April 1990,Minnesota,3262000,2389163,73.2,2279322,69.9,109841,4.6
8745,April 1990,Mississippi,1885000,1182405,62.7,1095808,58.1,86597,7.3
8746,April 1990,Missouri,3851000,2596927,67.4,2458587,63.8,138340,5.3
8747,April 1990,Montana,595000,413148,69.4,390346,65.6,22802,5.5
8748,April 1990,Nebraska,1159000,823084,71.0,803942,69.4,19142,2.3
8749,April 1990,Nevada,929000,663019,71.4,633601,68.2,29418,4.4
8750,April 1990,New Hampshire,846000,621015,73.4,587699,69.5,33316,5.4
8751,April 1990,New Jersey,6031000,4049193,67.1,3861403,64.0,187790,4.6
8752,April 1990,New Mexico,1115000,711895,63.8,666279,59.8,45616,6.4
8753,April 1990,New York,14058000,8824908,62.8,8377690,59.6,447218,5.1
8754,April 1990,North Carolina,5072000,3472078,68.5,3344747,65.9,127331,3.7
8755,April 1990,North Dakota,462000,316229,68.4,303505,65.7,12724,4.0
8756,April 1990,Ohio,8208000,5416801,66.0,5119277,62.4,297524,5.5
8757,April 1990,Oklahoma,2344000,1526503,65.1,1443417,61.6,83086,5.4
8758,April 1990,Oregon,2186000,1480007,67.7,1403095,64.2,76912,5.2
8759,April 1990,Pennsylvania,9187000,5832440,63.5,5533166,60.2,299274,5.1
8760,April 1990,Rhode Island,773000,523943,67.8,493468,63.8,30475,5.8
8761,April 1990,South Carolina,2599000,1736374,66.8,1657899,63.8,78475,4.5
8762,April 1990,South Dakota,500000,345841,69.2,332501,66.5,13340,3.9
8763,April 1990,Tennessee,3751000,2395586,63.9,2274066,60.6,121520,5.1
8764,April 1990,Texas,12573000,8592140,68.3,8056183,64.1,535957,6.2
8765,April 1990,Utah,1149000,815752,71.0,779237,67.8,36515,4.5
8766,April 1990,Vermont,428000,306267,71.6,292052,68.2,14215,4.6
8767,April 1990,Virginia,4643000,3227642,69.5,3101378,66.8,126264,3.9
8768,April 1990,Washington,3664000,2529623,69.0,2398895,65.5,130728,5.2
8769,April 1990,West Virginia,1395000,758446,54.4,699779,50.2,58667,7.7
8770,April 1990,Wisconsin,3670000,2584031,70.4,2479295,67.6,104736,4.1
8771,April 1990,Wyoming,329000,236319,71.8,223815,68.0,12504,5.3
8772,May 1990,Alabama,3066010,1906626,62.2,1780087,58.1,126539,6.6
8773,May 1990,Alaska,370957,267752,72.2,248590,67.0,19162,7.2
8774,May 1990,Arizona,2770919,1789306,64.6,1693644,61.1,95662,5.3
8775,May 1990,Arkansas,1778059,1130782,63.6,1054459,59.3,76323,6.7
8776,May 1990,California,22568458,15169173,67.2,14348414,63.6,820759,5.4
8777,May 1990,Colorado,2483888,1758442,70.8,1665862,67.1,92580,5.3
8778,May 1990,Connecticut,2574315,1819191,70.7,1726748,67.1,92443,5.1
8779,May 1990,Delaware,511380,358304,70.1,344613,67.4,13691,3.8
8780,May 1990,District of Columbia,486828,330594,67.9,310278,63.7,20316,6.1
8781,May 1990,Florida,10239776,6458777,63.1,6078592,59.4,380185,5.9
8782,May 1990,Georgia,4862054,3282341,67.5,3110844,64.0,171497,5.2
8783,May 1990,Hawaii,807656,548373,67.9,533262,66.0,15111,2.8
8784,May 1990,Idaho,726001,491878,67.8,464808,64.0,27070,5.5
8785,May 1990,Illinois,8683245,5940998,68.4,5587470,64.3,353528,6.0
8786,May 1990,Indiana,4174837,2813732,67.4,2668545,63.9,145187,5.2
8787,May 1990,Iowa,2086641,1447769,69.4,1384830,66.4,62939,4.3
8788,May 1990,Kansas,1822059,1269665,69.7,1216989,66.8,52676,4.1
8789,May 1990,Kentucky,2795249,1753188,62.7,1653021,59.1,100167,5.7
8790,May 1990,Louisiana,3069106,1860179,60.6,1752411,57.1,107768,5.8
8791,May 1990,Maine,938884,631337,67.2,601588,64.1,29749,4.7
8792,May 1990,Maryland,3686123,2583321,70.1,2479875,67.3,103446,4.0
8793,May 1990,Massachusetts,4716950,3210320,68.1,3021203,64.0,189117,5.9
8794,May 1990,Michigan,7005499,4613372,65.9,4278022,61.1,335350,7.3
8795,May 1990,Minnesota,3266425,2391794,73.2,2281576,69.8,110218,4.6
8796,May 1990,Mississippi,1891509,1181268,62.5,1095510,57.9,85758,7.3
8797,May 1990,Missouri,3857908,2599175,67.4,2461137,63.8,138038,5.3
8798,May 1990,Montana,594831,400801,67.4,377668,63.5,23133,5.8
8799,May 1990,Nebraska,1161219,823995,71.0,805020,69.3,18975,2.3
8800,May 1990,Nevada,933628,666005,71.3,636022,68.1,29983,4.5
8801,May 1990,New Hampshire,847479,620905,73.3,586880,69.3,34025,5.5
8802,May 1990,New Jersey,6042891,4053248,67.1,3862737,63.9,190511,4.7
8803,May 1990,New Mexico,1116061,713226,63.9,667528,59.8,45698,6.4
8804,May 1990,New York,14080404,8825081,62.7,8378472,59.5,446609,5.1
8805,May 1990,North Carolina,5087435,3477679,68.4,3346948,65.8,130731,3.8
8806,May 1990,North Dakota,463360,316628,68.3,303880,65.6,12748,4.0
8807,May 1990,Ohio,8221647,5420442,65.9,5122551,62.3,297891,5.5
8808,May 1990,Oklahoma,2344944,1526813,65.1,1443789,61.6,83024,5.4
8809,May 1990,Oregon,2187352,1484646,67.9,1405832,64.3,78814,5.3
8810,May 1990,Pennsylvania,9201050,5824112,63.3,5523778,60.0,300334,5.2
8811,May 1990,Rhode Island,776441,524411,67.5,492649,63.4,31762,6.1
8812,May 1990,South Carolina,2604890,1740964,66.8,1660747,63.8,80217,4.6
8813,May 1990,South Dakota,500444,346279,69.2,332973,66.5,13306,3.8
8814,May 1990,Tennessee,3758975,2397049,63.8,2274149,60.5,122900,5.1
8815,May 1990,Texas,12579007,8606931,68.4,8069925,64.2,537006,6.2
8816,May 1990,Utah,1154242,818538,70.9,781977,67.7,36561,4.5
8817,May 1990,Vermont,429122,305728,71.2,291254,67.9,14474,4.7
8818,May 1990,Virginia,4647638,3235517,69.6,3104912,66.8,130605,4.0
8819,May 1990,Washington,3666216,2529633,69.0,2399649,65.5,129984,5.1
8820,May 1990,West Virginia,1396382,759512,54.4,699859,50.1,59653,7.9
8821,May 1990,Wisconsin,3672277,2582427,70.3,2477677,67.5,104750,4.1
8822,May 1990,Wyoming,329107,236085,71.7,223678,68.0,12407,5.3
8823,June 1990,Alabama,3073813,1906985,62.0,1780427,57.9,126558,6.6
8824,June 1990,Alaska,369948,268468,72.6,249251,67.4,19217,7.2
8825,June 1990,Arizona,2770703,1791941,64.7,1696874,61.2,95067,5.3
8826,June 1990,Arkansas,1781471,1129991,63.4,1053079,59.1,76912,6.8
8827,June 1990,California,22574549,15165909,67.2,14325734,63.5,840175,5.5
8828,June 1990,Colorado,2481865,1763323,71.0,1670386,67.3,92937,5.3
8829,June 1990,Connecticut,2575778,1821203,70.7,1728095,67.1,93108,5.1
8830,June 1990,Delaware,511456,357923,70.0,343907,67.2,14016,3.9
8831,June 1990,District of Columbia,488194,329686,67.5,308884,63.3,20802,6.3
8832,June 1990,Florida,10236131,6468195,63.2,6082589,59.4,385606,6.0
8833,June 1990,Georgia,4868065,3288368,67.5,3112244,63.9,176124,5.4
8834,June 1990,Hawaii,809787,550518,68.0,535557,66.1,14961,2.7
8835,June 1990,Idaho,726001,491052,67.6,463705,63.9,27347,5.6
8836,June 1990,Illinois,8695493,5937183,68.3,5577951,64.1,359232,6.1
8837,June 1990,Indiana,4186404,2805987,67.0,2661973,63.6,144014,5.1
8838,June 1990,Iowa,2088969,1449745,69.4,1386521,66.4,63224,4.4
8839,June 1990,Kansas,1824071,1271896,69.7,1218332,66.8,53564,4.2
8840,June 1990,Kentucky,2800299,1753143,62.6,1652330,59.0,100813,5.8
8841,June 1990,Louisiana,3077128,1864317,60.6,1753795,57.0,110522,5.9
8842,June 1990,Maine,939861,632100,67.3,601048,64.0,31052,4.9
8843,June 1990,Maryland,3686948,2589516,70.2,2480244,67.3,109272,4.2
8844,June 1990,Massachusetts,4719940,3209543,68.0,3013562,63.8,195981,6.1
8845,June 1990,Michigan,7012199,4611209,65.8,4276765,61.0,334444,7.3
8846,June 1990,Minnesota,3269110,2395288,73.3,2283716,69.9,111572,4.7
8847,June 1990,Mississippi,1897611,1180273,62.2,1094713,57.7,85560,7.2
8848,June 1990,Missouri,3862489,2603032,67.4,2462472,63.8,140560,5.4
8849,June 1990,Montana,594798,397458,66.8,373940,62.9,23518,5.9
8850,June 1990,Nebraska,1162463,824760,70.9,805788,69.3,18972,2.3
8851,June 1990,Nevada,934554,669120,71.6,638427,68.3,30693,4.6
8852,June 1990,New Hampshire,849574,620736,73.1,586140,69.0,34596,5.6
8853,June 1990,New Jersey,6051069,4056447,67.0,3861971,63.8,194476,4.8
8854,June 1990,New Mexico,1116273,714273,64.0,668323,59.9,45950,6.4
8855,June 1990,New York,14090485,8823069,62.6,8373371,59.4,449698,5.1
8856,June 1990,North Carolina,5093923,3479985,68.3,3345393,65.7,134592,3.9
8857,June 1990,North Dakota,464432,317043,68.3,304232,65.5,12811,4.0
8858,June 1990,Ohio,8235576,5422478,65.8,5123153,62.2,299325,5.5
8859,June 1990,Oklahoma,2345133,1526306,65.1,1442928,61.5,83378,5.5
8860,June 1990,Oregon,2188623,1489589,68.1,1408480,64.4,81109,5.4
8861,June 1990,Pennsylvania,9208660,5816710,63.2,5513038,59.9,303672,5.2
8862,June 1990,Rhode Island,776930,525138,67.6,492045,63.3,33093,6.3
8863,June 1990,South Carolina,2610868,1745097,66.8,1662936,63.7,82161,4.7
8864,June 1990,South Dakota,500533,346726,69.3,333457,66.6,13269,3.8
8865,June 1990,Tennessee,3764570,2397239,63.7,2272841,60.4,124398,5.2
8866,June 1990,Texas,12583608,8618308,68.5,8079922,64.2,538386,6.2
8867,June 1990,Utah,1157691,821247,70.9,784828,67.8,36419,4.4
8868,June 1990,Vermont,430146,305040,70.9,290344,67.5,14696,4.8
8869,June 1990,Virginia,4652766,3244138,69.7,3107509,66.8,136629,4.2
8870,June 1990,Washington,3666459,2528004,68.9,2398831,65.4,129173,5.1
8871,June 1990,West Virginia,1399259,760706,54.4,699368,50.0,61338,8.1
8872,June 1990,Wisconsin,3672733,2582285,70.3,2476057,67.4,106228,4.1
8873,June 1990,Wyoming,329129,235868,71.7,223491,67.9,12377,5.2
8874,July 1990,Alabama,3080615,1907518,61.9,1780279,57.8,127239,6.7
8875,July 1990,Alaska,368940,269124,72.9,249819,67.7,19305,7.2
8876,July 1990,Arizona,2770487,1793458,64.7,1698941,61.3,94517,5.3
8877,July 1990,Arkansas,1783882,1129955,63.3,1052352,59.0,77603,6.9
8878,July 1990,California,22577641,15160425,67.1,14295964,63.3,864461,5.7
8879,July 1990,Colorado,2479843,1768034,71.3,1675050,67.5,92984,5.3
8880,July 1990,Connecticut,2577242,1822693,70.7,1728943,67.1,93750,5.1
8881,July 1990,Delaware,512532,357669,69.8,343087,66.9,14582,4.1
8882,July 1990,District of Columbia,489559,328934,67.2,307701,62.9,21233,6.5
8883,July 1990,Florida,10232487,6476949,63.3,6084271,59.5,392678,6.1
8884,July 1990,Georgia,4875076,3293274,67.6,3112143,63.8,181131,5.5
8885,July 1990,Hawaii,811918,552444,68.0,537643,66.2,14801,2.7
8886,July 1990,Idaho,727001,490505,67.5,463052,63.7,27453,5.6
8887,July 1990,Illinois,8707742,5936671,68.2,5570512,64.0,366159,6.2
8888,July 1990,Indiana,4197972,2801456,66.7,2657767,63.3,143689,5.1
8889,July 1990,Iowa,2090297,1451390,69.4,1387769,66.4,63621,4.4
8890,July 1990,Kansas,1825083,1273971,69.8,1219363,66.8,54608,4.3
8891,July 1990,Kentucky,2805348,1753542,62.5,1651489,58.9,102053,5.8
8892,July 1990,Louisiana,3085149,1869324,60.6,1755176,56.9,114148,6.1
8893,July 1990,Maine,941838,632834,67.2,600112,63.7,32722,5.2
8894,July 1990,Maryland,3688773,2595690,70.4,2479678,67.2,116012,4.5
8895,July 1990,Massachusetts,4722930,3208304,67.9,3005074,63.6,203230,6.3
8896,July 1990,Michigan,7017898,4608579,65.7,4271041,60.9,337538,7.3
8897,July 1990,Minnesota,3271795,2399765,73.3,2285894,69.9,113871,4.7
8898,July 1990,Mississippi,1903713,1180248,62.0,1093906,57.5,86342,7.3
8899,July 1990,Missouri,3866071,2609375,67.5,2463473,63.7,145902,5.6
8900,July 1990,Montana,594764,396838,66.7,372887,62.7,23951,6.0
8901,July 1990,Nebraska,1163706,825449,70.9,806437,69.3,19012,2.3
8902,July 1990,Nevada,934479,672451,72.0,640951,68.6,31500,4.7
8903,July 1990,New Hampshire,850670,620521,72.9,585362,68.8,35159,5.7
8904,July 1990,New Jersey,6057248,4059393,67.0,3859260,63.7,200133,4.9
8905,July 1990,New Mexico,1116486,715130,64.1,668737,59.9,46393,6.5
8906,July 1990,New York,14100566,8820754,62.6,8364181,59.3,456573,5.2
8907,July 1990,North Carolina,5099410,3480767,68.3,3341194,65.5,139573,4.0
8908,July 1990,North Dakota,465504,317383,68.2,304521,65.4,12862,4.1
8909,July 1990,Ohio,8248506,5423176,65.7,5122125,62.1,301051,5.6
8910,July 1990,Oklahoma,2344322,1525304,65.1,1440981,61.5,84323,5.5
8911,July 1990,Oregon,2188893,1494633,68.3,1411213,64.5,83420,5.6
8912,July 1990,Pennsylvania,9216270,5812509,63.1,5502820,59.7,309689,5.3
8913,July 1990,Rhode Island,778418,525983,67.6,491673,63.2,34310,6.5
8914,July 1990,South Carolina,2615846,1748704,66.9,1664728,63.6,83976,4.8
8915,July 1990,South Dakota,500622,347104,69.3,333913,66.7,13191,3.8
8916,July 1990,Tennessee,3770166,2396645,63.6,2270544,60.2,126101,5.3
8917,July 1990,Texas,12586209,8628601,68.6,8087867,64.3,540734,6.3
8918,July 1990,Utah,1161139,823873,71.0,787745,67.8,36128,4.4
8919,July 1990,Vermont,430171,304333,70.7,289348,67.3,14985,4.9
8920,July 1990,Virginia,4657894,3254087,69.9,3110187,66.8,143900,4.4
8921,July 1990,Washington,3666702,2525743,68.9,2397220,65.4,128523,5.1
8922,July 1990,West Virginia,1401135,762071,54.4,698468,49.9,63603,8.3
8923,July 1990,Wisconsin,3673188,2584138,70.4,2475065,67.4,109073,4.2
8924,July 1990,Wyoming,329150,235681,71.6,223300,67.8,12381,5.3
8925,August 1990,Alabama,3083417,1908593,61.9,1779865,57.7,128728,6.7
8926,August 1990,Alaska,370931,269797,72.7,250378,67.5,19419,7.2
8927,August 1990,Arizona,2777270,1794313,64.6,1700177,61.2,94136,5.2
8928,August 1990,Arkansas,1785294,1130554,63.3,1052075,58.9,78479,6.9
8929,August 1990,California,22594732,15155035,67.1,14261614,63.1,893421,5.9
8930,August 1990,Colorado,2485820,1772470,71.3,1679890,67.6,92580,5.2
8931,August 1990,Connecticut,2576705,1823983,70.8,1729427,67.1,94556,5.2
8932,August 1990,Delaware,513609,357488,69.6,342182,66.6,15306,4.3
8933,August 1990,District of Columbia,488925,328387,67.2,306763,62.7,21624,6.6
8934,August 1990,Florida,10254842,6485727,63.2,6084488,59.3,401239,6.2
8935,August 1990,Georgia,4883087,3296863,67.5,3110938,63.7,185925,5.6
8936,August 1990,Hawaii,813049,554331,68.2,539716,66.4,14615,2.6
8937,August 1990,Idaho,729001,490469,67.3,462957,63.5,27512,5.6
8938,August 1990,Illinois,8712991,5938210,68.2,5565824,63.9,372386,6.3
8939,August 1990,Indiana,4201539,2800070,66.6,2655407,63.2,144663,5.2
8940,August 1990,Iowa,2091625,1452754,69.5,1388543,66.4,64211,4.4
8941,August 1990,Kansas,1825095,1275727,69.9,1220026,66.8,55701,4.4
8942,August 1990,Kentucky,2807398,1754329,62.5,1650494,58.8,103835,5.9
8943,August 1990,Louisiana,3086170,1874948,60.8,1756604,56.9,118344,6.3
8944,August 1990,Maine,941815,633731,67.3,599063,63.6,34668,5.5
8945,August 1990,Maryland,3691597,2601066,70.5,2478331,67.1,122735,4.7
8946,August 1990,Massachusetts,4719921,3207223,68.0,2996080,63.5,211143,6.6
8947,August 1990,Michigan,7022598,4604482,65.6,4261143,60.7,343339,7.5
8948,August 1990,Minnesota,3274480,2404616,73.4,2288111,69.9,116505,4.8
8949,August 1990,Mississippi,1904815,1181515,62.0,1093418,57.4,88097,7.5
8950,August 1990,Missouri,3868652,2617968,67.7,2464575,63.7,153393,5.9
8951,August 1990,Montana,595730,397137,66.7,372688,62.6,24449,6.2
8952,August 1990,Nebraska,1163950,826177,71.0,807125,69.3,19052,2.3
8953,August 1990,Nevada,940405,675807,71.9,643428,68.4,32379,4.8
8954,August 1990,New Hampshire,850766,620251,72.9,584397,68.7,35854,5.8
8955,August 1990,New Jersey,6059426,4062381,67.0,3854719,63.6,207662,5.1
8956,August 1990,New Mexico,1118698,715805,64.0,668822,59.8,46983,6.6
8957,August 1990,New York,14099647,8818372,62.5,8351164,59.2,467208,5.3
8958,August 1990,North Carolina,5107897,3481895,68.2,3335799,65.3,146096,4.2
8959,August 1990,North Dakota,465576,317589,68.2,304738,65.5,12851,4.0
8960,August 1990,Ohio,8253435,5422875,65.7,5120356,62.0,302519,5.6
8961,August 1990,Oklahoma,2346510,1524089,65.0,1438070,61.3,86019,5.6
8962,August 1990,Oregon,2194164,1499249,68.3,1413739,64.4,85510,5.7
8963,August 1990,Pennsylvania,9219880,5812796,63.0,5494537,59.6,318259,5.5
8964,August 1990,Rhode Island,778906,526683,67.6,491380,63.1,35303,6.7
8965,August 1990,South Carolina,2620824,1751455,66.8,1665944,63.6,85511,4.9
8966,August 1990,South Dakota,500711,347377,69.4,334325,66.8,13052,3.8
8967,August 1990,Tennessee,3774761,2395895,63.5,2267507,60.1,128388,5.4
8968,August 1990,Texas,12605811,8639902,68.5,8094973,64.2,544929,6.3
8969,August 1990,Utah,1164587,826442,71.0,790606,67.9,35836,4.3
8970,August 1990,Vermont,430195,303719,70.6,288308,67.0,15411,5.1
8971,August 1990,Virginia,4663021,3264974,70.0,3113262,66.8,151712,4.6
8972,August 1990,Washington,3674946,2524078,68.7,2395211,65.2,128867,5.1
8973,August 1990,West Virginia,1402012,763541,54.5,697382,49.7,66159,8.7
8974,August 1990,Wisconsin,3677644,2587402,70.4,2474618,67.3,112784,4.4
8975,August 1990,Wyoming,329172,235547,71.6,223135,67.8,12412,5.3
8976,September 1990,Alabama,3087219,1909878,61.9,1779096,57.6,130782,6.8
8977,September 1990,Alaska,371922,270446,72.7,250903,67.5,19543,7.2
8978,September 1990,Arizona,2785054,1793938,64.4,1700269,61.0,93669,5.2
8979,September 1990,Arkansas,1787706,1131275,63.3,1051659,58.8,79616,7.0
8980,September 1990,California,22614824,15148084,67.0,14222028,62.9,926056,6.1
8981,September 1990,Colorado,2490798,1776112,71.3,1684219,67.6,91893,5.2
8982,September 1990,Connecticut,2576168,1825143,70.8,1729542,67.1,95601,5.2
8983,September 1990,Delaware,513685,361984,70.5,341259,66.4,20725,5.7
8984,September 1990,District of Columbia,487290,327883,67.3,305936,62.8,21947,6.7
8985,September 1990,Florida,10279197,6492712,63.2,6082100,59.2,410612,6.3
8986,September 1990,Georgia,4893098,3298113,67.4,3108382,63.5,189731,5.8
8987,September 1990,Hawaii,814180,556357,68.3,541952,66.6,14405,2.6
8988,September 1990,Idaho,731001,491053,67.2,463346,63.4,27707,5.6
8989,September 1990,Illinois,8719240,5939163,68.1,5562434,63.8,376729,6.3
8990,September 1990,Indiana,4206106,2799842,66.6,2652860,63.1,146982,5.2
8991,September 1990,Iowa,2092953,1453861,69.5,1388848,66.4,65013,4.5
8992,September 1990,Kansas,1826106,1277053,69.9,1220160,66.8,56893,4.5
8993,September 1990,Kentucky,2809448,1755083,62.5,1648833,58.7,106250,6.1
8994,September 1990,Louisiana,3088192,1880295,60.9,1757660,56.9,122635,6.5
8995,September 1990,Maine,942791,635124,67.4,598217,63.5,36907,5.8
8996,September 1990,Maryland,3694422,2604780,70.5,2475842,67.0,128938,5.0
8997,September 1990,Massachusetts,4717911,3205957,68.0,2986249,63.3,219708,6.9
8998,September 1990,Michigan,7029298,4598261,65.4,4248013,60.4,350248,7.6
8999,September 1990,Minnesota,3278166,2408908,73.5,2290090,69.9,118818,4.9
9000,September 1990,Mississippi,1905917,1183721,62.1,1093210,57.4,90511,7.6
9001,September 1990,Missouri,3871234,2626829,67.9,2465050,63.7,161779,6.2
9002,September 1990,Montana,595696,397895,66.8,372899,62.6,24996,6.3
9003,September 1990,Nebraska,1165194,827074,71.0,807897,69.3,19177,2.3
9004,September 1990,Nevada,946331,678932,71.7,645616,68.2,33316,4.9
9005,September 1990,New Hampshire,850862,619925,72.9,583130,68.5,36795,5.9
9006,September 1990,New Jersey,6061604,4064766,67.1,3848008,63.5,216758,5.3
9007,September 1990,New Mexico,1120910,716375,63.9,668764,59.7,47611,6.6
9008,September 1990,New York,14101728,8813305,62.5,8332587,59.1,480718,5.5
9009,September 1990,North Carolina,5117384,3484068,68.1,3330006,65.1,154062,4.4
9010,September 1990,North Dakota,465648,317638,68.2,304863,65.5,12775,4.0
9011,September 1990,Ohio,8258364,5421762,65.7,5117028,62.0,304734,5.6
9012,September 1990,Oklahoma,2348699,1522473,64.8,1434074,61.1,88399,5.8
9013,September 1990,Oregon,2199434,1502601,68.3,1415555,64.4,87046,5.8
9014,September 1990,Pennsylvania,9225490,5816876,63.1,5487720,59.5,329156,5.7
9015,September 1990,Rhode Island,778394,526949,67.7,490824,63.1,36125,6.9
9016,September 1990,South Carolina,2624802,1752939,66.8,1665981,63.5,86958,5.0
9017,September 1990,South Dakota,501799,347559,69.3,334676,66.7,12883,3.7
9018,September 1990,Tennessee,3779356,2395276,63.4,2263423,59.9,131853,5.5
9019,September 1990,Texas,12627412,8651162,68.5,8100599,64.2,550563,6.4
9020,September 1990,Utah,1169036,828932,70.9,793215,67.9,35717,4.3
9021,September 1990,Vermont,431219,303286,70.3,287269,66.6,16017,5.3
9022,September 1990,Virginia,4668149,3275232,70.2,3115611,66.7,159621,4.9
9023,September 1990,Washington,3684189,2523481,68.5,2392644,64.9,130837,5.2
9024,September 1990,West Virginia,1402888,764977,54.5,696292,49.6,68685,9.0
9025,September 1990,Wisconsin,3682099,2590859,70.4,2473894,67.2,116965,4.5
9026,September 1990,Wyoming,330193,235489,71.3,223028,67.5,12461,5.3
9027,October 1990,Alabama,3090021,1911034,61.8,1777959,57.5,133075,7.0
9028,October 1990,Alaska,372914,271028,72.7,251334,67.4,19694,7.3
9029,October 1990,Arizona,2792838,1792135,64.2,1699020,60.8,93115,5.2
9030,October 1990,Arkansas,1789118,1131585,63.2,1050696,58.7,80889,7.1
9031,October 1990,California,22634915,15139185,66.9,14176515,62.6,962670,6.4
9032,October 1990,Colorado,2496775,1778443,71.2,1687317,67.6,91126,5.1
9033,October 1990,Connecticut,2576631,1826158,70.9,1729303,67.1,96855,5.3
9034,October 1990,Delaware,514761,363250,70.6,340392,66.1,22858,6.3
9035,October 1990,District of Columbia,486656,327233,67.2,305073,62.7,22160,6.8
9036,October 1990,Florida,10303552,6496409,63.1,6075884,59.0,420525,6.5
9037,October 1990,Georgia,4903109,3296899,67.2,3104396,63.3,192503,5.8
9038,October 1990,Hawaii,815312,558615,68.5,544361,66.8,14254,2.6
9039,October 1990,Idaho,734001,492239,67.1,464081,63.2,28158,5.7
9040,October 1990,Illinois,8725489,5938254,68.1,5559094,63.7,379160,6.4
9041,October 1990,Indiana,4210674,2799521,66.5,2648412,62.9,151109,5.4
9042,October 1990,Iowa,2094281,1454792,69.5,1388737,66.3,66055,4.5
9043,October 1990,Kansas,1827118,1277847,69.9,1219693,66.8,58154,4.6
9044,October 1990,Kentucky,2812498,1755801,62.4,1646029,58.5,109772,6.3
9045,October 1990,Louisiana,3089213,1884661,61.0,1758001,56.9,126660,6.7
9046,October 1990,Maine,942768,637264,67.6,597758,63.4,39506,6.2
9047,October 1990,Maryland,3698247,2607067,70.5,2472057,66.8,135010,5.2
9048,October 1990,Massachusetts,4716901,3204235,67.9,2975395,63.1,228840,7.1
9049,October 1990,Michigan,7034998,4591658,65.3,4232374,60.2,359284,7.8
9050,October 1990,Minnesota,3281851,2412247,73.5,2291522,69.8,120725,5.0
9051,October 1990,Mississippi,1907019,1186557,62.2,1092987,57.3,93570,7.9
9052,October 1990,Missouri,3874816,2634068,68.0,2464216,63.6,169852,6.4
9053,October 1990,Montana,596663,398923,66.9,373343,62.6,25580,6.4
9054,October 1990,Nebraska,1166438,828160,71.0,808760,69.3,19400,2.3
9055,October 1990,Nevada,952256,681725,71.6,647401,68.0,34324,5.0
9056,October 1990,New Hampshire,850957,619473,72.8,581478,68.3,37995,6.1
9057,October 1990,New Jersey,6064782,4065993,67.0,3838973,63.3,227020,5.6
9058,October 1990,New Mexico,1123122,716932,63.8,668720,59.5,48212,6.7
9059,October 1990,New York,14103809,8804304,62.4,8307610,58.9,496694,5.6
9060,October 1990,North Carolina,5126871,3487294,68.0,3324159,64.8,163135,4.7
9061,October 1990,North Dakota,465720,317542,68.2,304865,65.5,12677,4.0
9062,October 1990,Ohio,8264294,5422056,65.6,5111149,61.8,310907,5.7
9063,October 1990,Oklahoma,2349888,1520221,64.7,1429105,60.8,91116,6.0
9064,October 1990,Oregon,2204705,1504343,68.2,1416499,64.2,87844,5.8
9065,October 1990,Pennsylvania,9230100,5823442,63.1,5481317,59.4,342125,5.9
9066,October 1990,Rhode Island,778883,526746,67.6,489697,62.9,37049,7.0
9067,October 1990,South Carolina,2629780,1753453,66.7,1664598,63.3,88855,5.1
9068,October 1990,South Dakota,501888,347686,69.3,334962,66.7,12724,3.7
9069,October 1990,Tennessee,3784951,2395273,63.3,2258166,59.7,137107,5.7
9070,October 1990,Texas,12648014,8660931,68.5,8103614,64.1,557317,6.4
9071,October 1990,Utah,1172484,831368,70.9,795511,67.8,35857,4.3
9072,October 1990,Vermont,431244,303029,70.3,286254,66.4,16775,5.5
9073,October 1990,Virginia,4674276,3283956,70.3,3116204,66.7,167752,5.1
9074,October 1990,Washington,3693432,2523739,68.3,2389363,64.7,134376,5.3
9075,October 1990,West Virginia,1403765,766410,54.6,695353,49.5,71057,9.3
9076,October 1990,Wisconsin,3686555,2594216,70.4,2472308,67.1,121908,4.7
9077,October 1990,Wyoming,330215,235468,71.3,222992,67.5,12476,5.3
9078,November 1990,Alabama,3093823,1911995,61.8,1776680,57.4,135315,7.1
9079,November 1990,Alaska,373905,271551,72.6,251655,67.3,19896,7.3
9080,November 1990,Arizona,2799622,1789621,63.9,1697269,60.6,92352,5.2
9081,November 1990,Arkansas,1791530,1131306,63.1,1049210,58.6,82096,7.3
9082,November 1990,California,22653007,15129979,66.8,14129323,62.4,1000656,6.6
9083,November 1990,Colorado,2501753,1779758,71.1,1689400,67.5,90358,5.1
9084,November 1990,Connecticut,2576094,1827188,70.9,1729087,67.1,98101,5.4
9085,November 1990,Delaware,515837,363579,70.5,339658,65.8,23921,6.6
9086,November 1990,District of Columbia,486022,326323,67.1,304073,62.6,22250,6.8
9087,November 1990,Florida,10326907,6497875,62.9,6067750,58.8,430125,6.6
9088,November 1990,Georgia,4912120,3294118,67.1,3100318,63.1,193800,5.9
9089,November 1990,Hawaii,817443,561050,68.6,546804,66.9,14246,2.5
9090,November 1990,Idaho,736001,493914,67.1,465061,63.2,28853,5.8
9091,November 1990,Illinois,8731738,5936741,68.0,5556420,63.6,380321,6.4
9092,November 1990,Indiana,4215241,2799057,66.4,2642320,62.7,156737,5.6
9093,November 1990,Iowa,2095609,1455903,69.5,1388766,66.3,67137,4.6
9094,November 1990,Kansas,1828130,1278190,69.9,1218980,66.7,59210,4.6
9095,November 1990,Kentucky,2814548,1756711,62.4,1642468,58.4,114243,6.5
9096,November 1990,Louisiana,3090234,1888059,61.1,1758097,56.9,129962,6.9
9097,November 1990,Maine,942745,640207,67.9,597703,63.4,42504,6.6
9098,November 1990,Maryland,3701071,2608412,70.5,2467538,66.7,140874,5.4
9099,November 1990,Massachusetts,4713891,3202367,67.9,2964342,62.9,238025,7.4
9100,November 1990,Michigan,7039697,4587593,65.2,4216364,59.9,371229,8.1
9101,November 1990,Minnesota,3285536,2414646,73.5,2292425,69.8,122221,5.1
9102,November 1990,Mississippi,1908121,1189616,62.3,1092663,57.3,96953,8.1
9103,November 1990,Missouri,3877397,2639103,68.1,2462940,63.5,176163,6.7
9104,November 1990,Montana,597629,400059,66.9,373835,62.6,26224,6.6
9105,November 1990,Nebraska,1167681,829352,71.0,809698,69.3,19654,2.4
9106,November 1990,Nevada,958182,684328,71.4,648899,67.7,35429,5.2
9107,November 1990,New Hampshire,850053,618871,72.8,579458,68.2,39413,6.4
9108,November 1990,New Jersey,6065961,4066418,67.0,3829102,63.1,237316,5.8
9109,November 1990,New Mexico,1124335,717527,63.8,668757,59.5,48770,6.8
9110,November 1990,New York,14104890,8793744,62.3,8278987,58.7,514757,5.9
9111,November 1990,North Carolina,5135358,3491855,68.0,3319467,64.6,172388,4.9
9112,November 1990,North Dakota,464792,317361,68.3,304737,65.6,12624,4.0
9113,November 1990,Ohio,8269223,5425152,65.6,5103543,61.7,321609,5.9
9114,November 1990,Oklahoma,2352077,1517524,64.5,1424014,60.5,93510,6.2
9115,November 1990,Oregon,2209975,1505040,68.1,1416850,64.1,88190,5.9
9116,November 1990,Pennsylvania,9234710,5831632,63.1,5475357,59.3,356275,6.1
9117,November 1990,Rhode Island,779371,526156,67.5,487883,62.6,38273,7.3
9118,November 1990,South Carolina,2633758,1753473,66.6,1662076,63.1,91397,5.2
9119,November 1990,South Dakota,502977,347805,69.1,335209,66.6,12596,3.6
9120,November 1990,Tennessee,3789546,2396735,63.2,2252968,59.5,143767,6.0
9121,November 1990,Texas,12667615,8670233,68.4,8105688,64.0,564545,6.5
9122,November 1990,Utah,1175933,833788,70.9,797545,67.8,36243,4.3
9123,November 1990,Vermont,431268,302946,70.2,285286,66.2,17660,5.8
9124,November 1990,Virginia,4678404,3291601,70.4,3115914,66.6,175687,5.3
9125,November 1990,Washington,3701675,2524942,68.2,2386011,64.5,138931,5.5
9126,November 1990,West Virginia,1404641,767950,54.7,694788,49.5,73162,9.5
9127,November 1990,Wisconsin,3691010,2597670,70.4,2470094,66.9,127576,4.9
9128,November 1990,Wyoming,330236,235429,71.3,223010,67.5,12419,5.3
9129,December 1990,Alabama,3096625,1912654,61.8,1775275,57.3,137379,7.2
9130,December 1990,Alaska,374897,272056,72.6,251894,67.2,20162,7.4
9131,December 1990,Arizona,2807405,1787156,63.7,1695732,60.4,91424,5.1
9132,December 1990,Arkansas,1792941,1130465,63.1,1047363,58.4,83102,7.4
9133,December 1990,California,22669098,15121697,66.7,14084463,62.1,1037234,6.9
9134,December 1990,Colorado,2507730,1780570,71.0,1690906,67.4,89664,5.0
9135,December 1990,Connecticut,2575557,1828496,71.0,1729158,67.1,99338,5.4
9136,December 1990,Delaware,515913,363631,70.5,339089,65.7,24542,6.7
9137,December 1990,District of Columbia,485387,325153,67.0,302871,62.4,22282,6.9
9138,December 1990,Florida,10349263,6498557,62.8,6059465,58.5,439092,6.8
9139,December 1990,Georgia,4920130,3290789,66.9,3097378,63.0,193411,5.9
9140,December 1990,Hawaii,818574,563383,68.8,549016,67.1,14367,2.6
9141,December 1990,Idaho,738002,495896,67.2,466208,63.2,29688,6.0
9142,December 1990,Illinois,8735987,5935721,67.9,5554447,63.6,381274,6.4
9143,December 1990,Indiana,4218809,2798692,66.3,2635909,62.5,162783,5.8
9144,December 1990,Iowa,2096937,1457553,69.5,1389500,66.3,68053,4.7
9145,December 1990,Kansas,1829142,1278264,69.9,1218393,66.6,59871,4.7
9146,December 1990,Kentucky,2815597,1757989,62.4,1638976,58.2,119013,6.8
9147,December 1990,Louisiana,3091256,1890800,61.2,1758365,56.9,132435,7.0
9148,December 1990,Maine,943722,643633,68.2,597874,63.4,45759,7.1
9149,December 1990,Maryland,3703896,2609247,70.4,2463034,66.5,146213,5.6
9150,December 1990,Massachusetts,4711881,3200585,67.9,2953849,62.7,246736,7.7
9151,December 1990,Michigan,7044397,4587354,65.1,4201704,59.6,385650,8.4
9152,December 1990,Minnesota,3289221,2416354,73.5,2292975,69.7,123379,5.1
9153,December 1990,Mississippi,1909223,1192207,62.4,1092060,57.2,100147,8.4
9154,December 1990,Missouri,3878979,2642226,68.1,2461990,63.5,180236,6.8
9155,December 1990,Montana,597595,401103,67.1,374225,62.6,26878,6.7
9156,December 1990,Nebraska,1167925,830486,71.1,810578,69.4,19908,2.4
9157,December 1990,Nevada,964107,686957,71.3,650341,67.5,36616,5.3
9158,December 1990,New Hampshire,850149,618167,72.7,577210,67.9,40957,6.6
9159,December 1990,New Jersey,6067139,4066572,67.0,3820015,63.0,246557,6.1
9160,December 1990,New Mexico,1126547,718182,63.8,668873,59.4,49309,6.9
9161,December 1990,New York,14103971,8784321,62.3,8249326,58.5,534995,6.1
9162,December 1990,North Carolina,5142845,3497492,68.0,3316635,64.5,180857,5.2
9163,December 1990,North Dakota,464864,317133,68.2,304452,65.5,12681,4.0
9164,December 1990,Ohio,8273153,5429241,65.6,5095021,61.6,334220,6.2
9165,December 1990,Oklahoma,2353265,1514744,64.4,1419614,60.3,95130,6.3
9166,December 1990,Oregon,2214246,1505325,68.0,1416949,64.0,88376,5.9
9167,December 1990,Pennsylvania,9238320,5840078,63.2,5469573,59.2,370505,6.3
9168,December 1990,Rhode Island,778859,525195,67.4,485489,62.3,39706,7.6
9169,December 1990,South Carolina,2638736,1753261,66.4,1658858,62.9,94403,5.4
9170,December 1990,South Dakota,503066,347962,69.2,335462,66.7,12500,3.6
9171,December 1990,Tennessee,3794141,2399237,63.2,2248924,59.3,150313,6.3
9172,December 1990,Texas,12687216,8679857,68.4,8108364,63.9,571493,6.6
9173,December 1990,Utah,1179381,836135,70.9,799371,67.8,36764,4.4
9174,December 1990,Vermont,431292,302995,70.3,284387,65.9,18608,6.1
9175,December 1990,Virginia,4683532,3298456,70.4,3115700,66.5,182756,5.5
9176,December 1990,Washington,3709918,2526921,68.1,2383268,64.2,143653,5.7
9177,December 1990,West Virginia,1404518,769502,54.8,694605,49.5,74897,9.7
9178,December 1990,Wisconsin,3695466,2601184,70.4,2467562,66.8,133622,5.1
9179,December 1990,Wyoming,331258,235361,71.1,223065,67.3,12296,5.2
9180,January 1991,Alabama,3099427,1913170,61.7,1773651,57.2,139519,7.3
9181,January 1991,Alaska,375888,272576,72.5,252059,67.1,20517,7.5
9182,January 1991,Arizona,2814189,1785450,63.4,1694497,60.2,90953,5.1
9183,January 1991,Arkansas,1794353,1129183,62.9,1045299,58.3,83884,7.4
9184,January 1991,California,22684190,15115456,66.6,14042942,61.9,1072514,7.1
9185,January 1991,Colorado,2512708,1781282,70.9,1692047,67.3,89235,5.0
9186,January 1991,Connecticut,2575020,1830410,71.1,1729362,67.2,101048,5.5
9187,January 1991,Delaware,516989,363547,70.3,338684,65.5,24863,6.8
9188,January 1991,District of Columbia,484753,323854,66.8,301495,62.2,22359,6.9
9189,January 1991,Florida,10371618,6499530,62.7,6051031,58.3,448499,6.9
9190,January 1991,Georgia,4929141,3288186,66.7,3095851,62.8,192335,5.8
9191,January 1991,Hawaii,819705,565354,69.0,550763,67.2,14591,2.6
9192,January 1991,Idaho,740002,497949,67.3,467468,63.2,30481,6.1
9193,January 1991,Illinois,8741236,5935758,67.9,5551641,63.5,384117,6.5
9194,January 1991,Indiana,4222376,2798969,66.3,2630194,62.3,168775,6.0
9195,January 1991,Iowa,2098265,1459905,69.6,1391068,66.3,68837,4.7
9196,January 1991,Kansas,1829154,1278077,69.9,1217911,66.6,60166,4.7
9197,January 1991,Kentucky,2817647,1759529,62.4,1635989,58.1,123540,7.0
9198,January 1991,Louisiana,3092277,1893247,61.2,1758706,56.9,134541,7.1
9199,January 1991,Maine,943699,646787,68.5,597942,63.4,48845,7.6
9200,January 1991,Maryland,3705721,2609997,70.4,2459059,66.4,150938,5.8
9201,January 1991,Massachusetts,4708871,3199020,67.9,2944138,62.5,254882,8.0
9202,January 1991,Michigan,7049097,4590325,65.1,4188542,59.4,401783,8.8
9203,January 1991,Minnesota,3291906,2418022,73.5,2293395,69.7,124627,5.2
9204,January 1991,Mississippi,1910325,1193927,62.5,1090883,57.1,103044,8.6
9205,January 1991,Missouri,3881560,2644179,68.1,2461233,63.4,182946,6.9
9206,January 1991,Montana,598561,401861,67.1,374414,62.6,27447,6.8
9207,January 1991,Nebraska,1169169,831478,71.1,811223,69.4,20255,2.4
9208,January 1991,Nevada,970033,689732,71.1,651920,67.2,37812,5.5
9209,January 1991,New Hampshire,849244,617379,72.7,574953,67.7,42426,6.9
9210,January 1991,New Jersey,6069317,4066741,67.0,3812232,62.8,254509,6.3
9211,January 1991,New Mexico,1128759,718784,63.7,668935,59.3,49849,6.9
9212,January 1991,New York,14103051,8777929,62.2,8219779,58.3,558150,6.4
9213,January 1991,North Carolina,5151332,3503351,68.0,3315081,64.4,188270,5.4
9214,January 1991,North Dakota,464936,316868,68.2,303994,65.4,12874,4.1
9215,January 1991,Ohio,8277082,5432610,65.6,5085766,61.4,346844,6.4
9216,January 1991,Oklahoma,2355454,1512063,64.2,1416154,60.1,95909,6.3
9217,January 1991,Oregon,2219516,1505789,67.8,1417084,63.8,88705,5.9
9218,January 1991,Pennsylvania,9241930,5847550,63.3,5463138,59.1,384412,6.6
9219,January 1991,Rhode Island,779347,523963,67.2,482743,61.9,41220,7.9
9220,January 1991,South Carolina,2642714,1753119,66.3,1655381,62.6,97738,5.6
9221,January 1991,South Dakota,503155,348155,69.2,335722,66.7,12433,3.6
9222,January 1991,Tennessee,3798736,2402107,63.2,2246039,59.1,156068,6.5
9223,January 1991,Texas,12705818,8690060,68.4,8111414,63.8,578646,6.7
9224,January 1991,Utah,1182829,838374,70.9,801034,67.7,37340,4.5
9225,January 1991,Vermont,431317,303103,70.3,283583,65.7,19520,6.4
9226,January 1991,Virginia,4687659,3304541,70.5,3115788,66.5,188753,5.7
9227,January 1991,Washington,3718162,2529237,68.0,2381190,64.0,148047,5.9
9228,January 1991,West Virginia,1405394,770887,54.9,694593,49.4,76294,9.9
9229,January 1991,Wisconsin,3698921,2604651,70.4,2464948,66.6,139703,5.4
9230,January 1991,Wyoming,331279,235286,71.0,223142,67.4,12144,5.2
9231,February 1991,Alabama,3101229,1914039,61.7,1772332,57.1,141707,7.4
9232,February 1991,Alaska,376879,273178,72.5,252187,66.9,20991,7.7
9233,February 1991,Arizona,2820973,1785383,63.3,1694035,60.1,91348,5.1
9234,February 1991,Arkansas,1795765,1127841,62.8,1043422,58.1,84419,7.5
9235,February 1991,California,22696281,15113706,66.6,14008200,61.7,1105506,7.3
9236,February 1991,Colorado,2517685,1782769,70.8,1693527,67.3,89242,5.0
9237,February 1991,Connecticut,2573483,1833183,71.2,1729537,67.2,103646,5.7
9238,February 1991,Delaware,518065,363311,70.1,338441,65.3,24870,6.8
9239,February 1991,District of Columbia,483118,322644,66.8,300069,62.1,22575,7.0
9240,February 1991,Florida,10392973,6503303,62.6,6044430,58.2,458873,7.1
9241,February 1991,Georgia,4937152,3287130,66.6,3096313,62.7,190817,5.8
9242,February 1991,Hawaii,820836,566920,69.1,552023,67.3,14897,2.6
9243,February 1991,Idaho,742002,499927,67.4,468887,63.2,31040,6.2
9244,February 1991,Illinois,8744485,5937775,67.9,5548073,63.4,389702,6.6
9245,February 1991,Indiana,4224943,2800192,66.3,2626319,62.2,173873,6.2
9246,February 1991,Iowa,2098593,1462902,69.7,1393507,66.4,69395,4.7
9247,February 1991,Kansas,1829165,1277954,69.9,1217815,66.6,60139,4.7
9248,February 1991,Kentucky,2818697,1761238,62.5,1633971,58.0,127267,7.2
9249,February 1991,Louisiana,3092298,1896171,61.3,1759603,56.9,136568,7.2
9250,February 1991,Maine,943676,648924,68.8,597728,63.3,51196,7.9
9251,February 1991,Maryland,3708545,2610896,70.4,2456182,66.2,154714,5.9
9252,February 1991,Massachusetts,4704861,3198266,68.0,2935928,62.4,262338,8.2
9253,February 1991,Michigan,7052797,4595069,65.2,4177644,59.2,417425,9.1
9254,February 1991,Minnesota,3294591,2420081,73.5,2294029,69.6,126052,5.2
9255,February 1991,Mississippi,1910426,1194730,62.5,1089300,57.0,105430,8.8
9256,February 1991,Missouri,3883142,2646242,68.1,2461498,63.4,184744,7.0
9257,February 1991,Montana,599528,402296,67.1,374437,62.5,27859,6.9
9258,February 1991,Nebraska,1169413,832322,71.2,811631,69.4,20691,2.5
9259,February 1991,Nevada,974959,692653,71.0,653725,67.1,38928,5.6
9260,February 1991,New Hampshire,849340,616583,72.6,572916,67.5,43667,7.1
9261,February 1991,New Jersey,6069495,4067397,67.0,3806575,62.7,260822,6.4
9262,February 1991,New Mexico,1129971,719390,63.7,668984,59.2,50406,7.0
9263,February 1991,New York,14100132,8775940,62.2,8192963,58.1,582977,6.6
9264,February 1991,North Carolina,5158819,3509555,68.0,3315020,64.3,194535,5.5
9265,February 1991,North Dakota,464008,316575,68.2,303408,65.4,13167,4.2
9266,February 1991,Ohio,8280011,5435009,65.6,5077682,61.3,357327,6.6
9267,February 1991,Oklahoma,2355643,1509867,64.1,1413843,60.0,96024,6.4
9268,February 1991,Oregon,2223787,1507091,67.8,1417790,63.8,89301,5.9
9269,February 1991,Pennsylvania,9243540,5853533,63.3,5456511,59.0,397022,6.8
9270,February 1991,Rhode Island,779836,522586,67.0,479981,61.5,42605,8.2
9271,February 1991,South Carolina,2646692,1753239,66.2,1652339,62.4,100900,5.8
9272,February 1991,South Dakota,503244,348401,69.2,336012,66.8,12389,3.6
9273,February 1991,Tennessee,3802331,2405587,63.3,2244786,59.0,160801,6.7
9274,February 1991,Texas,12722419,8702207,68.4,8116452,63.8,585755,6.7
9275,February 1991,Utah,1186278,840623,70.9,802677,67.7,37946,4.5
9276,February 1991,Vermont,431341,303277,70.3,282946,65.6,20331,6.7
9277,February 1991,Virginia,4691787,3310647,70.6,3117365,66.4,193282,5.8
9278,February 1991,Washington,3725405,2532041,68.0,2380244,63.9,151797,6.0
9279,February 1991,West Virginia,1406271,772140,54.9,694692,49.4,77448,10.0
9280,February 1991,Wisconsin,3702377,2608106,70.4,2463220,66.5,144886,5.6
9281,February 1991,Wyoming,331301,235246,71.0,223229,67.4,12017,5.1
9282,March 1991,Alabama,3104031,1915045,61.7,1771755,57.1,143290,7.5
9283,March 1991,Alaska,377871,273856,72.5,252315,66.8,21541,7.9
9284,March 1991,Arizona,2827757,1786810,63.2,1694191,59.9,92619,5.2
9285,March 1991,Arkansas,1797177,1126678,62.7,1042026,58.0,84652,7.5
9286,March 1991,California,22708373,15113573,66.6,13980838,61.6,1132735,7.5
9287,March 1991,Colorado,2522663,1785107,70.8,1695439,67.2,89668,5.0
9288,March 1991,Connecticut,2572946,1836365,71.4,1729252,67.2,107113,5.8
9289,March 1991,Delaware,518141,362864,70.0,338300,65.3,24564,6.8
9290,March 1991,District of Columbia,482484,321724,66.7,298752,61.9,22972,7.1
9291,March 1991,Florida,10413328,6509319,62.5,6039921,58.0,469398,7.2
9292,March 1991,Georgia,4945163,3286238,66.5,3098201,62.7,188037,5.7
9293,March 1991,Hawaii,821967,568140,69.1,552924,67.3,15216,2.7
9294,March 1991,Idaho,744002,501805,67.4,470498,63.2,31307,6.2
9295,March 1991,Illinois,8747734,5939862,67.9,5542934,63.4,396928,6.7
9296,March 1991,Indiana,4228511,2800796,66.2,2624169,62.1,176627,6.3
9297,March 1991,Iowa,2098922,1465947,69.8,1396374,66.5,69573,4.7
9298,March 1991,Kansas,1830177,1278016,69.8,1218276,66.6,59740,4.7
9299,March 1991,Kentucky,2820747,1762717,62.5,1632873,57.9,129844,7.4
9300,March 1991,Louisiana,3092319,1899352,61.4,1760969,56.9,138383,7.3
9301,March 1991,Maine,943652,649647,68.8,597259,63.3,52388,8.1
9302,March 1991,Maryland,3710370,2611581,70.4,2454500,66.2,157081,6.0
9303,March 1991,Massachusetts,4701851,3198048,68.0,2929264,62.3,268784,8.4
9304,March 1991,Michigan,7055496,4597706,65.2,4168700,59.1,429006,9.3
9305,March 1991,Minnesota,3297276,2422262,73.5,2295035,69.6,127227,5.3
9306,March 1991,Mississippi,1911528,1194382,62.5,1087415,56.9,106967,9.0
9307,March 1991,Missouri,3884723,2647795,68.2,2462732,63.4,185063,7.0
9308,March 1991,Montana,599494,402521,67.1,374445,62.5,28076,7.0
9309,March 1991,Nebraska,1170656,833086,71.2,811930,69.4,21156,2.5
9310,March 1991,Nevada,980884,695485,70.9,655647,66.8,39838,5.7
9311,March 1991,New Hampshire,848436,615826,72.6,571239,67.3,44587,7.2
9312,March 1991,New Jersey,6069674,4067904,67.0,3802866,62.7,265038,6.5
9313,March 1991,New Mexico,1132184,720194,63.6,669229,59.1,50965,7.1
9314,March 1991,New York,14097213,8775539,62.3,8169223,57.9,606316,6.9
9315,March 1991,North Carolina,5166306,3515911,68.1,3316339,64.2,199572,5.7
9316,March 1991,North Dakota,464080,316228,68.1,302735,65.2,13493,4.3
9317,March 1991,Ohio,8281941,5435344,65.6,5072190,61.2,363154,6.7
9318,March 1991,Oklahoma,2356832,1508047,64.0,1412440,59.9,95607,6.3
9319,March 1991,Oregon,2228057,1509206,67.7,1419027,63.7,90179,6.0
9320,March 1991,Pennsylvania,9245150,5856730,63.3,5449835,58.9,406895,6.9
9321,March 1991,Rhode Island,779324,521186,66.9,477528,61.3,43658,8.4
9322,March 1991,South Carolina,2650669,1753485,66.2,1650179,62.3,103306,5.9
9323,March 1991,South Dakota,504332,348692,69.1,336331,66.7,12361,3.5
9324,March 1991,Tennessee,3805926,2408753,63.3,2244775,59.0,163978,6.8
9325,March 1991,Texas,12739020,8715080,68.4,8123665,63.8,591415,6.8
9326,March 1991,Utah,1188726,842975,70.9,804428,67.7,38547,4.6
9327,March 1991,Vermont,431366,303480,70.4,282553,65.5,20927,6.9
9328,March 1991,Virginia,4695915,3316308,70.6,3120475,66.5,195833,5.9
9329,March 1991,Washington,3733648,2534809,67.9,2380245,63.8,154564,6.1
9330,March 1991,West Virginia,1406147,773271,55.0,694775,49.4,78496,10.2
9331,March 1991,Wisconsin,3705832,2611051,70.5,2463009,66.5,148042,5.7
9332,March 1991,Wyoming,332322,235268,70.8,223322,67.2,11946,5.1
9333,April 1991,Alabama,3106833,1915943,61.7,1772198,57.0,143745,7.5
9334,April 1991,Alaska,378862,274551,72.5,252441,66.6,22110,8.1
9335,April 1991,Arizona,2834541,1789356,63.1,1694600,59.8,94756,5.3
9336,April 1991,Arkansas,1798588,1125820,62.6,1041231,57.9,84589,7.5
9337,April 1991,California,22723464,15113131,66.5,13961200,61.4,1151931,7.6
9338,April 1991,Colorado,2527640,1788000,70.7,1697598,67.2,90402,5.1
9339,April 1991,Connecticut,2572409,1839380,71.5,1728220,67.2,111160,6.0
9340,April 1991,Delaware,519217,362207,69.8,338187,65.1,24020,6.6
9341,April 1991,District of Columbia,481850,321232,66.7,297692,61.8,23540,7.3
9342,April 1991,Florida,10435683,6516320,62.4,6037635,57.9,478685,7.3
9343,April 1991,Georgia,4953174,3284320,66.3,3100847,62.6,183473,5.6
9344,April 1991,Hawaii,823099,569190,69.2,553676,67.3,15514,2.7
9345,April 1991,Idaho,747002,503652,67.4,472261,63.2,31391,6.2
9346,April 1991,Illinois,8752983,5940157,67.9,5536039,63.2,404118,6.8
9347,April 1991,Indiana,4232078,2799606,66.2,2623524,62.0,176082,6.3
9348,April 1991,Iowa,2100250,1468587,69.9,1399221,66.6,69366,4.7
9349,April 1991,Kansas,1830189,1278183,69.8,1219231,66.6,58952,4.6
9350,April 1991,Kentucky,2821797,1763658,62.5,1632490,57.9,131168,7.4
9351,April 1991,Louisiana,3093341,1902372,61.5,1762736,57.0,139636,7.3
9352,April 1991,Maine,943629,649032,68.8,596702,63.2,52330,8.1
9353,April 1991,Maryland,3713195,2611771,70.3,2453855,66.1,157916,6.0
9354,April 1991,Massachusetts,4698841,3198131,68.1,2924077,62.2,274054,8.6
9355,April 1991,Michigan,7060196,4595838,65.1,4161539,58.9,434299,9.4
9356,April 1991,Minnesota,3299961,2424233,73.5,2296521,69.6,127712,5.3
9357,April 1991,Mississippi,1912630,1192903,62.4,1085454,56.8,107449,9.0
9358,April 1991,Missouri,3886305,2648247,68.1,2464755,63.4,183492,6.9
9359,April 1991,Montana,600460,402778,67.1,374684,62.4,28094,7.0
9360,April 1991,Nebraska,1170900,833952,71.2,812343,69.4,21609,2.6
9361,April 1991,Nevada,985810,698070,70.8,657647,66.7,40423,5.8
9362,April 1991,New Hampshire,848532,615076,72.5,569901,67.2,45175,7.3
9363,April 1991,New Jersey,6070852,4067459,67.0,3800524,62.6,266935,6.6
9364,April 1991,New Mexico,1133396,721378,63.6,669900,59.1,51478,7.1
9365,April 1991,New York,14095294,8773441,62.2,8148418,57.8,625023,7.1
9366,April 1991,North Carolina,5173793,3522766,68.1,3319148,64.2,203618,5.8
9367,April 1991,North Dakota,464152,315831,68.0,302060,65.1,13771,4.4
9368,April 1991,Ohio,8285870,5433409,65.6,5069981,61.2,363428,6.7
9369,April 1991,Oklahoma,2359021,1506626,63.9,1411654,59.8,94972,6.3
9370,April 1991,Oregon,2232328,1511640,67.7,1420405,63.6,91235,6.0
9371,April 1991,Pennsylvania,9248760,5856655,63.3,5443600,58.9,413055,7.1
9372,April 1991,Rhode Island,779812,519870,66.7,475559,61.0,44311,8.5
9373,April 1991,South Carolina,2654647,1753735,66.1,1648920,62.1,104815,6.0
9374,April 1991,South Dakota,504421,349025,69.2,336679,66.7,12346,3.5
9375,April 1991,Tennessee,3810521,2410957,63.3,2245558,58.9,165399,6.9
9376,April 1991,Texas,12757622,8727678,68.4,8132922,63.7,594756,6.8
9377,April 1991,Utah,1192175,845497,70.9,806359,67.6,39138,4.6
9378,April 1991,Vermont,431390,303646,70.4,282439,65.5,21207,7.0
9379,April 1991,Virginia,4700042,3321602,70.7,3125054,66.5,196548,5.9
9380,April 1991,Washington,3740891,2537193,67.8,2380727,63.6,156466,6.2
9381,April 1991,West Virginia,1407024,774349,55.0,694791,49.4,79558,10.3
9382,April 1991,Wisconsin,3710288,2613253,70.4,2464557,66.4,148696,5.7
9383,April 1991,Wyoming,332344,235345,70.8,223411,67.2,11934,5.1
9384,May 1991,Alabama,3109635,1916793,61.6,1773793,57.0,143000,7.5
9385,May 1991,Alaska,379853,275239,72.5,252570,66.5,22669,8.2
9386,May 1991,Arizona,2841324,1793017,63.1,1695085,59.7,97932,5.5
9387,May 1991,Arkansas,1800000,1125441,62.5,1041165,57.8,84276,7.5
9388,May 1991,California,22738556,15112948,66.5,13949592,61.3,1163356,7.7
9389,May 1991,Colorado,2532618,1791139,70.7,1699798,67.1,91341,5.1
9390,May 1991,Connecticut,2571872,1841952,71.6,1726461,67.1,115491,6.3
9391,May 1991,Delaware,520293,361434,69.5,338109,65.0,23325,6.5
9392,May 1991,District of Columbia,481215,321091,66.7,296879,61.7,24212,7.5
9393,May 1991,Florida,10457039,6523977,62.4,6037693,57.7,486284,7.5
9394,May 1991,Georgia,4962185,3281383,66.1,3103908,62.6,177475,5.4
9395,May 1991,Hawaii,824230,570225,69.2,554450,67.3,15775,2.8
9396,May 1991,Idaho,749002,505494,67.5,474129,63.3,31365,6.2
9397,May 1991,Illinois,8757232,5938408,67.8,5527990,63.1,410418,6.9
9398,May 1991,Indiana,4235646,2796779,66.0,2624063,62.0,172716,6.2
9399,May 1991,Iowa,2101578,1470600,70.0,1401795,66.7,68805,4.7
9400,May 1991,Kansas,1831201,1278424,69.8,1220554,66.7,57870,4.5
9401,May 1991,Kentucky,2823846,1764062,62.5,1632601,57.8,131461,7.5
9402,May 1991,Louisiana,3093362,1905271,61.6,1765058,57.1,140213,7.4
9403,May 1991,Maine,943606,647409,68.6,596201,63.2,51208,7.9
9404,May 1991,Maryland,3715019,2611850,70.3,2454122,66.1,157728,6.0
9405,May 1991,Massachusetts,4695831,3198490,68.1,2920324,62.2,278166,8.7
9406,May 1991,Michigan,7064896,4590716,65.0,4157008,58.8,433708,9.4
9407,May 1991,Minnesota,3303646,2425844,73.4,2298578,69.6,127266,5.2
9408,May 1991,Mississippi,1912732,1190492,62.2,1083700,56.7,106792,9.0
9409,May 1991,Missouri,3888886,2648106,68.1,2467527,63.5,180579,6.8
9410,May 1991,Montana,600427,403290,67.2,375338,62.5,27952,6.9
9411,May 1991,Nebraska,1172144,835016,71.2,813054,69.4,21962,2.6
9412,May 1991,Nevada,991735,700387,70.6,659725,66.5,40662,5.8
9413,May 1991,New Hampshire,847627,614371,72.5,568864,67.1,45507,7.4
9414,May 1991,New Jersey,6072030,4065948,67.0,3799039,62.6,266909,6.6
9415,May 1991,New Mexico,1135608,722976,63.7,671112,59.1,51864,7.2
9416,May 1991,New York,14094375,8767616,62.2,8130636,57.7,636980,7.3
9417,May 1991,North Carolina,5182280,3530532,68.1,3323988,64.1,206544,5.9
9418,May 1991,North Dakota,463224,315429,68.1,301498,65.1,13931,4.4
9419,May 1991,Ohio,8289799,5430397,65.5,5071146,61.2,359251,6.6
9420,May 1991,Oklahoma,2360209,1505931,63.8,1411340,59.8,94591,6.3
9421,May 1991,Oregon,2237598,1514161,67.7,1421664,63.5,92497,6.1
9422,May 1991,Pennsylvania,9252370,5853844,63.3,5438685,58.8,415159,7.1
9423,May 1991,Rhode Island,779300,518688,66.6,474086,60.8,44602,8.6
9424,May 1991,South Carolina,2658625,1754068,66.0,1648388,62.0,105680,6.0
9425,May 1991,South Dakota,504510,349383,69.3,337065,66.8,12318,3.5
9426,May 1991,Tennessee,3815116,2412480,63.2,2247020,58.9,165460,6.9
9427,May 1991,Texas,12776223,8740588,68.4,8144048,63.7,596540,6.8
9428,May 1991,Utah,1195623,848146,70.9,808466,67.6,39680,4.7
9429,May 1991,Vermont,432414,303745,70.2,282606,65.4,21139,7.0
9430,May 1991,Virginia,4705170,3327233,70.7,3131273,66.5,195960,5.9
9431,May 1991,Washington,3749134,2539476,67.7,2381546,63.5,157930,6.2
9432,May 1991,West Virginia,1407900,775477,55.1,694761,49.3,80716,10.4
9433,May 1991,Wisconsin,3713743,2615009,70.4,2467796,66.5,147213,5.6
9434,May 1991,Wyoming,332365,235463,70.8,223497,67.2,11966,5.1
9435,June 1991,Alabama,3112438,1917741,61.6,1776404,57.1,141337,7.4
9436,June 1991,Alaska,380845,275895,72.4,252704,66.4,23191,8.4
9437,June 1991,Arizona,2848108,1797945,63.1,1695877,59.5,102068,5.7
9438,June 1991,Arkansas,1801412,1125673,62.5,1041874,57.8,83799,7.4
9439,June 1991,California,22756648,15114191,66.4,13945559,61.3,1168632,7.7
9440,June 1991,Colorado,2537595,1794282,70.7,1701828,67.1,92454,5.2
9441,June 1991,Connecticut,2571335,1844045,71.7,1724160,67.1,119885,6.5
9442,June 1991,Delaware,520369,360731,69.3,338167,65.0,22564,6.3
9443,June 1991,District of Columbia,479581,321133,67.0,296248,61.8,24885,7.7
9444,June 1991,Florida,10480394,6531524,62.3,6039639,57.6,491885,7.5
9445,June 1991,Georgia,4971196,3277892,65.9,3107131,62.5,170761,5.2
9446,June 1991,Hawaii,826361,571272,69.1,555291,67.2,15981,2.8
9447,June 1991,Idaho,751002,507333,67.6,476055,63.4,31278,6.2
9448,June 1991,Illinois,8762480,5935879,67.7,5519302,63.0,416577,7.0
9449,June 1991,Indiana,4239213,2792926,65.9,2625222,61.9,167704,6.0
9450,June 1991,Iowa,2102906,1472262,70.0,1404211,66.8,68051,4.6
9451,June 1991,Kansas,1831213,1278745,69.8,1222098,66.7,56647,4.4
9452,June 1991,Kentucky,2825896,1763963,62.4,1633025,57.8,130938,7.4
9453,June 1991,Louisiana,3094383,1908177,61.7,1768006,57.1,140171,7.3
9454,June 1991,Maine,943583,645280,68.4,595889,63.2,49391,7.7
9455,June 1991,Maryland,3717844,2612280,70.3,2455124,66.0,157156,6.0
9456,June 1991,Massachusetts,4693821,3198792,68.1,2917711,62.2,281081,8.8
9457,June 1991,Michigan,7069596,4585178,64.9,4156299,58.8,428879,9.4
9458,June 1991,Minnesota,3306331,2427273,73.4,2301094,69.6,126179,5.2
9459,June 1991,Mississippi,1913834,1187369,62.0,1082369,56.6,105000,8.8
9460,June 1991,Missouri,3890468,2647972,68.1,2471050,63.5,176922,6.7
9461,June 1991,Montana,601393,404105,67.2,376360,62.6,27745,6.9
9462,June 1991,Nebraska,1173388,836191,71.3,813966,69.4,22225,2.7
9463,June 1991,Nevada,997661,702420,70.4,661752,66.3,40668,5.8
9464,June 1991,New Hampshire,847723,613820,72.4,568180,67.0,45640,7.4
9465,June 1991,New Jersey,6073208,4063989,66.9,3797709,62.5,266280,6.6
9466,June 1991,New Mexico,1137820,724741,63.7,672660,59.1,52081,7.2
9467,June 1991,New York,14095456,8757553,62.1,8115530,57.6,642023,7.3
9468,June 1991,North Carolina,5190768,3538981,68.2,3330860,64.2,208121,5.9
9469,June 1991,North Dakota,463296,315055,68.0,301102,65.0,13953,4.4
9470,June 1991,Ohio,8294729,5427431,65.4,5075115,61.2,352316,6.5
9471,June 1991,Oklahoma,2361398,1505949,63.8,1411410,59.8,94539,6.3
9472,June 1991,Oregon,2242869,1516551,67.6,1422514,63.4,94037,6.2
9473,June 1991,Pennsylvania,9255980,5850075,63.2,5435877,58.7,414198,7.1
9474,June 1991,Rhode Island,779789,517634,66.4,472998,60.7,44636,8.6
9475,June 1991,South Carolina,2662603,1754845,65.9,1648447,61.9,106398,6.1
9476,June 1991,South Dakota,504599,349746,69.3,337471,66.9,12275,3.5
9477,June 1991,Tennessee,3819711,2413911,63.2,2249100,58.9,164811,6.8
9478,June 1991,Texas,12795824,8754825,68.4,8156673,63.7,598152,6.8
9479,June 1991,Utah,1199072,850903,71.0,810756,67.6,40147,4.7
9480,June 1991,Vermont,432439,303746,70.2,283011,65.4,20735,6.8
9481,June 1991,Virginia,4709298,3333805,70.8,3138949,66.7,194856,5.8
9482,June 1991,Washington,3758378,2542081,67.6,2382682,63.4,159399,6.3
9483,June 1991,West Virginia,1407777,776663,55.2,694720,49.3,81943,10.6
9484,June 1991,Wisconsin,3718199,2616864,70.4,2472280,66.5,144584,5.5
9485,June 1991,Wyoming,333387,235585,70.7,223551,67.1,12034,5.1
9486,July 1991,Alabama,3116240,1918938,61.6,1779430,57.1,139508,7.3
9487,July 1991,Alaska,381836,276483,72.4,252806,66.2,23677,8.6
9488,July 1991,Arizona,2855892,1803825,63.2,1697021,59.4,106804,5.9
9489,July 1991,Arkansas,1803824,1126454,62.4,1043144,57.8,83310,7.4
9490,July 1991,California,22772739,15116703,66.4,13946036,61.2,1170667,7.7
9491,July 1991,Colorado,2543573,1796970,70.6,1703204,67.0,93766,5.2
9492,July 1991,Connecticut,2570798,1845528,71.8,1721451,67.0,124077,6.7
9493,July 1991,Delaware,521445,360272,69.1,338455,64.9,21817,6.1
9494,July 1991,District of Columbia,478946,321176,67.1,295695,61.7,25481,7.9
9495,July 1991,Florida,10502749,6537530,62.2,6041752,57.5,495778,7.6
9496,July 1991,Georgia,4979207,3273994,65.8,3110038,62.5,163956,5.0
9497,July 1991,Hawaii,827492,572333,69.2,556129,67.2,16204,2.8
9498,July 1991,Idaho,753002,509164,67.6,477902,63.5,31262,6.1
9499,July 1991,Illinois,8767729,5934525,67.7,5509685,62.8,424840,7.2
9500,July 1991,Indiana,4243780,2788682,65.7,2626173,61.9,162509,5.8
9501,July 1991,Iowa,2103234,1474091,70.1,1406694,66.9,67397,4.6
9502,July 1991,Kansas,1832224,1279127,69.8,1223656,66.8,55471,4.3
9503,July 1991,Kentucky,2826946,1763449,62.4,1633530,57.8,129919,7.4
9504,July 1991,Louisiana,3095405,1910729,61.7,1771129,57.2,139600,7.3
9505,July 1991,Maine,943560,643262,68.2,595821,63.1,47441,7.4
9506,July 1991,Maryland,3720669,2613202,70.2,2456347,66.0,156855,6.0
9507,July 1991,Massachusetts,4690811,3198378,68.2,2915676,62.2,282702,8.8
9508,July 1991,Michigan,7074296,4581862,64.8,4159454,58.8,422408,9.2
9509,July 1991,Minnesota,3310016,2428612,73.4,2303687,69.6,124925,5.1
9510,July 1991,Mississippi,1914936,1183680,61.8,1081362,56.5,102318,8.6
9511,July 1991,Missouri,3893050,2647504,68.0,2474577,63.6,172927,6.5
9512,July 1991,Montana,602359,405221,67.3,377603,62.7,27618,6.8
9513,July 1991,Nebraska,1173631,837303,71.3,814820,69.4,22483,2.7
9514,July 1991,Nevada,1003587,704212,70.2,663564,66.1,40648,5.8
9515,July 1991,New Hampshire,847819,613445,72.4,567838,67.0,45607,7.4
9516,July 1991,New Jersey,6075386,4062228,66.9,3795633,62.5,266595,6.6
9517,July 1991,New Mexico,1139032,726362,63.8,674232,59.2,52130,7.2
9518,July 1991,New York,14094537,8743327,62.0,8100769,57.5,642558,7.3
9519,July 1991,North Carolina,5198255,3546816,68.2,3338288,64.2,208528,5.9
9520,July 1991,North Dakota,463368,314742,67.9,300862,64.9,13880,4.4
9521,July 1991,Ohio,8298658,5424981,65.4,5080180,61.2,344801,6.4
9522,July 1991,Oklahoma,2363587,1506312,63.7,1411591,59.7,94721,6.3
9523,July 1991,Oregon,2247139,1518432,67.6,1422585,63.3,95847,6.3
9524,July 1991,Pennsylvania,9259590,5847260,63.1,5435013,58.7,412247,7.1
9525,July 1991,Rhode Island,779277,516558,66.3,471974,60.6,44584,8.6
9526,July 1991,South Carolina,2667581,1756175,65.8,1648862,61.8,107313,6.1
9527,July 1991,South Dakota,505688,350095,69.2,337859,66.8,12236,3.5
9528,July 1991,Tennessee,3824306,2415302,63.2,2251321,58.9,163981,6.8
9529,July 1991,Texas,12814426,8769323,68.4,8169147,63.7,600176,6.8
9530,July 1991,Utah,1202520,853677,71.0,813140,67.6,40537,4.7
9531,July 1991,Vermont,432463,303656,70.2,283561,65.6,20095,6.6
9532,July 1991,Virginia,4714425,3341068,70.9,3146978,66.8,194090,5.8
9533,July 1991,Washington,3766621,2544849,67.6,2383690,63.3,161159,6.3
9534,July 1991,West Virginia,1408653,777786,55.2,694613,49.3,83173,10.7
9535,July 1991,Wisconsin,3722654,2619275,70.4,2477138,66.5,142137,5.4
9536,July 1991,Wyoming,333408,235673,70.7,223532,67.0,12141,5.2
9537,August 1991,Alabama,3119042,1920760,61.6,1782414,57.1,138346,7.2
9538,August 1991,Alaska,382828,277077,72.4,252917,66.1,24160,8.7
9539,August 1991,Arizona,2864676,1810356,63.2,1698431,59.3,111925,6.2
9540,August 1991,Arkansas,1805235,1127966,62.5,1044958,57.9,83008,7.4
9541,August 1991,California,22800831,15122207,66.3,13947745,61.2,1174462,7.8
9542,August 1991,Colorado,2549550,1799120,70.6,1703810,66.8,95310,5.3
9543,August 1991,Connecticut,2570262,1846227,71.8,1718463,66.9,127764,6.9
9544,August 1991,Delaware,522521,360207,68.9,338994,64.9,21213,5.9
9545,August 1991,District of Columbia,478312,321146,67.1,295156,61.7,25990,8.1
9546,August 1991,Florida,10520104,6542562,62.2,6042786,57.4,499776,7.6
9547,August 1991,Georgia,4989217,3270962,65.6,3112621,62.4,158341,4.8
9548,August 1991,Hawaii,828623,573364,69.2,556842,67.2,16522,2.9
9549,August 1991,Idaho,755003,510941,67.7,479569,63.5,31372,6.1
9550,August 1991,Illinois,8774978,5936615,67.7,5499911,62.7,436704,7.4
9551,August 1991,Indiana,4247348,2785489,65.6,2626688,61.8,158801,5.7
9552,August 1991,Iowa,2105562,1476704,70.1,1409460,66.9,67244,4.6
9553,August 1991,Kansas,1834236,1279721,69.8,1225206,66.8,54515,4.3
9554,August 1991,Kentucky,2829996,1763065,62.3,1634078,57.7,128987,7.3
9555,August 1991,Louisiana,3097426,1912764,61.8,1773909,57.3,138855,7.3
9556,August 1991,Maine,944537,641896,68.0,595883,63.1,46013,7.2
9557,August 1991,Maryland,3723493,2615303,70.2,2457548,66.0,157755,6.0
9558,August 1991,Massachusetts,4690801,3196914,68.2,2913865,62.1,283049,8.9
9559,August 1991,Michigan,7079995,4583262,64.7,4165387,58.8,417875,9.1
9560,August 1991,Minnesota,3312701,2430081,73.4,2306082,69.6,123999,5.1
9561,August 1991,Mississippi,1916038,1179820,61.6,1080482,56.4,99338,8.4
9562,August 1991,Missouri,3895631,2646718,67.9,2477407,63.6,169311,6.4
9563,August 1991,Montana,603325,406611,67.4,378927,62.8,27684,6.8
9564,August 1991,Nebraska,1174875,838230,71.3,815473,69.4,22757,2.7
9565,August 1991,Nevada,1007512,705954,70.1,665110,66.0,40844,5.8
9566,August 1991,New Hampshire,847914,613255,72.3,567779,67.0,45476,7.4
9567,August 1991,New Jersey,6077565,4061382,66.8,3792256,62.4,269126,6.6
9568,August 1991,New Mexico,1141245,727785,63.8,675652,59.2,52133,7.2
9569,August 1991,New York,14097618,8727816,61.9,8084980,57.3,642836,7.4
9570,August 1991,North Carolina,5204742,3552984,68.3,3344748,64.3,208236,5.9
9571,August 1991,North Dakota,463440,314526,67.9,300725,64.9,13801,4.4
9572,August 1991,Ohio,8303588,5424650,65.3,5084859,61.2,339791,6.3
9573,August 1991,Oklahoma,2365776,1506475,63.7,1411802,59.7,94673,6.3
9574,August 1991,Oregon,2251410,1520044,67.5,1421986,63.2,98058,6.5
9575,August 1991,Pennsylvania,9262200,5847348,63.1,5435672,58.7,411676,7.0
9576,August 1991,Rhode Island,779765,515619,66.1,470989,60.4,44630,8.7
9577,August 1991,South Carolina,2670559,1758512,65.8,1649641,61.8,108871,6.2
9578,August 1991,South Dakota,505777,350449,69.3,338245,66.9,12204,3.5
9579,August 1991,Tennessee,3828902,2416795,63.1,2253386,58.9,163409,6.8
9580,August 1991,Texas,12835027,8784865,68.4,8180166,63.7,604699,6.9
9581,August 1991,Utah,1206968,856381,71.0,815515,67.6,40866,4.8
9582,August 1991,Vermont,432487,303536,70.2,284094,65.7,19442,6.4
9583,August 1991,Virginia,4720553,3348932,70.9,3154386,66.8,194546,5.8
9584,August 1991,Washington,3774864,2547958,67.5,2384585,63.2,163373,6.4
9585,August 1991,West Virginia,1409530,778855,55.3,694373,49.3,84482,10.8
9586,August 1991,Wisconsin,3726110,2622795,70.4,2481962,66.6,140833,5.4
9587,August 1991,Wyoming,334430,235745,70.5,223443,66.8,12302,5.2
9588,September 1991,Alabama,3122844,1923679,61.6,1785300,57.2,138379,7.2
9589,September 1991,Alaska,383819,277841,72.4,253172,66.0,24669,8.9
9590,September 1991,Arizona,2873460,1817549,63.3,1700131,59.2,117418,6.5
9591,September 1991,Arkansas,1807647,1130495,62.5,1047416,57.9,83079,7.3
9592,September 1991,California,22830922,15133835,66.3,13948583,61.1,1185252,7.8
9593,September 1991,Colorado,2556528,1801088,70.5,1704113,66.7,96975,5.4
9594,September 1991,Connecticut,2568725,1846188,71.9,1715335,66.8,130853,7.1
9595,September 1991,Delaware,522597,360551,69.0,339743,65.0,20808,5.8
9596,September 1991,District of Columbia,477678,321088,67.2,294654,61.7,26434,8.2
9597,September 1991,Florida,10538460,6548927,62.1,6042751,57.3,506176,7.7
9598,September 1991,Georgia,4999228,3270708,65.4,3115293,62.3,155415,4.8
9599,September 1991,Hawaii,829754,574318,69.2,557333,67.2,16985,3.0
9600,September 1991,Idaho,757003,512653,67.7,481050,63.5,31603,6.2
9601,September 1991,Illinois,8783227,5944191,67.7,5491747,62.5,452444,7.6
9602,September 1991,Indiana,4251915,2784966,65.5,2627293,61.8,157673,5.7
9603,September 1991,Iowa,2107890,1480434,70.2,1412671,67.0,67763,4.6
9604,September 1991,Kansas,1837248,1280689,69.7,1226890,66.8,53799,4.2
9605,September 1991,Kentucky,2833045,1763341,62.2,1634907,57.7,128434,7.3
9606,September 1991,Louisiana,3100447,1914612,61.8,1776072,57.3,138540,7.2
9607,September 1991,Maine,944513,641385,67.9,595933,63.1,45452,7.1
9608,September 1991,Maryland,3725318,2619192,70.3,2458831,66.0,160361,6.1
9609,September 1991,Massachusetts,4690791,3194515,68.1,2912210,62.1,282305,8.8
9610,September 1991,Michigan,7085695,4590516,64.8,4172993,58.9,417523,9.1
9611,September 1991,Minnesota,3316386,2431937,73.3,2308214,69.6,123723,5.1
9612,September 1991,Mississippi,1918140,1176494,61.3,1079713,56.3,96781,8.2
9613,September 1991,Missouri,3899213,2646078,67.9,2479565,63.6,166513,6.3
9614,September 1991,Montana,604292,408168,67.5,380218,62.9,27950,6.8
9615,September 1991,Nebraska,1177119,838929,71.3,815904,69.3,23025,2.7
9616,September 1991,Nevada,1011438,707897,70.0,666432,65.9,41465,5.9
9617,September 1991,New Hampshire,848010,613199,72.3,567892,67.0,45307,7.4
9618,September 1991,New Jersey,6079743,4062370,66.8,3787782,62.3,274588,6.8
9619,September 1991,New Mexico,1144457,729114,63.7,676810,59.1,52304,7.2
9620,September 1991,New York,14101699,8715680,61.8,8068393,57.2,647287,7.4
9621,September 1991,North Carolina,5212229,3557559,68.3,3349379,64.3,208180,5.9
9622,September 1991,North Dakota,463512,314425,67.8,300627,64.9,13798,4.4
9623,September 1991,Ohio,8308517,5428330,65.3,5088624,61.2,339706,6.3
9624,September 1991,Oklahoma,2368965,1506545,63.6,1412178,59.6,94367,6.3
9625,September 1991,Oregon,2255680,1522068,67.5,1421224,63.0,100844,6.6
9626,September 1991,Pennsylvania,9265810,5851829,63.2,5437447,58.7,414382,7.1
9627,September 1991,Rhode Island,780253,515229,66.0,470373,60.3,44856,8.7
9628,September 1991,South Carolina,2673537,1762200,65.9,1651015,61.8,111185,6.3
9629,September 1991,South Dakota,506865,350879,69.2,338716,66.8,12163,3.5
9630,September 1991,Tennessee,3834497,2418786,63.1,2255345,58.8,163441,6.8
9631,September 1991,Texas,12855628,8803796,68.5,8189899,63.7,613897,7.0
9632,September 1991,Utah,1211417,859093,70.9,817891,67.5,41202,4.8
9633,September 1991,Vermont,432512,303466,70.2,284491,65.8,18975,6.3
9634,September 1991,Virginia,4726681,3357796,71.0,3160829,66.9,196967,5.9
9635,September 1991,Washington,3783107,2552326,67.5,2386122,63.1,166204,6.5
9636,September 1991,West Virginia,1410406,779885,55.3,693973,49.2,85912,11.0
9637,September 1991,Wisconsin,3730565,2627506,70.4,2486792,66.7,140714,5.4
9638,September 1991,Wyoming,334451,235846,70.5,223322,66.8,12524,5.3
9639,October 1991,Alabama,3126646,1927603,61.7,1787974,57.2,139629,7.2
9640,October 1991,Alaska,385810,278852,72.3,253658,65.7,25194,9.0
9641,October 1991,Arizona,2882243,1824992,63.3,1701785,59.0,123207,6.8
9642,October 1991,Arkansas,1809059,1133945,62.7,1050380,58.1,83565,7.4
9643,October 1991,California,22861014,15150562,66.3,13945443,61.0,1205119,8.0
9644,October 1991,Colorado,2563505,1803233,70.3,1704480,66.5,98753,5.5
9645,October 1991,Connecticut,2568188,1845444,71.9,1712054,66.7,133390,7.2
9646,October 1991,Delaware,523673,361145,69.0,340588,65.0,20557,5.7
9647,October 1991,District of Columbia,478043,321071,67.2,294229,61.5,26842,8.4
9648,October 1991,Florida,10555815,6557473,62.1,6041455,57.2,516018,7.9
9649,October 1991,Georgia,5009239,3273416,65.3,3117974,62.2,155442,4.7
9650,October 1991,Hawaii,830886,575201,69.2,557592,67.1,17609,3.1
9651,October 1991,Idaho,759003,514293,67.8,482365,63.6,31928,6.2
9652,October 1991,Illinois,8791476,5956223,67.7,5485884,62.4,470339,7.9
9653,October 1991,Indiana,4257483,2787084,65.5,2628130,61.7,158954,5.7
9654,October 1991,Iowa,2110218,1484899,70.4,1416203,67.1,68696,4.6
9655,October 1991,Kansas,1839260,1282074,69.7,1228720,66.8,53354,4.2
9656,October 1991,Kentucky,2836095,1763984,62.2,1635962,57.7,128022,7.3
9657,October 1991,Louisiana,3102468,1916297,61.8,1777174,57.3,139123,7.3
9658,October 1991,Maine,944490,641663,67.9,595913,63.1,45750,7.1
9659,October 1991,Maryland,3728143,2624462,70.4,2459869,66.0,164593,6.3
9660,October 1991,Massachusetts,4690781,3191275,68.0,2910521,62.0,280754,8.8
9661,October 1991,Michigan,7092395,4602280,64.9,4181176,59.0,421104,9.1
9662,October 1991,Minnesota,3320071,2434004,73.3,2310149,69.6,123855,5.1
9663,October 1991,Mississippi,1919242,1174052,61.2,1079000,56.2,95052,8.1
9664,October 1991,Missouri,3901794,2645072,67.8,2480606,63.6,164466,6.2
9665,October 1991,Montana,605258,409752,67.7,381444,63.0,28308,6.9
9666,October 1991,Nebraska,1178363,839460,71.2,816156,69.3,23304,2.8
9667,October 1991,Nevada,1015363,710115,69.9,667598,65.7,42517,6.0
9668,October 1991,New Hampshire,848106,613103,72.3,568006,67.0,45097,7.4
9669,October 1991,New Jersey,6082921,4065372,66.8,3782710,62.2,282662,7.0
9670,October 1991,New Mexico,1146669,730341,63.7,677673,59.1,52668,7.2
9671,October 1991,New York,14105779,8708582,61.7,8050294,57.1,658288,7.6
9672,October 1991,North Carolina,5218716,3560896,68.2,3351661,64.2,209235,5.9
9673,October 1991,North Dakota,464584,314433,67.7,300513,64.7,13920,4.4
9674,October 1991,Ohio,8313446,5435266,65.4,5090444,61.2,344822,6.3
9675,October 1991,Oklahoma,2371153,1507001,63.6,1412548,59.6,94453,6.3
9676,October 1991,Oregon,2259951,1524831,67.5,1420548,62.9,104283,6.8
9677,October 1991,Pennsylvania,9269420,5859867,63.2,5439229,58.7,420638,7.2
9678,October 1991,Rhode Island,779742,515503,66.1,470242,60.3,45261,8.8
9679,October 1991,South Carolina,2676515,1766644,66.0,1652737,61.7,113907,6.4
9680,October 1991,South Dakota,506954,351412,69.3,339304,66.9,12108,3.4
9681,October 1991,Tennessee,3839092,2421082,63.1,2256975,58.8,164107,6.8
9682,October 1991,Texas,12876230,8825539,68.5,8198148,63.7,627391,7.1
9683,October 1991,Utah,1215865,861865,70.9,820256,67.5,41609,4.8
9684,October 1991,Vermont,433536,303535,70.0,284730,65.7,18805,6.2
9685,October 1991,Virginia,4733808,3367041,71.1,3165527,66.9,201514,6.0
9686,October 1991,Washington,3791350,2558571,67.5,2388800,63.0,169771,6.6
9687,October 1991,West Virginia,1411283,780738,55.3,693344,49.1,87394,11.2
9688,October 1991,Wisconsin,3735021,2632409,70.5,2491421,66.7,140988,5.4
9689,October 1991,Wyoming,335473,236024,70.4,223222,66.5,12802,5.4
9690,November 1991,Alabama,3129448,1932167,61.7,1790427,57.2,141740,7.3
9691,November 1991,Alaska,386802,280073,72.4,254388,65.8,25685,9.2
9692,November 1991,Arizona,2891027,1832314,63.4,1703230,58.9,129084,7.0
9693,November 1991,Arkansas,1811471,1137999,62.8,1053719,58.2,84280,7.4
9694,November 1991,California,22887105,15169840,66.3,13937417,60.9,1232423,8.1
9695,November 1991,Colorado,2570483,1805848,70.3,1705244,66.3,100604,5.6
9696,November 1991,Connecticut,2567651,1843984,71.8,1708558,66.5,135426,7.3
9697,November 1991,Delaware,523750,361823,69.1,341422,65.2,20401,5.6
9698,November 1991,District of Columbia,477409,321186,67.3,293988,61.6,27198,8.5
9699,November 1991,Florida,10572170,6568219,62.1,6039676,57.1,528543,8.0
9700,November 1991,Georgia,5018250,3278130,65.3,3120691,62.2,157439,4.8
9701,November 1991,Hawaii,832017,576027,69.2,557699,67.0,18328,3.2
9702,November 1991,Idaho,761003,515947,67.8,483640,63.6,32307,6.3
9703,November 1991,Illinois,8797725,5969882,67.9,5482821,62.3,487061,8.2
9704,November 1991,Indiana,4261050,2791360,65.5,2629396,61.7,161964,5.8
9705,November 1991,Iowa,2111546,1489356,70.5,1419692,67.2,69664,4.7
9706,November 1991,Kansas,1842272,1283983,69.7,1230741,66.8,53242,4.1
9707,November 1991,Kentucky,2838145,1764513,62.2,1637211,57.7,127302,7.2
9708,November 1991,Louisiana,3104490,1917800,61.8,1777083,57.2,140717,7.3
9709,November 1991,Maine,944467,642494,68.0,595865,63.1,46629,7.3
9710,November 1991,Maryland,3729967,2630611,70.5,2460564,66.0,170047,6.5
9711,November 1991,Massachusetts,4690772,3187489,68.0,2908712,62.0,278777,8.7
9712,November 1991,Michigan,7097095,4615956,65.0,4189290,59.0,426666,9.2
9713,November 1991,Minnesota,3322756,2436144,73.3,2312146,69.6,123998,5.1
9714,November 1991,Mississippi,1920343,1172740,61.1,1078430,56.2,94310,8.0
9715,November 1991,Missouri,3904376,2643769,67.7,2480588,63.5,163181,6.2
9716,November 1991,Montana,606224,411233,67.8,382657,63.1,28576,6.9
9717,November 1991,Nebraska,1179606,839881,71.2,816322,69.2,23559,2.8
9718,November 1991,Nevada,1019289,712547,69.9,668752,65.6,43795,6.1
9719,November 1991,New Hampshire,848202,612891,72.3,568024,67.0,44867,7.3
9720,November 1991,New Jersey,6085099,4069566,66.9,3777597,62.1,291969,7.2
9721,November 1991,New Mexico,1148881,731516,63.7,678374,59.0,53142,7.3
9722,November 1991,New York,14106860,8705941,61.7,8031299,56.9,674642,7.7
9723,November 1991,North Carolina,5225203,3563158,68.2,3351761,64.1,211397,5.9
9724,November 1991,North Dakota,464656,314524,67.7,300372,64.6,14152,4.5
9725,November 1991,Ohio,8317376,5444391,65.5,5090231,61.2,354160,6.5
9726,November 1991,Oklahoma,2373342,1507842,63.5,1412834,59.5,95008,6.3
9727,November 1991,Oregon,2263221,1528283,67.5,1420212,62.8,108071,7.1
9728,November 1991,Pennsylvania,9271030,5869122,63.3,5440169,58.7,428953,7.3
9729,November 1991,Rhode Island,780230,516519,66.2,470727,60.3,45792,8.9
9730,November 1991,South Carolina,2679493,1771198,66.1,1654589,61.8,116609,6.6
9731,November 1991,South Dakota,507043,352018,69.4,339995,67.1,12023,3.4
9732,November 1991,Tennessee,3843687,2423313,63.0,2258438,58.8,164875,6.8
9733,November 1991,Texas,12895831,8848136,68.6,8205370,63.6,642766,7.3
9734,November 1991,Utah,1220314,864750,70.9,822673,67.4,42077,4.9
9735,November 1991,Vermont,433561,303768,70.1,284847,65.7,18921,6.2
9736,November 1991,Virginia,4738936,3375860,71.2,3168316,66.9,207544,6.1
9737,November 1991,Washington,3799594,2566613,67.5,2392944,63.0,173669,6.8
9738,November 1991,West Virginia,1412159,781266,55.3,692491,49.0,88775,11.4
9739,November 1991,Wisconsin,3739476,2636677,70.5,2496037,66.7,140640,5.3
9740,November 1991,Wyoming,335494,236286,70.4,223196,66.5,13090,5.5
9741,December 1991,Alabama,3132250,1937011,61.8,1792940,57.2,144071,7.4
9742,December 1991,Alaska,387793,281397,72.6,255320,65.8,26077,9.3
9743,December 1991,Arizona,2898811,1839227,63.4,1704649,58.8,134578,7.3
9744,December 1991,Arkansas,1812883,1142281,63.0,1057377,58.3,84904,7.4
9745,December 1991,California,22910197,15188594,66.3,13925992,60.8,1262602,8.3
9746,December 1991,Colorado,2576460,1809074,70.2,1706642,66.2,102432,5.7
9747,December 1991,Connecticut,2566114,1841748,71.8,1704867,66.4,136881,7.4
9748,December 1991,Delaware,524826,362482,69.1,342189,65.2,20293,5.6
9749,December 1991,District of Columbia,476775,321434,67.4,293982,61.7,27452,8.5
9750,December 1991,Florida,10587525,6580212,62.2,6039035,57.0,541177,8.2
9751,December 1991,Georgia,5026261,3283291,65.3,3123781,62.1,159510,4.9
9752,December 1991,Hawaii,833148,576900,69.2,557752,66.9,19148,3.3
9753,December 1991,Idaho,763003,517722,67.9,485064,63.6,32658,6.3
9754,December 1991,Illinois,8802974,5982596,68.0,5482949,62.3,499647,8.4
9755,December 1991,Indiana,4264617,2797631,65.6,2631369,61.7,166262,5.9
9756,December 1991,Iowa,2113874,1493017,70.6,1422736,67.3,70281,4.7
9757,December 1991,Kansas,1844284,1286481,69.8,1233056,66.9,53425,4.2
9758,December 1991,Kentucky,2840195,1764621,62.1,1638671,57.7,125950,7.1
9759,December 1991,Louisiana,3106511,1919060,61.8,1776073,57.2,142987,7.5
9760,December 1991,Maine,944444,643570,68.1,595894,63.1,47676,7.4
9761,December 1991,Maryland,3731792,2636887,70.7,2461162,66.0,175725,6.7
9762,December 1991,Massachusetts,4689762,3183549,67.9,2906892,62.0,276657,8.7
9763,December 1991,Michigan,7100794,4628745,65.2,4197030,59.1,431715,9.3
9764,December 1991,Minnesota,3325441,2438527,73.3,2314592,69.6,123935,5.1
9765,December 1991,Mississippi,1921445,1172662,61.0,1078280,56.1,94382,8.0
9766,December 1991,Missouri,3905957,2642613,67.7,2480140,63.5,162473,6.1
9767,December 1991,Montana,606190,412577,68.1,383908,63.3,28669,6.9
9768,December 1991,Nebraska,1180850,840331,71.2,816599,69.2,23732,2.8
9769,December 1991,Nevada,1022215,715131,70.0,670089,65.6,45042,6.3
9770,December 1991,New Hampshire,848297,612699,72.2,568003,67.0,44696,7.3
9771,December 1991,New Jersey,6086278,4073964,66.9,3772921,62.0,301043,7.4
9772,December 1991,New Mexico,1151094,732662,63.6,679090,59.0,53572,7.3
9773,December 1991,New York,14106941,8706137,61.7,8013353,56.8,692784,8.0
9774,December 1991,North Carolina,5229690,3564455,68.2,3350574,64.1,213881,6.0
9775,December 1991,North Dakota,464728,314650,67.7,300221,64.6,14429,4.6
9776,December 1991,Ohio,8319305,5455521,65.6,5089390,61.2,366131,6.7
9777,December 1991,Oklahoma,2375531,1508802,63.5,1413231,59.5,95571,6.3
9778,December 1991,Oregon,2266492,1532161,67.6,1420556,62.7,111605,7.3
9779,December 1991,Pennsylvania,9272640,5877467,63.4,5440410,58.7,437057,7.4
9780,December 1991,Rhode Island,779718,518292,66.5,471919,60.5,46373,8.9
9781,December 1991,South Carolina,2681471,1775277,66.2,1656502,61.8,118775,6.7
9782,December 1991,South Dakota,508132,352673,69.4,340754,67.1,11919,3.4
9783,December 1991,Tennessee,3847282,2425307,63.0,2260219,58.7,165088,6.8
9784,December 1991,Texas,12912432,8869946,68.7,8212912,63.6,657034,7.4
9785,December 1991,Utah,1223762,867831,70.9,825270,67.4,42561,4.9
9786,December 1991,Vermont,433585,304138,70.1,284931,65.7,19207,6.3
9787,December 1991,Virginia,4744064,3383643,71.3,3169906,66.8,213737,6.3
9788,December 1991,Washington,3806837,2576057,67.7,2398702,63.0,177355,6.9
9789,December 1991,West Virginia,1412036,781389,55.3,691578,49.0,89811,11.5
9790,December 1991,Wisconsin,3741932,2640390,70.6,2501213,66.8,139177,5.3
9791,December 1991,Wyoming,336515,236620,70.3,223295,66.4,13325,5.6
9792,January 1992,Alabama,3134052,1942026,62.0,1795831,57.3,146195,7.5
9793,January 1992,Alaska,388784,282706,72.7,256376,65.9,26330,9.3
9794,January 1992,Arizona,2906595,1845636,63.5,1706570,58.7,139066,7.5
9795,January 1992,Arkansas,1814294,1146490,63.2,1061269,58.5,85221,7.4
9796,January 1992,California,22934288,15207298,66.3,13915017,60.7,1292281,8.5
9797,January 1992,Colorado,2582438,1813198,70.2,1708966,66.2,104232,5.7
9798,January 1992,Connecticut,2564577,1838832,71.7,1701204,66.3,137628,7.5
9799,January 1992,Delaware,524902,363110,69.2,342851,65.3,20259,5.6
9800,January 1992,District of Columbia,476140,321670,67.6,294096,61.8,27574,8.6
9801,January 1992,Florida,10602880,6592991,62.2,6041801,57.0,551190,8.4
9802,January 1992,Georgia,5035272,3287794,65.3,3127792,62.1,160002,4.9
9803,January 1992,Hawaii,834279,577900,69.3,557793,66.9,20107,3.5
9804,January 1992,Idaho,764003,519702,68.0,486778,63.7,32924,6.3
9805,January 1992,Illinois,8808223,5993989,68.0,5487199,62.3,506790,8.5
9806,January 1992,Indiana,4268185,2805908,65.7,2634698,61.7,171210,6.1
9807,January 1992,Iowa,2115203,1495611,70.7,1425269,67.4,70342,4.7
9808,January 1992,Kansas,1846295,1289686,69.9,1235779,66.9,53907,4.2
9809,January 1992,Kentucky,2842245,1764695,62.1,1640598,57.7,124097,7.0
9810,January 1992,Louisiana,3108532,1920456,61.8,1774827,57.1,145629,7.6
9811,January 1992,Maine,944421,644653,68.3,596109,63.1,48544,7.5
9812,January 1992,Maryland,3733617,2642587,70.8,2462042,65.9,180545,6.8
9813,January 1992,Massachusetts,4688752,3180284,67.8,2905549,62.0,274735,8.6
9814,January 1992,Michigan,7105494,4639519,65.3,4204786,59.2,434733,9.4
9815,January 1992,Minnesota,3328126,2441497,73.4,2317774,69.6,123723,5.1
9816,January 1992,Mississippi,1922547,1173783,61.1,1078887,56.1,94896,8.1
9817,January 1992,Missouri,3907539,2642661,67.6,2480350,63.5,162311,6.1
9818,January 1992,Montana,607157,413857,68.2,385237,63.4,28620,6.9
9819,January 1992,Nebraska,1182094,841027,71.1,817204,69.1,23823,2.8
9820,January 1992,Nevada,1026140,717774,69.9,671700,65.5,46074,6.4
9821,January 1992,New Hampshire,848393,612783,72.2,568073,67.0,44710,7.3
9822,January 1992,New Jersey,6087456,4078455,67.0,3769153,61.9,309302,7.6
9823,January 1992,New Mexico,1152306,733928,63.7,680037,59.0,53891,7.3
9824,January 1992,New York,14107022,8708926,61.7,7999171,56.7,709755,8.1
9825,January 1992,North Carolina,5235177,3566075,68.1,3350111,64.0,215964,6.1
9826,January 1992,North Dakota,464800,314801,67.7,300108,64.6,14693,4.7
9827,January 1992,Ohio,8322234,5468594,65.7,5089489,61.2,379105,6.9
9828,January 1992,Oklahoma,2377720,1509930,63.5,1414071,59.5,95859,6.3
9829,January 1992,Oregon,2270762,1536128,67.6,1421809,62.6,114319,7.4
9830,January 1992,Pennsylvania,9273250,5884244,63.5,5440959,58.7,443285,7.5
9831,January 1992,Rhode Island,779207,520583,66.8,473672,60.8,46911,9.0
9832,January 1992,South Carolina,2684449,1778423,66.2,1658374,61.8,120049,6.8
9833,January 1992,South Dakota,508221,353373,69.5,341541,67.2,11832,3.3
9834,January 1992,Tennessee,3851877,2427708,63.0,2263201,58.8,164507,6.8
9835,January 1992,Texas,12930034,8891705,68.8,8222987,63.6,668718,7.5
9836,January 1992,Utah,1228211,871120,70.9,828107,67.4,43013,4.9
9837,January 1992,Vermont,433609,304599,70.2,285080,65.7,19519,6.4
9838,January 1992,Virginia,4749191,3390464,71.4,3171579,66.8,218885,6.5
9839,January 1992,Washington,3815080,2586539,67.8,2406048,63.1,180491,7.0
9840,January 1992,West Virginia,1412912,781150,55.3,690813,48.9,90337,11.6
9841,January 1992,Wisconsin,3745387,2644491,70.6,2507563,67.0,136928,5.2
9842,January 1992,Wyoming,336537,237022,70.4,223529,66.4,13493,5.7
9843,February 1992,Alabama,3136854,1947271,62.1,1799138,57.4,148133,7.6
9844,February 1992,Alaska,389776,283890,72.8,257459,66.1,26431,9.3
9845,February 1992,Arizona,2914379,1851661,63.5,1709307,58.7,142354,7.7
9846,February 1992,Arkansas,1815706,1150345,63.4,1065157,58.7,85188,7.4
9847,February 1992,California,22954380,15228215,66.3,13907091,60.6,1321124,8.7
9848,February 1992,Colorado,2588415,1818204,70.2,1712185,66.1,106019,5.8
9849,February 1992,Connecticut,2563040,1835691,71.6,1697818,66.2,137873,7.5
9850,February 1992,Delaware,525978,363738,69.2,343424,65.3,20314,5.6
9851,February 1992,District of Columbia,475506,321705,67.7,294149,61.9,27556,8.6
9852,February 1992,Florida,10616236,6606363,62.2,6048784,57.0,557579,8.4
9853,February 1992,Georgia,5043283,3362566,66.7,3132895,62.1,229671,6.8
9854,February 1992,Hawaii,835410,579008,69.3,557825,66.8,21183,3.7
9855,February 1992,Idaho,766003,521912,68.1,488830,63.8,33082,6.3
9856,February 1992,Illinois,8813472,6004398,68.1,5495382,62.4,509016,8.5
9857,February 1992,Indiana,4270752,2816632,66.0,2639844,61.8,176788,6.3
9858,February 1992,Iowa,2116531,1497375,70.7,1427429,67.4,69946,4.7
9859,February 1992,Kansas,1848307,1293440,70.0,1238743,67.0,54697,4.2
9860,February 1992,Kentucky,2844294,1765410,62.1,1643121,57.8,122289,6.9
9861,February 1992,Louisiana,3109554,1922436,61.8,1773785,57.0,148651,7.7
9862,February 1992,Maine,944398,645530,68.4,596565,63.2,48965,7.6
9863,February 1992,Maryland,3734441,2647421,70.9,2463476,66.0,183945,6.9
9864,February 1992,Massachusetts,4686742,3178323,67.8,2904821,62.0,273502,8.6
9865,February 1992,Michigan,7108194,4649041,65.4,4212926,59.3,436115,9.4
9866,February 1992,Minnesota,3329812,2445395,73.4,2321748,69.7,123647,5.1
9867,February 1992,Mississippi,1922649,1176083,61.2,1080350,56.2,95733,8.1
9868,February 1992,Missouri,3909120,2644853,67.7,2481737,63.5,163116,6.2
9869,February 1992,Montana,608123,415117,68.3,386626,63.6,28491,6.9
9870,February 1992,Nebraska,1182338,842089,71.2,818180,69.2,23909,2.8
9871,February 1992,Nevada,1030066,720378,69.9,673546,65.4,46832,6.5
9872,February 1992,New Hampshire,848489,613244,72.3,568333,67.0,44911,7.3
9873,February 1992,New Jersey,6087634,4083864,67.1,3766342,61.9,317522,7.8
9874,February 1992,New Mexico,1154518,735389,63.7,681318,59.0,54071,7.4
9875,February 1992,New York,14105103,8714912,61.8,7990052,56.6,724860,8.3
9876,February 1992,North Carolina,5240664,3569378,68.1,3351924,64.0,217454,6.1
9877,February 1992,North Dakota,464872,314955,67.8,300052,64.5,14903,4.7
9878,February 1992,Ohio,8324164,5482535,65.9,5091088,61.2,391447,7.1
9879,February 1992,Oklahoma,2378909,1511287,63.5,1415462,59.5,95825,6.3
9880,February 1992,Oregon,2274033,1539913,67.7,1423980,62.6,115933,7.5
9881,February 1992,Pennsylvania,9272860,5890170,63.5,5442747,58.7,447423,7.6
9882,February 1992,Rhode Island,779695,523042,67.1,475704,61.0,47338,9.1
9883,February 1992,South Carolina,2686427,1780673,66.3,1660139,61.8,120534,6.8
9884,February 1992,South Dakota,508310,354050,69.7,342267,67.3,11783,3.3
9885,February 1992,Tennessee,3854472,2431013,63.1,2267763,58.8,163250,6.7
9886,February 1992,Texas,12945635,8914515,68.9,8236370,63.6,678145,7.6
9887,February 1992,Utah,1231659,874447,71.0,831108,67.5,43339,5.0
9888,February 1992,Vermont,433634,305040,70.3,285360,65.8,19680,6.5
9889,February 1992,Virginia,4753319,3396406,71.5,3174101,66.8,222305,6.5
9890,February 1992,Washington,3821323,2597502,68.0,2414386,63.2,183116,7.0
9891,February 1992,West Virginia,1412789,780613,55.3,690275,48.9,90338,11.6
9892,February 1992,Wisconsin,3748843,2650113,70.7,2515117,67.1,134996,5.1
9893,February 1992,Wyoming,337558,237465,70.3,223859,66.3,13606,5.7
9894,March 1992,Alabama,3139656,1953008,62.2,1803125,57.4,149883,7.7
9895,March 1992,Alaska,390767,284916,72.9,258515,66.2,26401,9.3
9896,March 1992,Arizona,2923162,1857883,63.6,1713519,58.6,144364,7.8
9897,March 1992,Arkansas,1817118,1153656,63.5,1068834,58.8,84822,7.4
9898,March 1992,California,22978471,15254202,66.4,13905274,60.5,1348928,8.8
9899,March 1992,Colorado,2594393,1824185,70.3,1716425,66.2,107760,5.9
9900,March 1992,Connecticut,2561503,1833116,71.6,1695207,66.2,137909,7.5
9901,March 1992,Delaware,526054,364413,69.3,344002,65.4,20411,5.6
9902,March 1992,District of Columbia,474871,321415,67.7,294002,61.9,27413,8.5
9903,March 1992,Florida,10631591,6621640,62.3,6061140,57.0,560500,8.5
9904,March 1992,Georgia,5052294,3387960,67.1,3139692,62.1,248268,7.3
9905,March 1992,Hawaii,836541,580269,69.4,557893,66.7,22376,3.9
9906,March 1992,Idaho,768003,524379,68.3,491204,64.0,33175,6.3
9907,March 1992,Illinois,8818721,6015227,68.2,5507752,62.5,507475,8.4
9908,March 1992,Indiana,4274319,2830253,66.2,2647326,61.9,182927,6.5
9909,March 1992,Iowa,2117859,1499064,70.8,1429791,67.5,69273,4.6
9910,March 1992,Kansas,1850319,1297603,70.1,1241892,67.1,55711,4.3
9911,March 1992,Kentucky,2846344,1767302,62.1,1646303,57.8,120999,6.8
9912,March 1992,Louisiana,3111575,1925381,61.9,1773512,57.0,151869,7.9
9913,March 1992,Maine,944374,646117,68.4,597291,63.2,48826,7.6
9914,March 1992,Maryland,3736266,2651315,71.0,2465767,66.0,185548,7.0
9915,March 1992,Massachusetts,4685732,3178222,67.8,2905170,62.0,273052,8.6
9916,March 1992,Michigan,7111894,4659477,65.5,4222667,59.4,436810,9.4
9917,March 1992,Minnesota,3332497,2450471,73.5,2326458,69.8,124013,5.1
9918,March 1992,Mississippi,1923751,1179687,61.3,1082858,56.3,96829,8.2
9919,March 1992,Missouri,3910702,2649854,67.8,2485072,63.5,164782,6.2
9920,March 1992,Montana,609089,416270,68.3,387916,63.7,28354,6.8
9921,March 1992,Nebraska,1183581,843397,71.3,819371,69.2,24026,2.8
9922,March 1992,Nevada,1032992,722940,70.0,675583,65.4,47357,6.6
9923,March 1992,New Hampshire,848585,613931,72.3,568730,67.0,45201,7.4
9924,March 1992,New Jersey,6088812,4091322,67.2,3764952,61.8,326370,8.0
9925,March 1992,New Mexico,1156730,736885,63.7,682833,59.0,54052,7.3
9926,March 1992,New York,14105184,8725365,61.9,7987568,56.6,737797,8.5
9927,March 1992,North Carolina,5245151,3575703,68.2,3357304,64.0,218399,6.1
9928,March 1992,North Dakota,464944,315121,67.8,300080,64.5,15041,4.8
9929,March 1992,Ohio,8327093,5496615,66.0,5094679,61.2,401936,7.3
9930,March 1992,Oklahoma,2381097,1512959,63.5,1417639,59.5,95320,6.3
9931,March 1992,Oregon,2277303,1543556,67.8,1427133,62.7,116423,7.5
9932,March 1992,Pennsylvania,9273470,5897111,63.6,5447055,58.7,450056,7.6
9933,March 1992,Rhode Island,779183,525249,67.4,477652,61.3,47597,9.1
9934,March 1992,South Carolina,2688405,1782371,66.3,1661945,61.8,120426,6.8
9935,March 1992,South Dakota,509398,354666,69.6,342880,67.3,11786,3.3
9936,March 1992,Tennessee,3859067,2435944,63.1,2274345,58.9,161599,6.6
9937,March 1992,Texas,12963237,8939715,69.0,8254338,63.7,685377,7.7
9938,March 1992,Utah,1235107,877691,71.1,834201,67.5,43490,5.0
9939,March 1992,Vermont,433658,305442,70.4,285802,65.9,19640,6.4
9940,March 1992,Virginia,4758446,3402217,71.5,3178530,66.8,223687,6.6
9941,March 1992,Washington,3829566,2608712,68.1,2423298,63.3,185414,7.1
9942,March 1992,West Virginia,1413665,779953,55.2,690098,48.8,89855,11.5
9943,March 1992,Wisconsin,3752298,2658266,70.8,2523853,67.3,134413,5.1
9944,March 1992,Wyoming,337580,237906,70.5,224242,66.4,13664,5.7
9945,April 1992,Alabama,3142458,1958967,62.3,1807692,57.5,151275,7.7
9946,April 1992,Alaska,391759,285818,73.0,259535,66.2,26283,9.2
9947,April 1992,Arizona,2930946,1864526,63.6,1719398,58.7,145128,7.8
9948,April 1992,Arkansas,1818530,1156154,63.6,1071888,58.9,84266,7.3
9949,April 1992,California,23004563,15284995,66.4,13908347,60.5,1376648,9.0
9950,April 1992,Colorado,2601370,1830759,70.4,1721352,66.2,109407,6.0
9951,April 1992,Connecticut,2559966,1831446,71.5,1693531,66.2,137915,7.5
9952,April 1992,Delaware,527130,365150,69.3,344679,65.4,20471,5.6
9953,April 1992,District of Columbia,474237,320677,67.6,293484,61.9,27193,8.5
9954,April 1992,Florida,10646946,6639323,62.4,6077805,57.1,561518,8.5
9955,April 1992,Georgia,5061304,3399433,67.2,3147902,62.2,251531,7.4
9956,April 1992,Hawaii,837672,581565,69.4,558055,66.6,23510,4.0
9957,April 1992,Idaho,770004,527002,68.4,493683,64.1,33319,6.3
9958,April 1992,Illinois,8824970,6027228,68.3,5523487,62.6,503741,8.4
9959,April 1992,Indiana,4277887,2845809,66.5,2656399,62.1,189410,6.7
9960,April 1992,Iowa,2120187,1501264,70.8,1432773,67.6,68491,4.6
9961,April 1992,Kansas,1852331,1302110,70.3,1245173,67.2,56937,4.4
9962,April 1992,Kentucky,2848394,1770471,62.2,1649934,57.9,120537,6.8
9963,April 1992,Louisiana,3113596,1929005,62.0,1773814,57.0,155191,8.0
9964,April 1992,Maine,944351,646380,68.4,598190,63.3,48190,7.5
9965,April 1992,Maryland,3738091,2654030,71.0,2468619,66.0,185411,7.0
9966,April 1992,Massachusetts,4684722,3179921,67.9,2906657,62.0,273264,8.6
9967,April 1992,Michigan,7116593,4671340,65.6,4234185,59.5,437155,9.4
9968,April 1992,Minnesota,3336182,2456583,73.6,2331564,69.9,125019,5.1
9969,April 1992,Mississippi,1924853,1184296,61.5,1086225,56.4,98071,8.3
9970,April 1992,Missouri,3913284,2656498,67.9,2489768,63.6,166730,6.3
9971,April 1992,Montana,610056,417179,68.4,388900,63.7,28279,6.8
9972,April 1992,Nebraska,1184825,844767,71.3,820559,69.3,24208,2.9
9973,April 1992,Nevada,1036917,725498,70.0,677727,65.4,47771,6.6
9974,April 1992,New Hampshire,848680,614522,72.4,569053,67.1,45469,7.4
9975,April 1992,New Jersey,6090991,4100677,67.3,3764874,61.8,335803,8.2
9976,April 1992,New Mexico,1158943,738267,63.7,684401,59.1,53866,7.3
9977,April 1992,New York,14106265,8740047,62.0,7990891,56.6,749156,8.6
9978,April 1992,North Carolina,5251638,3585270,68.3,3366065,64.1,219205,6.1
9979,April 1992,North Dakota,465016,315269,67.8,300164,64.5,15105,4.8
9980,April 1992,Ohio,8331023,5509331,66.1,5099255,61.2,410076,7.4
9981,April 1992,Oklahoma,2383286,1514916,63.6,1420450,59.6,94466,6.2
9982,April 1992,Oregon,2281574,1547146,67.8,1431040,62.7,116106,7.5
9983,April 1992,Pennsylvania,9276080,5905561,63.7,5453430,58.8,452131,7.7
9984,April 1992,Rhode Island,779671,526868,67.6,479177,61.5,47691,9.1
9985,April 1992,South Carolina,2691383,1783843,66.3,1663869,61.8,119974,6.7
9986,April 1992,South Dakota,509487,355251,69.7,343415,67.4,11836,3.3
9987,April 1992,Tennessee,3863662,2442463,63.2,2282538,59.1,159925,6.5
9988,April 1992,Texas,12981838,8966875,69.1,8276182,63.8,690693,7.7
9989,April 1992,Utah,1239556,880748,71.1,837278,67.5,43470,4.9
9990,April 1992,Vermont,433682,305858,70.5,286415,66.0,19443,6.4
9991,April 1992,Virginia,4764574,3407609,71.5,3184485,66.8,223124,6.5
9992,April 1992,Washington,3836810,2619747,68.3,2432194,63.4,187553,7.2
9993,April 1992,West Virginia,1413542,779330,55.1,690234,48.8,89096,11.4
9994,April 1992,Wisconsin,3755754,2668924,71.1,2533273,67.5,135651,5.1
9995,April 1992,Wyoming,338601,238310,70.4,224632,66.3,13678,5.7
9996,May 1992,Alabama,3145260,1964155,62.4,1812223,57.6,151932,7.7
9997,May 1992,Alaska,393750,286605,72.8,260486,66.2,26119,9.1
9998,May 1992,Arizona,2939730,1870787,63.6,1726031,58.7,144756,7.7
9999,May 1992,Arkansas,1819941,1157557,63.6,1073913,59.0,83644,7.2
10000,May 1992,California,23029654,15313616,66.5,13910133,60.4,1403483,9.2
10001,May 1992,Colorado,2607348,1837040,70.5,1726257,66.2,110783,6.0
10002,May 1992,Connecticut,2558429,1830240,71.5,1692349,66.1,137891,7.5
10003,May 1992,Delaware,527206,365931,69.4,345450,65.5,20481,5.6
10004,May 1992,District of Columbia,473603,319523,67.5,292554,61.8,26969,8.4
10005,May 1992,Florida,10663301,6656141,62.4,6094738,57.2,561403,8.4
10006,May 1992,Georgia,5070315,3406338,67.2,3156034,62.2,250304,7.3
10007,May 1992,Hawaii,838804,582787,69.5,558318,66.6,24469,4.2
10008,May 1992,Idaho,772004,529576,68.6,495972,64.2,33604,6.3
10009,May 1992,Illinois,8831219,6037456,68.4,5539780,62.7,497676,8.2
10010,May 1992,Indiana,4281454,2860306,66.8,2665223,62.3,195083,6.8
10011,May 1992,Iowa,2121515,1504171,70.9,1436296,67.7,67875,4.5
10012,May 1992,Kansas,1854343,1306451,70.5,1248219,67.3,58232,4.5
10013,May 1992,Kentucky,2850444,1774370,62.2,1653470,58.0,120900,6.8
10014,May 1992,Louisiana,3115618,1931754,62.0,1773574,56.9,158180,8.2
10015,May 1992,Maine,944328,646336,68.4,599034,63.4,47302,7.3
10016,May 1992,Maryland,3739915,2655281,71.0,2471246,66.1,184035,6.9
10017,May 1992,Massachusetts,4683712,3182119,67.9,2908477,62.1,273642,8.6
10018,May 1992,Michigan,7121293,4682300,65.8,4245628,59.6,436672,9.3
10019,May 1992,Minnesota,3338867,2462891,73.8,2336586,70.0,126305,5.1
10020,May 1992,Mississippi,1925955,1189030,61.7,1089826,56.6,99204,8.3
10021,May 1992,Missouri,3915865,2661559,68.0,2493633,63.7,167926,6.3
10022,May 1992,Montana,611022,417748,68.4,389450,63.7,28298,6.8
10023,May 1992,Nebraska,1186069,846104,71.3,821643,69.3,24461,2.9
10024,May 1992,Nevada,1040843,728008,69.9,679827,65.3,48181,6.6
10025,May 1992,New Hampshire,848776,614769,72.4,569178,67.1,45591,7.4
10026,May 1992,New Jersey,6092169,4084665,67.0,3739794,61.4,344871,8.4
10027,May 1992,New Mexico,1161155,739455,63.7,685893,59.1,53562,7.2
10028,May 1992,New York,14107346,8754894,62.1,7995743,56.7,759151,8.7
10029,May 1992,North Carolina,5257125,3596121,68.4,3376281,64.2,219840,6.1
10030,May 1992,North Dakota,466088,315370,67.7,300256,64.4,15114,4.8
10031,May 1992,Ohio,8333952,5518115,66.2,5102741,61.2,415374,7.5
10032,May 1992,Oklahoma,2385475,1516645,63.6,1423322,59.7,93323,6.2
10033,May 1992,Oregon,2284844,1550401,67.9,1435068,62.8,115333,7.4
10034,May 1992,Pennsylvania,9277690,5914128,63.7,5460048,58.9,454080,7.7
10035,May 1992,Rhode Island,779160,527792,67.7,480137,61.6,47655,9.0
10036,May 1992,South Carolina,2694361,1785226,66.3,1665769,61.8,119457,6.7
10037,May 1992,South Dakota,509576,355817,69.8,343913,67.5,11904,3.3
10038,May 1992,Tennessee,3867257,2449059,63.3,2290755,59.2,158304,6.5
10039,May 1992,Texas,13000439,8991923,69.2,8298164,63.8,693759,7.7
10040,May 1992,Utah,1244004,883536,71.0,840224,67.5,43312,4.9
10041,May 1992,Vermont,434707,306353,70.5,287186,66.1,19167,6.3
10042,May 1992,Virginia,4769702,3410804,71.5,3189808,66.9,220996,6.5
10043,May 1992,Washington,3845053,2629717,68.4,2440005,63.5,189712,7.2
10044,May 1992,West Virginia,1414418,778749,55.1,690410,48.8,88339,11.3
10045,May 1992,Wisconsin,3759209,2680621,71.3,2542218,67.6,138403,5.2
10046,May 1992,Wyoming,338623,238648,70.5,224990,66.4,13658,5.7
10047,June 1992,Alabama,3148063,1967989,62.5,1816357,57.7,151632,7.7
10048,June 1992,Alaska,394741,287278,72.8,261331,66.2,25947,9.0
10049,June 1992,Arizona,2948514,1875811,63.6,1732235,58.7,143576,7.7
10050,June 1992,Arkansas,1822353,1157872,63.5,1074850,59.0,83022,7.2
10051,June 1992,California,23055746,15334765,66.5,13906393,60.3,1428372,9.3
10052,June 1992,Colorado,2614325,1842573,70.5,1730915,66.2,111658,6.1
10053,June 1992,Connecticut,2557892,1829019,71.5,1691188,66.1,137831,7.5
10054,June 1992,Delaware,528282,366734,69.4,346301,65.6,20433,5.6
10055,June 1992,District of Columbia,473968,318093,67.1,291259,61.5,26834,8.4
10056,June 1992,Florida,10678657,6669464,62.5,6109353,57.2,560111,8.4
10057,June 1992,Georgia,5079326,3411274,67.2,3163220,62.3,248054,7.3
10058,June 1992,Hawaii,839935,584005,69.5,558660,66.5,25345,4.3
10059,June 1992,Idaho,773004,531958,68.8,497900,64.4,34058,6.4
10060,June 1992,Illinois,8837467,6043343,68.4,5555029,62.9,488314,8.1
10061,June 1992,Indiana,4286022,2870976,67.0,2672516,62.4,198460,6.9
10062,June 1992,Iowa,2123843,1507737,71.0,1440256,67.8,67481,4.5
10063,June 1992,Kansas,1856354,1310210,70.6,1250863,67.4,59347,4.5
10064,June 1992,Kentucky,2853493,1778336,62.3,1656501,58.1,121835,6.9
10065,June 1992,Louisiana,3117639,1932341,62.0,1772154,56.8,160187,8.3
10066,June 1992,Maine,945305,646104,68.3,599594,63.4,46510,7.2
10067,June 1992,Maryland,3741740,2655222,71.0,2473115,66.1,182107,6.9
10068,June 1992,Massachusetts,4683702,3183687,68.0,2910172,62.1,273515,8.6
10069,June 1992,Michigan,7125993,4690167,65.8,4255764,59.7,434403,9.3
10070,June 1992,Minnesota,3341552,2468655,73.9,2341259,70.1,127396,5.2
10071,June 1992,Mississippi,1927057,1193134,61.9,1093276,56.7,99858,8.4
10072,June 1992,Missouri,3917447,2662863,68.0,2495180,63.7,167683,6.3
10073,June 1992,Montana,611988,418053,68.3,389683,63.7,28370,6.8
10074,June 1992,Nebraska,1187313,847414,71.4,822717,69.3,24697,2.9
10075,June 1992,Nevada,1044768,730537,69.9,681918,65.3,48619,6.7
10076,June 1992,New Hampshire,848872,614622,72.4,569105,67.0,45517,7.4
10077,June 1992,New Jersey,6093347,4072202,66.8,3720229,61.1,351973,8.6
10078,June 1992,New Mexico,1163367,740636,63.7,687430,59.1,53206,7.2
10079,June 1992,New York,14108426,8766480,62.1,7999215,56.7,767265,8.8
10080,June 1992,North Carolina,5263613,3606549,68.5,3386286,64.3,220263,6.1
10081,June 1992,North Dakota,466159,315465,67.7,300365,64.4,15100,4.8
10082,June 1992,Ohio,8337881,5521744,66.2,5103893,61.2,417851,7.6
10083,June 1992,Oklahoma,2387664,1517730,63.6,1425925,59.7,91805,6.0
10084,June 1992,Oregon,2289115,1553263,67.9,1438847,62.9,114416,7.4
10085,June 1992,Pennsylvania,9279301,5921204,63.8,5465718,58.9,455486,7.7
10086,June 1992,Rhode Island,779648,528164,67.7,480643,61.6,47521,9.0
10087,June 1992,South Carolina,2697339,1786762,66.2,1667682,61.8,119080,6.7
10088,June 1992,South Dakota,510665,356396,69.8,344443,67.4,11953,3.4
10089,June 1992,Tennessee,3871852,2454996,63.4,2298011,59.4,156985,6.4
10090,June 1992,Texas,13019041,9012246,69.2,8317784,63.9,694462,7.7
10091,June 1992,Utah,1247453,886184,71.0,843074,67.6,43110,4.9
10092,June 1992,Vermont,434731,306992,70.6,288084,66.3,18908,6.2
10093,June 1992,Virginia,4775829,3411006,71.4,3193145,66.9,217861,6.4
10094,June 1992,Washington,3852296,2638291,68.5,2446263,63.5,192028,7.3
10095,June 1992,West Virginia,1415295,778264,55.0,690478,48.8,87786,11.3
10096,June 1992,Wisconsin,3763665,2691511,71.5,2550008,67.8,141503,5.3
10097,June 1992,Wyoming,339644,238937,70.3,225333,66.3,13604,5.7
10098,July 1992,Alabama,3150865,1970571,62.5,1820023,57.8,150548,7.6
10099,July 1992,Alaska,395733,287887,72.7,262116,66.2,25771,9.0
10100,July 1992,Arizona,2956297,1879588,63.6,1737416,58.8,142172,7.6
10101,July 1992,Arkansas,1823765,1157363,63.5,1075015,58.9,82348,7.1
10102,July 1992,California,23081837,15347638,66.5,13895966,60.2,1451672,9.5
10103,July 1992,Colorado,2620303,1847602,70.5,1735518,66.2,112084,6.1
10104,July 1992,Connecticut,2556355,1827495,71.5,1689649,66.1,137846,7.5
10105,July 1992,Delaware,528358,367543,69.6,347247,65.7,20296,5.5
10106,July 1992,District of Columbia,473334,316500,66.9,289664,61.2,26836,8.5
10107,July 1992,Florida,10696012,6678803,62.4,6121462,57.2,557341,8.3
10108,July 1992,Georgia,5088337,3415460,67.1,3169497,62.3,245963,7.2
10109,July 1992,Hawaii,841066,585256,69.6,559066,66.5,26190,4.5
10110,July 1992,Idaho,775004,533967,68.9,499469,64.4,34498,6.5
10111,July 1992,Illinois,8844716,6044649,68.3,5568969,63.0,475680,7.9
10112,July 1992,Indiana,4289589,2876744,67.1,2677801,62.4,198943,6.9
10113,July 1992,Iowa,2125171,1511780,71.1,1444595,68.0,67185,4.4
10114,July 1992,Kansas,1858366,1313287,70.7,1253167,67.4,60120,4.6
10115,July 1992,Kentucky,2855543,1781915,62.4,1658893,58.1,123022,6.9
10116,July 1992,Louisiana,3119660,1930475,61.9,1769590,56.7,160885,8.3
10117,July 1992,Maine,945282,645783,68.3,599728,63.4,46055,7.1
10118,July 1992,Maryland,3743565,2654370,70.9,2474070,66.1,180300,6.8
10119,July 1992,Massachusetts,4682692,3184330,68.0,2911804,62.2,272526,8.6
10120,July 1992,Michigan,7131693,4694604,65.8,4264574,59.8,430030,9.2
10121,July 1992,Minnesota,3344237,2473592,74.0,2345578,70.1,128014,5.2
10122,July 1992,Mississippi,1928159,1196220,62.0,1096494,56.9,99726,8.3
10123,July 1992,Missouri,3920028,2660334,67.9,2494157,63.6,166177,6.2
10124,July 1992,Montana,612954,418195,68.2,389817,63.6,28378,6.8
10125,July 1992,Nebraska,1188556,848634,71.4,823866,69.3,24768,2.9
10126,July 1992,Nevada,1048694,733130,69.9,684069,65.2,49061,6.7
10127,July 1992,New Hampshire,848967,614213,72.3,568965,67.0,45248,7.4
10128,July 1992,New Jersey,6095525,4061927,66.6,3705837,60.8,356090,8.8
10129,July 1992,New Mexico,1165579,742067,63.7,689154,59.1,52913,7.1
10130,July 1992,New York,14110507,8773818,62.2,8001004,56.7,772814,8.8
10131,July 1992,North Carolina,5269100,3615614,68.6,3395123,64.4,220491,6.1
10132,July 1992,North Dakota,466231,315626,67.7,300537,64.5,15089,4.8
10133,July 1992,Ohio,8341811,5520413,66.2,5102481,61.2,417932,7.6
10134,July 1992,Oklahoma,2390852,1518453,63.5,1428200,59.7,90253,5.9
10135,July 1992,Oregon,2292385,1556170,67.9,1442342,62.9,113828,7.3
10136,July 1992,Pennsylvania,9280911,5925529,63.8,5469721,58.9,455808,7.7
10137,July 1992,Rhode Island,779136,528282,67.8,480969,61.7,47313,9.0
10138,July 1992,South Carolina,2699317,1788622,66.3,1669663,61.9,118959,6.7
10139,July 1992,South Dakota,510754,357018,69.9,345070,67.6,11948,3.3
10140,July 1992,Tennessee,3876447,2460805,63.5,2304188,59.4,156617,6.4
10141,July 1992,Texas,13037642,9028300,69.2,8334457,63.9,693843,7.7
10142,July 1992,Utah,1251901,888996,71.0,846028,67.6,42968,4.8
10143,July 1992,Vermont,434755,307756,70.8,289066,66.5,18690,6.1
10144,July 1992,Virginia,4780957,3408813,71.3,3194363,66.8,214450,6.3
10145,July 1992,Washington,3860539,2645791,68.5,2451278,63.5,194513,7.4
10146,July 1992,West Virginia,1415171,778001,55.0,690474,48.8,87527,11.3
10147,July 1992,Wisconsin,3767120,2700463,71.7,2556755,67.9,143708,5.3
10148,July 1992,Wyoming,339666,239202,70.4,225694,66.4,13508,5.6
10149,August 1992,Alabama,3155667,1972213,62.5,1823128,57.8,149085,7.6
10150,August 1992,Alaska,396724,288448,72.7,262906,66.3,25542,8.9
10151,August 1992,Arizona,2967081,1882327,63.4,1741508,58.7,140819,7.5
10152,August 1992,Arkansas,1827177,1156217,63.3,1074733,58.8,81484,7.0
10153,August 1992,California,23090929,15351319,66.5,13879781,60.1,1471538,9.6
10154,August 1992,Colorado,2629280,1852686,70.5,1740392,66.2,112294,6.1
10155,August 1992,Connecticut,2556818,1825690,71.4,1687598,66.0,138092,7.6
10156,August 1992,Delaware,529434,368339,69.6,348306,65.8,20033,5.4
10157,August 1992,District of Columbia,472699,314953,66.6,287989,60.9,26964,8.6
10158,August 1992,Florida,10713367,6683343,62.4,6131325,57.2,552018,8.3
10159,August 1992,Georgia,5098348,3418719,67.1,3175043,62.3,243676,7.1
10160,August 1992,Hawaii,841197,586474,69.7,559472,66.5,27002,4.6
10161,August 1992,Idaho,778004,535494,68.8,500753,64.4,34741,6.5
10162,August 1992,Illinois,8852965,6041715,68.2,5580379,63.0,461336,7.6
10163,August 1992,Indiana,4295156,2877736,67.0,2681231,62.4,196505,6.8
10164,August 1992,Iowa,2127499,1516038,71.3,1449204,68.1,66834,4.4
10165,August 1992,Kansas,1861378,1315628,70.7,1255100,67.4,60528,4.6
10166,August 1992,Kentucky,2859593,1784828,62.4,1660872,58.1,123956,6.9
10167,August 1992,Louisiana,3121681,1926213,61.7,1766122,56.6,160091,8.3
10168,August 1992,Maine,945259,645234,68.3,599309,63.4,45925,7.1
10169,August 1992,Maryland,3745390,2653049,70.8,2474313,66.1,178736,6.7
10170,August 1992,Massachusetts,4684682,3183881,68.0,2913452,62.2,270429,8.5
10171,August 1992,Michigan,7135392,4695267,65.8,4272658,59.9,422609,9.0
10172,August 1992,Minnesota,3348922,2477628,74.0,2349573,70.2,128055,5.2
10173,August 1992,Mississippi,1930261,1198007,62.1,1099430,57.0,98577,8.2
10174,August 1992,Missouri,3924610,2654917,67.6,2491135,63.5,163782,6.2
10175,August 1992,Montana,613921,418239,68.1,389964,63.5,28275,6.8
10176,August 1992,Nebraska,1189800,849693,71.4,825030,69.3,24663,2.9
10177,August 1992,Nevada,1052620,735724,69.9,686271,65.2,49453,6.7
10178,August 1992,New Hampshire,850063,613791,72.2,568970,66.9,44821,7.3
10179,August 1992,New Jersey,6099704,4052775,66.4,3696124,60.6,356651,8.8
10180,August 1992,New Mexico,1167792,743708,63.7,690994,59.2,52714,7.1
10181,August 1992,New York,14116588,8776018,62.2,8001319,56.7,774699,8.8
10182,August 1992,North Carolina,5279587,3622322,68.6,3402121,64.4,220201,6.1
10183,August 1992,North Dakota,466303,315911,67.7,300824,64.5,15087,4.8
10184,August 1992,Ohio,8347740,5515178,66.1,5099419,61.1,415759,7.5
10185,August 1992,Oklahoma,2393041,1519107,63.5,1430082,59.8,89025,5.9
10186,August 1992,Oregon,2297656,1559155,67.9,1445346,62.9,113809,7.3
10187,August 1992,Pennsylvania,9285521,5926197,63.8,5471730,58.9,454467,7.7
10188,August 1992,Rhode Island,779624,528268,67.8,481256,61.7,47012,8.9
10189,August 1992,South Carolina,2703295,1790740,66.2,1671653,61.8,119087,6.7
10190,August 1992,South Dakota,511843,357653,69.9,345750,67.6,11903,3.3
10191,August 1992,Tennessee,3882042,2466514,63.5,2309317,59.5,157197,6.4
10192,August 1992,Texas,13061243,9040671,69.2,8348375,63.9,692296,7.7
10193,August 1992,Utah,1256349,892233,71.0,849329,67.6,42904,4.8
10194,August 1992,Vermont,434780,308566,71.0,290085,66.7,18481,6.0
10195,August 1992,Virginia,4788085,3404738,71.1,3193695,66.7,211043,6.2
10196,August 1992,Washington,3869782,2652104,68.5,2454964,63.4,197140,7.4
10197,August 1992,West Virginia,1417048,777884,54.9,690482,48.7,87402,11.2
10198,August 1992,Wisconsin,3771576,2706531,71.8,2562573,67.9,143958,5.3
10199,August 1992,Wyoming,340687,239421,70.3,226067,66.4,13354,5.6
10200,September 1992,Alabama,3159469,1973375,62.5,1825707,57.8,147668,7.5
10201,September 1992,Alaska,397715,288922,72.6,263716,66.3,25206,8.7
10202,September 1992,Arizona,2976865,1884354,63.3,1744766,58.6,139588,7.4
10203,September 1992,Arkansas,1830589,1154734,63.1,1074404,58.7,80330,7.0
10204,September 1992,California,23101020,15346155,66.4,13860329,60.0,1485826,9.7
10205,September 1992,Colorado,2637258,1858395,70.5,1745804,66.2,112591,6.1
10206,September 1992,Connecticut,2556281,1823819,71.3,1685291,65.9,138528,7.6
10207,September 1992,Delaware,530510,369117,69.6,349471,65.9,19646,5.3
10208,September 1992,District of Columbia,473065,313724,66.3,286540,60.6,27184,8.7
10209,September 1992,Florida,10731722,6682982,62.3,6139294,57.2,543688,8.1
10210,September 1992,Georgia,5109359,3420689,66.9,3180171,62.2,240518,7.0
10211,September 1992,Hawaii,842328,587501,69.7,559776,66.5,27725,4.7
10212,September 1992,Idaho,780004,536543,68.8,501841,64.3,34702,6.5
10213,September 1992,Illinois,8862214,6035975,68.1,5587479,63.0,448496,7.4
10214,September 1992,Indiana,4300724,2875676,66.9,2683636,62.4,192040,6.7
10215,September 1992,Iowa,2128827,1520306,71.4,1453955,68.3,66351,4.4
10216,September 1992,Kansas,1863390,1317265,70.7,1256545,67.4,60720,4.6
10217,September 1992,Kentucky,2863643,1786849,62.4,1662876,58.1,123973,6.9
10218,September 1992,Louisiana,3124703,1920087,61.4,1762165,56.4,157922,8.2
10219,September 1992,Maine,946235,644160,68.1,598216,63.2,45944,7.1
10220,September 1992,Maryland,3748214,2651468,70.7,2474332,66.0,177136,6.7
10221,September 1992,Massachusetts,4685672,3182361,67.9,2915147,62.2,267214,8.4
10222,September 1992,Michigan,7141092,4692566,65.7,4280871,59.9,411695,8.8
10223,September 1992,Minnesota,3353607,2481025,74.0,2353324,70.2,127701,5.1
10224,September 1992,Mississippi,1932362,1198388,62.0,1102050,57.0,96338,8.0
10225,September 1992,Missouri,3928191,2648701,67.4,2487104,63.3,161597,6.1
10226,September 1992,Montana,614887,418258,68.0,390193,63.5,28065,6.7
10227,September 1992,Nebraska,1191044,850561,71.4,826106,69.4,24455,2.9
10228,September 1992,Nevada,1056545,738238,69.9,688505,65.2,49733,6.7
10229,September 1992,New Hampshire,851159,613701,72.1,569341,66.9,44360,7.2
10230,September 1992,New Jersey,6102882,4044008,66.3,3690303,60.5,353705,8.7
10231,September 1992,New Mexico,1170004,745321,63.7,692785,59.2,52536,7.0
10232,September 1992,New York,14123669,8772947,62.1,8000418,56.6,772529,8.8
10233,September 1992,North Carolina,5290074,3626025,68.5,3407148,64.4,218877,6.0
10234,September 1992,North Dakota,467375,316305,67.7,301251,64.5,15054,4.8
10235,September 1992,Ohio,8353669,5508082,65.9,5096369,61.0,411713,7.5
10236,September 1992,Oklahoma,2395230,1519589,63.4,1431540,59.8,88049,5.8
10237,September 1992,Oregon,2303926,1561924,67.8,1447726,62.8,114198,7.3
10238,September 1992,Pennsylvania,9291131,5923603,63.8,5472563,58.9,451040,7.6
10239,September 1992,Rhode Island,779113,528031,67.8,481475,61.8,46556,8.8
10240,September 1992,South Carolina,2707273,1793148,66.2,1673606,61.8,119542,6.7
10241,September 1992,South Dakota,511931,358243,70.0,346384,67.7,11859,3.3
10242,September 1992,Tennessee,3887637,2471224,63.6,2313399,59.5,157825,6.4
10243,September 1992,Texas,13085845,9050234,69.2,8360011,63.9,690223,7.6
10244,September 1992,Utah,1260798,895927,71.1,853082,67.7,42845,4.8
10245,September 1992,Vermont,435804,309333,71.0,291077,66.8,18256,5.9
10246,September 1992,Virginia,4795212,3399102,70.9,3191774,66.6,207328,6.1
10247,September 1992,Washington,3878026,2656631,68.5,2456883,63.4,199748,7.5
10248,September 1992,West Virginia,1417924,777781,54.9,690583,48.7,87198,11.2
10249,September 1992,Wisconsin,3777031,2709138,71.7,2567686,68.0,141452,5.2
10250,September 1992,Wyoming,340709,239574,70.3,226428,66.5,13146,5.5
10251,October 1992,Alabama,3164271,1974819,62.4,1828197,57.8,146622,7.4
10252,October 1992,Alaska,397707,289336,72.8,264579,66.5,24757,8.6
10253,October 1992,Arizona,2986649,1886366,63.2,1748044,58.5,138322,7.3
10254,October 1992,Arkansas,1834000,1153510,62.9,1074611,58.6,78899,6.8
10255,October 1992,California,23112112,15335527,66.4,13841904,59.9,1493623,9.7
10256,October 1992,Colorado,2646235,1865239,70.5,1752186,66.2,113053,6.1
10257,October 1992,Connecticut,2556745,1822065,71.3,1683215,65.8,138850,7.6
10258,October 1992,Delaware,531586,369889,69.6,350699,66.0,19190,5.2
10259,October 1992,District of Columbia,472431,313027,66.3,285600,60.5,27427,8.8
10260,October 1992,Florida,10750077,6680312,62.1,6147458,57.2,532854,8.0
10261,October 1992,Georgia,5120370,3422411,66.8,3185826,62.2,236585,6.9
10262,October 1992,Hawaii,843459,588201,69.7,559933,66.4,28268,4.8
10263,October 1992,Idaho,783004,537221,68.6,502826,64.2,34395,6.4
10264,October 1992,Illinois,8871463,6030371,68.0,5590132,63.0,440239,7.3
10265,October 1992,Indiana,4306291,2873437,66.7,2686642,62.4,186795,6.5
10266,October 1992,Iowa,2131155,1524695,71.5,1458902,68.5,65793,4.3
10267,October 1992,Kansas,1865402,1318517,70.7,1257573,67.4,60944,4.6
10268,October 1992,Kentucky,2867693,1788413,62.4,1665449,58.1,122964,6.9
10269,October 1992,Louisiana,3127724,1913296,61.2,1758526,56.2,154770,8.1
10270,October 1992,Maine,946212,642393,67.9,596496,63.0,45897,7.1
10271,October 1992,Maryland,3751039,2650014,70.6,2474794,66.0,175220,6.6
10272,October 1992,Massachusetts,4687662,3180364,67.8,2917253,62.2,263111,8.3
10273,October 1992,Michigan,7145792,4688140,65.6,4290490,60.0,397650,8.5
10274,October 1992,Minnesota,3359292,2484370,74.0,2357066,70.2,127304,5.1
10275,October 1992,Mississippi,1934464,1197875,61.9,1104625,57.1,93250,7.8
10276,October 1992,Missouri,3932773,2644572,67.2,2483731,63.2,160841,6.1
10277,October 1992,Montana,616853,418345,67.8,390567,63.3,27778,6.6
10278,October 1992,Nebraska,1193288,851344,71.3,827069,69.3,24275,2.9
10279,October 1992,Nevada,1060471,740705,69.8,690775,65.1,49930,6.7
10280,October 1992,New Hampshire,852255,614218,72.1,570177,66.9,44041,7.2
10281,October 1992,New Jersey,6107060,4035849,66.1,3687574,60.4,348275,8.6
10282,October 1992,New Mexico,1172216,746801,63.7,694381,59.2,52420,7.0
10283,October 1992,New York,14130750,8766374,62.0,8000168,56.6,766206,8.7
10284,October 1992,North Carolina,5300561,3627152,68.4,3410897,64.3,216255,6.0
10285,October 1992,North Dakota,467447,316773,67.8,301821,64.6,14952,4.7
10286,October 1992,Ohio,8360599,5501582,65.8,5095353,60.9,406229,7.4
10287,October 1992,Oklahoma,2397419,1519824,63.4,1432816,59.8,87008,5.7
10288,October 1992,Oregon,2309197,1564554,67.8,1449946,62.8,114608,7.3
10289,October 1992,Pennsylvania,9296741,5919387,63.7,5473547,58.9,445840,7.5
10290,October 1992,Rhode Island,779601,527565,67.7,481706,61.8,45859,8.7
10291,October 1992,South Carolina,2711251,1796144,66.2,1675579,61.8,120565,6.7
10292,October 1992,South Dakota,513020,358802,69.9,346937,67.6,11865,3.3
10293,October 1992,Tennessee,3893233,2475001,63.6,2317005,59.5,157996,6.4
10294,October 1992,Texas,13111446,9059658,69.1,8371358,63.8,688300,7.6
10295,October 1992,Utah,1266246,900092,71.1,857357,67.7,42735,4.7
10296,October 1992,Vermont,435829,309934,71.1,291938,67.0,17996,5.8
10297,October 1992,Virginia,4803340,3393104,70.6,3190114,66.4,202990,6.0
10298,October 1992,Washington,3887269,2659618,68.4,2457594,63.2,202024,7.6
10299,October 1992,West Virginia,1418801,777708,54.8,690910,48.7,86798,11.2
10300,October 1992,Wisconsin,3782487,2709542,71.6,2572907,68.0,136635,5.0
10301,October 1992,Wyoming,341730,239677,70.1,226737,66.3,12940,5.4
10302,November 1992,Alabama,3168073,1977282,62.4,1830852,57.8,146430,7.4
10303,November 1992,Alaska,398698,289741,72.7,265510,66.6,24231,8.4
10304,November 1992,Arizona,2996433,1888571,63.0,1751568,58.5,137003,7.3
10305,November 1992,Arkansas,1836412,1153038,62.8,1075656,58.6,77382,6.7
10306,November 1992,California,23118204,15321124,66.3,13824785,59.8,1496339,9.8
10307,November 1992,Colorado,2654213,1872826,70.6,1759315,66.3,113511,6.1
10308,November 1992,Connecticut,2556208,1820373,71.2,1681479,65.8,138894,7.6
10309,November 1992,Delaware,531662,370618,69.7,351886,66.2,18732,5.1
10310,November 1992,District of Columbia,472796,312911,66.2,285281,60.3,27630,8.8
10311,November 1992,Florida,10766433,6677143,62.0,6155768,57.2,521375,7.8
10312,November 1992,Georgia,5129381,3424528,66.8,3191893,62.2,232635,6.8
10313,November 1992,Hawaii,844591,588530,69.7,559939,66.3,28591,4.9
10314,November 1992,Idaho,785004,537643,68.5,503671,64.2,33972,6.3
10315,November 1992,Illinois,8879712,6026756,67.9,5587929,62.9,438827,7.3
10316,November 1992,Indiana,4310859,2873327,66.7,2691292,62.4,182035,6.3
10317,November 1992,Iowa,2132484,1529133,71.7,1463809,68.6,65324,4.3
10318,November 1992,Kansas,1867414,1319460,70.7,1258077,67.4,61383,4.7
10319,November 1992,Kentucky,2870742,1790109,62.4,1668530,58.1,121579,6.8
10320,November 1992,Louisiana,3129745,1906774,60.9,1755363,56.1,151411,7.9
10321,November 1992,Maine,947189,639941,67.6,594298,62.7,45643,7.1
10322,November 1992,Maryland,3752864,2648796,70.6,2475690,66.0,173106,6.5
10323,November 1992,Massachusetts,4688652,3178196,67.8,2919733,62.3,258463,8.1
10324,November 1992,Michigan,7149492,4683584,65.5,4301615,60.2,381969,8.2
10325,November 1992,Minnesota,3362977,2488044,74.0,2360813,70.2,127231,5.1
10326,November 1992,Mississippi,1936566,1197292,61.8,1107283,57.2,90009,7.5
10327,November 1992,Missouri,3936354,2643329,67.2,2481399,63.0,161930,6.1
10328,November 1992,Montana,617819,418586,67.8,391124,63.3,27462,6.6
10329,November 1992,Nebraska,1193531,852217,71.4,827985,69.4,24232,2.8
10330,November 1992,Nevada,1064396,743153,69.8,692986,65.1,50167,6.8
10331,November 1992,New Hampshire,852350,615176,72.2,571359,67.0,43817,7.1
10332,November 1992,New Jersey,6110238,4028775,65.9,3686466,60.3,342309,8.5
10333,November 1992,New Mexico,1174428,748163,63.7,695735,59.2,52428,7.0
10334,November 1992,New York,14134831,8756812,62.0,8000282,56.6,756530,8.6
10335,November 1992,North Carolina,5310048,3626489,68.3,3413527,64.3,212962,5.9
10336,November 1992,North Dakota,467519,317271,67.9,302492,64.7,14779,4.7
10337,November 1992,Ohio,8365528,5496387,65.7,5096118,60.9,400269,7.3
10338,November 1992,Oklahoma,2399608,1519859,63.3,1433688,59.7,86171,5.7
10339,November 1992,Oregon,2314467,1567161,67.7,1452327,62.7,114834,7.3
10340,November 1992,Pennsylvania,9300351,5914586,63.6,5474528,58.9,440058,7.4
10341,November 1992,Rhode Island,780089,526822,67.5,481860,61.8,44962,8.5
10342,November 1992,South Carolina,2715229,1799955,66.3,1677532,61.8,122423,6.8
10343,November 1992,South Dakota,514109,359372,69.9,347410,67.6,11962,3.3
10344,November 1992,Tennessee,3898828,2477932,63.6,2319878,59.5,158054,6.4
10345,November 1992,Texas,13133047,9069412,69.1,8382518,63.8,686894,7.6
10346,November 1992,Utah,1270695,904598,71.2,862080,67.8,42518,4.7
10347,November 1992,Vermont,435853,310292,71.2,292607,67.1,17685,5.7
10348,November 1992,Virginia,4809468,3387220,70.4,3188827,66.3,198393,5.9
10349,November 1992,Washington,3895512,2661408,68.3,2457634,63.1,203774,7.7
10350,November 1992,West Virginia,1419677,777684,54.8,691381,48.7,86303,11.1
10351,November 1992,Wisconsin,3786942,2709684,71.6,2578257,68.1,131427,4.9
10352,November 1992,Wyoming,341752,239772,70.2,226975,66.4,12797,5.3
10353,December 1992,Alabama,3171875,1981117,62.5,1833926,57.8,147191,7.4
10354,December 1992,Alaska,399690,290209,72.6,266499,66.7,23710,8.2
10355,December 1992,Arizona,3005216,1891441,62.9,1755846,58.4,135595,7.2
10356,December 1992,Arkansas,1839824,1153716,62.7,1077703,58.6,76013,6.6
10357,December 1992,California,23121295,15304969,66.2,13809859,59.7,1495110,9.8
10358,December 1992,Colorado,2662190,1880650,70.6,1766960,66.4,113690,6.0
10359,December 1992,Connecticut,2555671,1818626,71.2,1680137,65.7,138489,7.6
10360,December 1992,Delaware,532738,371264,69.7,352935,66.2,18329,4.9
10361,December 1992,District of Columbia,472162,313300,66.4,285561,60.5,27739,8.9
10362,December 1992,Florida,10780788,6675929,61.9,6164898,57.2,511031,7.7
10363,December 1992,Georgia,5138391,3427247,66.7,3198464,62.2,228783,6.7
10364,December 1992,Hawaii,845722,588531,69.6,559913,66.2,28618,4.9
10365,December 1992,Idaho,788005,538030,68.3,504425,64.0,33605,6.2
10366,December 1992,Illinois,8885961,6026510,67.8,5582543,62.8,443967,7.4
10367,December 1992,Indiana,4315426,2877036,66.7,2698432,62.5,178604,6.2
10368,December 1992,Iowa,2133812,1533600,71.9,1468574,68.8,65026,4.2
10369,December 1992,Kansas,1868425,1320210,70.7,1258114,67.3,62096,4.7
10370,December 1992,Kentucky,2874792,1792379,62.3,1671866,58.2,120513,6.7
10371,December 1992,Louisiana,3130767,1901343,60.7,1752871,56.0,148472,7.8
10372,December 1992,Maine,947166,637107,67.3,591900,62.5,45207,7.1
10373,December 1992,Maryland,3754688,2647988,70.5,2476919,66.0,171069,6.5
10374,December 1992,Massachusetts,4688642,3176262,67.7,2922774,62.3,253488,8.0
10375,December 1992,Michigan,7153192,4681373,65.4,4314416,60.3,366957,7.8
10376,December 1992,Minnesota,3366662,2492183,74.0,2364544,70.2,127639,5.1
10377,December 1992,Mississippi,1938668,1197595,61.8,1110256,57.3,87339,7.3
10378,December 1992,Missouri,3939936,2644874,67.1,2480553,63.0,164321,6.2
10379,December 1992,Montana,618786,419005,67.7,391858,63.3,27147,6.5
10380,December 1992,Nebraska,1194775,853335,71.4,828973,69.4,24362,2.9
10381,December 1992,Nevada,1068322,745620,69.8,695080,65.1,50540,6.8
10382,December 1992,New Hampshire,853446,616100,72.2,572648,67.1,43452,7.1
10383,December 1992,New Jersey,6112416,4023395,65.8,3686315,60.3,337080,8.4
10384,December 1992,New Mexico,1176640,749496,63.7,696954,59.2,52542,7.0
10385,December 1992,New York,14137912,8745286,61.9,8000812,56.6,744474,8.5
10386,December 1992,North Carolina,5318535,3625325,68.2,3415645,64.2,209680,5.8
10387,December 1992,North Dakota,467591,317817,68.0,303249,64.9,14568,4.6
10388,December 1992,Ohio,8369458,5492288,65.6,5097846,60.9,394442,7.2
10389,December 1992,Oklahoma,2401796,1519999,63.3,1433998,59.7,86001,5.7
10390,December 1992,Oregon,2318738,1569918,67.7,1454996,62.7,114922,7.3
10391,December 1992,Pennsylvania,9302961,5910122,63.5,5475492,58.9,434630,7.4
10392,December 1992,Rhode Island,779577,525813,67.4,481810,61.8,44003,8.4
10393,December 1992,South Carolina,2718207,1804696,66.4,1679551,61.8,125145,6.9
10394,December 1992,South Dakota,515198,359966,69.9,347845,67.5,12121,3.4
10395,December 1992,Tennessee,3903423,2480571,63.5,2322266,59.5,158305,6.4
10396,December 1992,Texas,13154649,9079491,69.0,8394296,63.8,685195,7.5
10397,December 1992,Utah,1275143,909236,71.3,867096,68.0,42140,4.6
10398,December 1992,Vermont,436877,310423,71.1,293096,67.1,17327,5.6
10399,December 1992,Virginia,4815595,3382082,70.2,3188088,66.2,193994,5.7
10400,December 1992,Washington,3903755,2662486,68.2,2457806,63.0,204680,7.7
10401,December 1992,West Virginia,1420554,777826,54.8,691839,48.7,85987,11.1
10402,December 1992,Wisconsin,3791398,2711271,71.5,2583621,68.1,127650,4.7
10403,December 1992,Wyoming,342773,239877,70.0,227135,66.3,12742,5.3
10404,January 1993,Alabama,3175677,1985991,62.5,1837649,57.9,148342,7.5
10405,January 1993,Alaska,399681,290814,72.8,267539,66.9,23275,8.0
10406,January 1993,Arizona,3015000,1895718,62.9,1761811,58.4,133907,7.1
10407,January 1993,Arkansas,1842236,1155745,62.7,1080810,58.7,74935,6.5
10408,January 1993,California,23126387,15289389,66.1,13799752,59.7,1489637,9.7
10409,January 1993,Colorado,2670168,1888369,70.7,1775151,66.5,113218,6.0
10410,January 1993,Connecticut,2555134,1816638,71.1,1679295,65.7,137343,7.6
10411,January 1993,Delaware,533814,371849,69.7,353828,66.3,18021,4.8
10412,January 1993,District of Columbia,472527,314014,66.5,286311,60.6,27703,8.8
10413,January 1993,Florida,10797143,6679597,61.9,6177038,57.2,502559,7.5
10414,January 1993,Georgia,5148402,3431054,66.6,3206300,62.3,224754,6.6
10415,January 1993,Hawaii,845853,588316,69.6,560017,66.2,28299,4.8
10416,January 1993,Idaho,790005,538706,68.2,505240,64.0,33466,6.2
10417,January 1993,Illinois,8893210,6030359,67.8,5577350,62.7,453009,7.5
10418,January 1993,Indiana,4318993,2885713,66.8,2708927,62.7,176786,6.1
10419,January 1993,Iowa,2135140,1538058,72.0,1473377,69.0,64681,4.2
10420,January 1993,Kansas,1870437,1321170,70.6,1258121,67.3,63049,4.8
10421,January 1993,Kentucky,2877842,1795352,62.4,1675331,58.2,120021,6.7
10422,January 1993,Louisiana,3132788,1897512,60.6,1751408,55.9,146104,7.7
10423,January 1993,Maine,947143,634388,67.0,589630,62.3,44758,7.1
10424,January 1993,Maryland,3756513,2647824,70.5,2478557,66.0,169267,6.4
10425,January 1993,Massachusetts,4689632,3174904,67.7,2926740,62.4,248164,7.8
10426,January 1993,Michigan,7155891,4683851,65.5,4329167,60.5,354684,7.6
10427,January 1993,Minnesota,3371347,2496791,74.1,2368312,70.2,128479,5.1
10428,January 1993,Mississippi,1940770,1199413,61.8,1113899,57.4,85514,7.1
10429,January 1993,Missouri,3943518,2649190,67.2,2482005,62.9,167185,6.3
10430,January 1993,Montana,619752,419575,67.7,392733,63.4,26842,6.4
10431,January 1993,Nebraska,1196019,854724,71.5,830142,69.4,24582,2.9
10432,January 1993,Nevada,1072248,748352,69.8,697288,65.0,51064,6.8
10433,January 1993,New Hampshire,853542,616567,72.2,573812,67.2,42755,6.9
10434,January 1993,New Jersey,6115595,4020147,65.7,3687656,60.3,332491,8.3
10435,January 1993,New Mexico,1178853,750915,63.7,698186,59.2,52729,7.0
10436,January 1993,New York,14141993,8733683,61.8,8003049,56.6,730634,8.4
10437,January 1993,North Carolina,5328022,3624500,68.0,3418019,64.2,206481,5.7
10438,January 1993,North Dakota,468663,318427,67.9,304074,64.9,14353,4.5
10439,January 1993,Ohio,8374387,5488855,65.5,5100563,60.9,388292,7.1
10440,January 1993,Oklahoma,2402985,1520637,63.3,1434059,59.7,86578,5.7
10441,January 1993,Oregon,2324008,1573064,67.7,1458172,62.7,114892,7.3
10442,January 1993,Pennsylvania,9306571,5906407,63.5,5476665,58.8,429742,7.3
10443,January 1993,Rhode Island,780066,524725,67.3,481615,61.7,43110,8.2
10444,January 1993,South Carolina,2722185,1810260,66.5,1681850,61.8,128410,7.1
10445,January 1993,South Dakota,515287,360589,70.0,348325,67.6,12264,3.4
10446,January 1993,Tennessee,3909018,2483789,63.5,2325295,59.5,158494,6.4
10447,January 1993,Texas,13176250,9090333,69.0,8408770,63.8,681563,7.5
10448,January 1993,Utah,1279592,913903,71.4,872309,68.2,41594,4.6
10449,January 1993,Vermont,436902,310461,71.1,293506,67.2,16955,5.5
10450,January 1993,Virginia,4821723,3378552,70.1,3188752,66.1,189800,5.6
10451,January 1993,Washington,3911998,2663706,68.1,2459275,62.9,204431,7.7
10452,January 1993,West Virginia,1421430,778194,54.7,692233,48.7,85961,11.0
10453,January 1993,Wisconsin,3795853,2715457,71.5,2589234,68.2,126223,4.6
10454,January 1993,Wyoming,342795,239999,70.0,227251,66.3,12748,5.3
10455,February 1993,Alabama,3178479,1991441,62.7,1841905,57.9,149536,7.5
10456,February 1993,Alaska,400672,291575,72.8,268608,67.0,22967,7.9
10457,February 1993,Arizona,3023784,1901612,62.9,1769744,58.5,131868,6.9
10458,February 1993,Arkansas,1845647,1159067,62.8,1084891,58.8,74176,6.4
10459,February 1993,California,23128478,15275639,66.0,13794944,59.6,1480695,9.7
10460,February 1993,Colorado,2678145,1895747,70.8,1783830,66.6,111917,5.9
10461,February 1993,Connecticut,2554597,1814093,71.0,1678814,65.7,135279,7.5
10462,February 1993,Delaware,533891,372459,69.8,354600,66.4,17859,4.8
10463,February 1993,District of Columbia,471893,314823,66.7,287292,60.9,27531,8.7
10464,February 1993,Florida,10811498,6688766,61.9,6192668,57.3,496098,7.4
10465,February 1993,Georgia,5156413,3436206,66.6,3215663,62.4,220543,6.4
10466,February 1993,Hawaii,846984,587990,69.4,560298,66.2,27692,4.7
10467,February 1993,Idaho,792005,539902,68.2,506329,63.9,33573,6.2
10468,February 1993,Illinois,8899459,6037566,67.8,5574958,62.6,462608,7.7
10469,February 1993,Indiana,4323561,2899070,67.1,2722728,63.0,176342,6.1
10470,February 1993,Iowa,2136468,1542675,72.2,1478241,69.2,64434,4.2
10471,February 1993,Kansas,1872449,1322668,70.6,1258518,67.2,64150,4.9
10472,February 1993,Kentucky,2880892,1798708,62.4,1678761,58.3,119947,6.7
10473,February 1993,Louisiana,3134809,1895017,60.5,1750789,55.8,144228,7.6
10474,February 1993,Maine,948120,632153,66.7,587681,62.0,44472,7.0
10475,February 1993,Maryland,3757338,2648456,70.5,2480514,66.0,167942,6.3
10476,February 1993,Massachusetts,4689623,3173949,67.7,2931505,62.5,242444,7.6
10477,February 1993,Michigan,7158591,4691287,65.5,4345149,60.7,346138,7.4
10478,February 1993,Minnesota,3375032,2501662,74.1,2372110,70.3,129552,5.2
10479,February 1993,Mississippi,1941872,1202456,61.9,1118128,57.6,84328,7.0
10480,February 1993,Missouri,3946099,2655410,67.3,2485646,63.0,169764,6.4
10481,February 1993,Montana,620718,420270,67.7,393682,63.4,26588,6.3
10482,February 1993,Nebraska,1197263,856339,71.5,831566,69.5,24773,2.9
10483,February 1993,Nevada,1076173,751539,69.8,699863,65.0,51676,6.9
10484,February 1993,New Hampshire,854637,616491,72.1,574803,67.3,41688,6.8
10485,February 1993,New Jersey,6116773,4018513,65.7,3690615,60.3,327898,8.2
10486,February 1993,New Mexico,1181065,752450,63.7,699531,59.2,52919,7.0
10487,February 1993,New York,14144074,8723152,61.7,8007237,56.6,715915,8.2
10488,February 1993,North Carolina,5336509,3624231,67.9,3421061,64.1,203170,5.6
10489,February 1993,North Dakota,468735,319107,68.1,304938,65.1,14169,4.4
10490,February 1993,Ohio,8377316,5485748,65.5,5104012,60.9,381736,7.0
10491,February 1993,Oklahoma,2405174,1522040,63.3,1434232,59.6,87808,5.8
10492,February 1993,Oregon,2328279,1576759,67.7,1461869,62.8,114890,7.3
10493,February 1993,Pennsylvania,9308181,5903470,63.4,5477998,58.9,425472,7.2
10494,February 1993,Rhode Island,779554,523753,67.2,481397,61.8,42356,8.1
10495,February 1993,South Carolina,2725163,1816288,66.6,1684519,61.8,131769,7.3
10496,February 1993,South Dakota,516376,361279,70.0,348925,67.6,12354,3.4
10497,February 1993,Tennessee,3913613,2488084,63.6,2329749,59.5,158335,6.4
10498,February 1993,Texas,13195851,9102130,69.0,8426484,63.9,675646,7.4
10499,February 1993,Utah,1283040,918630,71.6,877686,68.4,40944,4.5
10500,February 1993,Vermont,436926,310567,71.1,293940,67.3,16627,5.4
10501,February 1993,Virginia,4826851,3376784,70.0,3190736,66.1,186048,5.5
10502,February 1993,Washington,3919242,2665852,68.0,2462583,62.8,203269,7.6
10503,February 1993,West Virginia,1422307,778710,54.7,692564,48.7,86146,11.1
10504,February 1993,Wisconsin,3799309,2722202,71.6,2595011,68.3,127191,4.7
10505,February 1993,Wyoming,343816,240199,69.9,227415,66.1,12784,5.3
10506,March 1993,Alabama,3182281,1997034,62.8,1846347,58.0,150687,7.5
10507,March 1993,Alaska,401664,292452,72.8,269656,67.1,22796,7.8
10508,March 1993,Arizona,3032568,1909174,63.0,1779609,58.7,129565,6.8
10509,March 1993,Arkansas,1848059,1163539,63.0,1089825,59.0,73714,6.3
10510,March 1993,California,23130570,15266733,66.0,13796047,59.6,1470686,9.6
10511,March 1993,Colorado,2685123,1903052,70.9,1793201,66.8,109851,5.8
10512,March 1993,Connecticut,2553060,1810908,70.9,1678491,65.7,132417,7.3
10513,March 1993,Delaware,534967,373198,69.8,355312,66.4,17886,4.8
10514,March 1993,District of Columbia,472259,315525,66.8,288228,61.0,27297,8.7
10515,March 1993,Florida,10825854,6703371,61.9,6211911,57.4,491460,7.3
10516,March 1993,Georgia,5165424,3443355,66.7,3226829,62.5,216526,6.3
10517,March 1993,Hawaii,848115,587615,69.3,560681,66.1,26934,4.6
10518,March 1993,Idaho,795005,541791,68.1,507998,63.9,33793,6.2
10519,March 1993,Illinois,8905708,6047369,67.9,5577596,62.6,469773,7.8
10520,March 1993,Indiana,4327128,2916070,67.4,2739262,63.3,176808,6.1
10521,March 1993,Iowa,2137796,1547743,72.4,1483227,69.4,64516,4.2
10522,March 1993,Kansas,1873461,1324881,70.7,1259621,67.2,65260,4.9
10523,March 1993,Kentucky,2883941,1802160,62.5,1682150,58.3,120010,6.7
10524,March 1993,Louisiana,3135830,1893636,60.4,1750802,55.8,142834,7.5
10525,March 1993,Maine,948096,630586,66.5,586138,61.8,44448,7.0
10526,March 1993,Maryland,3759162,2650275,70.5,2482757,66.0,167518,6.3
10527,March 1993,Massachusetts,4689613,3173398,67.7,2936862,62.6,236536,7.5
10528,March 1993,Michigan,7161291,4702725,65.7,4361354,60.9,341371,7.3
10529,March 1993,Minnesota,3378717,2506410,74.2,2375998,70.3,130412,5.2
10530,March 1993,Mississippi,1943974,1206007,62.0,1122621,57.7,83386,6.9
10531,March 1993,Missouri,3948681,2662887,67.4,2491263,63.1,171624,6.4
10532,March 1993,Montana,622684,421091,67.6,394678,63.4,26413,6.3
10533,March 1993,Nebraska,1197506,858141,71.7,833305,69.6,24836,2.9
10534,March 1993,Nevada,1079099,755205,70.0,702904,65.1,52301,6.9
10535,March 1993,New Hampshire,854733,616129,72.1,575784,67.4,40345,6.5
10536,March 1993,New Jersey,6118951,4018089,65.7,3695117,60.4,322972,8.0
10537,March 1993,New Mexico,1183277,754177,63.7,701044,59.2,53133,7.0
10538,March 1993,New York,14145154,8715644,61.6,8013517,56.7,702127,8.1
10539,March 1993,North Carolina,5344996,3624943,67.8,3425350,64.1,199593,5.5
10540,March 1993,North Dakota,468807,319871,68.2,305832,65.2,14039,4.4
10541,March 1993,Ohio,8381246,5483486,65.4,5108460,61.0,375026,6.8
10542,March 1993,Oklahoma,2406363,1524477,63.4,1434938,59.6,89539,5.9
10543,March 1993,Oregon,2333549,1581089,67.8,1466021,62.8,115068,7.3
10544,March 1993,Pennsylvania,9310791,5902107,63.4,5479976,58.9,422131,7.2
10545,March 1993,Rhode Island,780042,523063,67.1,481314,61.7,41749,8.0
10546,March 1993,South Carolina,2728141,1822444,66.8,1687550,61.9,134894,7.4
10547,March 1993,South Dakota,516464,362061,70.1,349692,67.7,12369,3.4
10548,March 1993,Tennessee,3917208,2494268,63.7,2336569,59.6,157699,6.3
10549,March 1993,Texas,13215453,9116466,69.0,8447741,63.9,668725,7.3
10550,March 1993,Utah,1287488,923497,71.7,883224,68.6,40273,4.4
10551,March 1993,Vermont,436950,310837,71.1,294462,67.4,16375,5.3
10552,March 1993,Virginia,4831978,3376956,69.9,3193839,66.1,183117,5.4
10553,March 1993,Washington,3927485,2669599,68.0,2467808,62.8,201791,7.6
10554,March 1993,West Virginia,1423183,779344,54.8,692948,48.7,86396,11.1
10555,March 1993,Wisconsin,3802764,2730790,71.8,2600951,68.4,129839,4.8
10556,March 1993,Wyoming,343838,240544,70.0,227691,66.2,12853,5.3
10557,April 1993,Alabama,3185083,2002158,62.9,1850615,58.1,151543,7.6
10558,April 1993,Alaska,401655,293357,73.0,270626,67.4,22731,7.7
10559,April 1993,Arizona,3042352,1918200,63.0,1791142,58.9,127058,6.6
10560,April 1993,Arkansas,1850471,1168717,63.2,1095314,59.2,73403,6.3
10561,April 1993,California,23133661,15262939,66.0,13802757,59.7,1460182,9.6
10562,April 1993,Colorado,2693100,1910662,70.9,1803407,67.0,107255,5.6
10563,April 1993,Connecticut,2552523,1807144,70.8,1678197,65.7,128947,7.1
10564,April 1993,Delaware,535043,374141,69.9,356048,66.5,18093,4.8
10565,April 1993,District of Columbia,471624,316017,67.0,288951,61.3,27066,8.6
10566,April 1993,Florida,10841209,6721312,62.0,6234020,57.5,487292,7.2
10567,April 1993,Georgia,5174435,3452399,66.7,3239740,62.6,212659,6.2
10568,April 1993,Hawaii,848246,587268,69.2,561047,66.1,26221,4.5
10569,April 1993,Idaho,797005,544458,68.3,510532,64.1,33926,6.2
10570,April 1993,Illinois,8911957,6058471,68.0,5585815,62.7,472656,7.8
10571,April 1993,Indiana,4331695,2934876,67.8,2757316,63.7,177560,6.1
10572,April 1993,Iowa,2139124,1553148,72.6,1488365,69.6,64783,4.2
10573,April 1993,Kansas,1875473,1327666,70.8,1261590,67.3,66076,5.0
10574,April 1993,Kentucky,2886991,1805191,62.5,1685456,58.4,119735,6.6
10575,April 1993,Louisiana,3137852,1892766,60.3,1751166,55.8,141600,7.5
10576,April 1993,Maine,948073,629718,66.4,584983,61.7,44735,7.1
10577,April 1993,Maryland,3760987,2653164,70.5,2485336,66.1,167828,6.3
10578,April 1993,Massachusetts,4689603,3173055,67.7,2942451,62.7,230604,7.3
10579,April 1993,Michigan,7163991,4716377,65.8,4376799,61.1,339578,7.2
10580,April 1993,Minnesota,3382402,2510345,74.2,2379932,70.4,130413,5.2
10581,April 1993,Mississippi,1945076,1209378,62.2,1127021,57.9,82357,6.8
10582,April 1993,Missouri,3952262,2670797,67.6,2498493,63.2,172304,6.5
10583,April 1993,Montana,623651,421941,67.7,395656,63.4,26285,6.2
10584,April 1993,Nebraska,1198750,860004,71.7,835314,69.7,24690,2.9
10585,April 1993,Nevada,1083025,759078,70.1,706218,65.2,52860,7.0
10586,April 1993,New Hampshire,855829,615852,72.0,576947,67.4,38905,6.3
10587,April 1993,New Jersey,6121129,4018570,65.7,3700927,60.5,317643,7.9
10588,April 1993,New Mexico,1185489,756047,63.8,702696,59.3,53351,7.1
10589,April 1993,New York,14148235,8711654,61.6,8021349,56.7,690305,7.9
10590,April 1993,North Carolina,5353483,3626290,67.7,3431026,64.1,195264,5.4
10591,April 1993,North Dakota,468879,320727,68.4,306762,65.4,13965,4.4
10592,April 1993,Ohio,8385175,5482876,65.4,5114777,61.0,368099,6.7
10593,April 1993,Oklahoma,2408552,1527681,63.4,1436442,59.6,91239,6.0
10594,April 1993,Oregon,2337820,1586036,67.8,1470630,62.9,115406,7.3
10595,April 1993,Pennsylvania,9313401,5902577,63.4,5483088,58.9,419489,7.1
10596,April 1993,Rhode Island,779530,522715,67.1,481492,61.8,41223,7.9
10597,April 1993,South Carolina,2731119,1828081,66.9,1690812,61.9,137269,7.5
10598,April 1993,South Dakota,517553,362904,70.1,350590,67.7,12314,3.4
10599,April 1993,Tennessee,3922803,2502617,63.8,2346280,59.8,156337,6.2
10600,April 1993,Texas,13236054,9133901,69.0,8472232,64.0,661669,7.2
10601,April 1993,Utah,1291937,928547,71.9,888907,68.8,39640,4.3
10602,April 1993,Vermont,437975,311290,71.1,295085,67.4,16205,5.2
10603,April 1993,Virginia,4838106,3378618,69.8,3197656,66.1,180962,5.4
10604,April 1993,Washington,3934728,2674918,68.0,2474484,62.9,200434,7.5
10605,April 1993,West Virginia,1424059,780030,54.8,693582,48.7,86448,11.1
10606,April 1993,Wisconsin,3807219,2739865,72.0,2607118,68.5,132747,4.8
10607,April 1993,Wyoming,344859,241045,69.9,228117,66.1,12928,5.4
10608,May 1993,Alabama,3188885,2006394,62.9,1854396,58.2,151998,7.6
10609,May 1993,Alaska,402647,294243,73.1,271521,67.4,22722,7.7
10610,May 1993,Arizona,3051135,1928250,63.2,1803664,59.1,124586,6.5
10611,May 1993,Arkansas,1853883,1173940,63.3,1100808,59.4,73132,6.2
10612,May 1993,California,23137753,15263787,66.0,13812057,59.7,1451730,9.5
10613,May 1993,Colorado,2701078,1918590,71.0,1814002,67.2,104588,5.5
10614,May 1993,Connecticut,2551986,1803018,70.7,1677855,65.7,125163,6.9
10615,May 1993,Delaware,536119,375279,70.0,356854,66.6,18425,4.9
10616,May 1993,District of Columbia,470990,316285,67.2,289398,61.4,26887,8.5
10617,May 1993,Florida,10855564,6739840,62.1,6256501,57.6,483339,7.2
10618,May 1993,Georgia,5183446,3463261,66.8,3253577,62.8,209684,6.1
10619,May 1993,Hawaii,849378,586960,69.1,561307,66.1,25653,4.4
10620,May 1993,Idaho,799005,547842,68.6,513956,64.3,33886,6.2
10621,May 1993,Illinois,8918206,6070103,68.1,5597871,62.8,472232,7.8
10622,May 1993,Indiana,4336263,2954003,68.1,2775132,64.0,178871,6.1
10623,May 1993,Iowa,2140452,1558452,72.8,1493479,69.8,64973,4.2
10624,May 1993,Kansas,1876484,1330792,70.9,1264241,67.4,66551,5.0
10625,May 1993,Kentucky,2890041,1807222,62.5,1688466,58.4,118756,6.6
10626,May 1993,Louisiana,3139873,1892103,60.3,1751486,55.8,140617,7.4
10627,May 1993,Maine,948050,629378,66.4,584116,61.6,45262,7.2
10628,May 1993,Maryland,3761812,2656550,70.6,2488201,66.1,168349,6.3
10629,May 1993,Massachusetts,4689593,3172812,67.7,2947748,62.9,225064,7.1
10630,May 1993,Michigan,7166690,4730600,66.0,4390744,61.3,339856,7.2
10631,May 1993,Minnesota,3386087,2513295,74.2,2383817,70.4,129478,5.2
10632,May 1993,Mississippi,1947178,1212278,62.3,1131018,58.1,81260,6.7
10633,May 1993,Missouri,3955844,2678431,67.7,2506339,63.4,172092,6.4
10634,May 1993,Montana,624617,422693,67.7,396534,63.5,26159,6.2
10635,May 1993,Nebraska,1199994,861781,71.8,837450,69.8,24331,2.8
10636,May 1993,Nevada,1086950,762904,70.2,709607,65.3,53297,7.0
10637,May 1993,New Hampshire,855925,615917,72.0,578260,67.6,37657,6.1
10638,May 1993,New Jersey,6123308,4019506,65.6,3707219,60.5,312287,7.8
10639,May 1993,New Mexico,1187702,757963,63.8,704408,59.3,53555,7.1
10640,May 1993,New York,14151316,8711124,61.6,8029031,56.7,682093,7.8
10641,May 1993,North Carolina,5362970,3627786,67.6,3437394,64.1,190392,5.2
10642,May 1993,North Dakota,468951,321679,68.6,307742,65.6,13937,4.3
10643,May 1993,Ohio,8389105,5485135,65.4,5122794,61.1,362341,6.6
10644,May 1993,Oklahoma,2409740,1531069,63.5,1438566,59.7,92503,6.0
10645,May 1993,Oregon,2343090,1591446,67.9,1475656,63.0,115790,7.3
10646,May 1993,Pennsylvania,9316011,5904654,63.4,5486992,58.9,417662,7.1
10647,May 1993,Rhode Island,780019,522625,67.0,481880,61.8,40745,7.8
10648,May 1993,South Carolina,2734097,1832606,67.0,1694065,62.0,138541,7.6
10649,May 1993,South Dakota,518642,363804,70.1,351569,67.8,12235,3.4
10650,May 1993,Tennessee,3927398,2512574,64.0,2358253,60.0,154321,6.1
10651,May 1993,Texas,13257655,9154528,69.1,8498215,64.1,656313,7.2
10652,May 1993,Utah,1296385,933773,72.0,894681,69.0,39092,4.2
10653,May 1993,Vermont,437999,311879,71.2,295767,67.5,16112,5.2
10654,May 1993,Virginia,4844234,3380749,69.8,3201185,66.1,179564,5.3
10655,May 1993,Washington,3942971,2681462,68.0,2481863,62.9,199599,7.4
10656,May 1993,West Virginia,1424936,780666,54.8,694562,48.7,86104,11.0
10657,May 1993,Wisconsin,3811675,2748025,72.1,2613416,68.6,134609,4.9
10658,May 1993,Wyoming,344881,241681,70.1,228697,66.3,12984,5.4
10659,June 1993,Alabama,3192688,2009317,62.9,1857430,58.2,151887,7.6
10660,June 1993,Alaska,403638,295131,73.1,272407,67.5,22724,7.7
10661,June 1993,Arizona,3060919,1939127,63.4,1816592,59.3,122535,6.3
10662,June 1993,Arkansas,1856294,1178642,63.5,1105801,59.6,72841,6.2
10663,June 1993,California,23142844,15267070,66.0,13820046,59.7,1447024,9.5
10664,June 1993,Colorado,2709055,1926712,71.1,1824451,67.3,102261,5.3
10665,June 1993,Connecticut,2551449,1798725,70.5,1677427,65.7,121298,6.7
10666,June 1993,Delaware,537195,376509,70.1,357694,66.6,18815,5.0
10667,June 1993,District of Columbia,471355,316394,67.1,289610,61.4,26784,8.5
10668,June 1993,Florida,10871919,6756852,62.1,6276595,57.7,480257,7.1
10669,June 1993,Georgia,5193457,3475179,66.9,3267297,62.9,207882,6.0
10670,June 1993,Hawaii,850509,586594,69.0,561402,66.0,25192,4.3
10671,June 1993,Idaho,802005,551628,68.8,517989,64.6,33639,6.1
10672,June 1993,Illinois,8926454,6080994,68.1,5611343,62.9,469651,7.7
10673,June 1993,Indiana,4340830,2972534,68.5,2791289,64.3,181245,6.1
10674,June 1993,Iowa,2141780,1563093,73.0,1498208,70.0,64885,4.2
10675,June 1993,Kansas,1878496,1333852,71.0,1267026,67.4,66826,5.0
10676,June 1993,Kentucky,2894091,1807977,62.5,1691144,58.4,116833,6.5
10677,June 1993,Louisiana,3141894,1891930,60.2,1751493,55.7,140437,7.4
10678,June 1993,Maine,949027,629231,66.3,583385,61.5,45846,7.3
10679,June 1993,Maryland,3763636,2659725,70.7,2491267,66.2,168458,6.3
10680,June 1993,Massachusetts,4690583,3172737,67.6,2952391,62.9,220346,6.9
10681,June 1993,Michigan,7170390,4743996,66.2,4402628,61.4,341368,7.2
10682,June 1993,Minnesota,3390772,2515565,74.2,2387732,70.4,127833,5.1
10683,June 1993,Mississippi,1949279,1214677,62.3,1134456,58.2,80221,6.6
10684,June 1993,Missouri,3959425,2685369,67.8,2513899,63.5,171470,6.4
10685,June 1993,Montana,625583,423223,67.7,397220,63.5,26003,6.1
10686,June 1993,Nebraska,1201238,863440,71.9,839572,69.9,23868,2.8
10687,June 1993,Nevada,1090876,766585,70.3,713021,65.4,53564,7.0
10688,June 1993,New Hampshire,857020,616359,71.9,579541,67.6,36818,6.0
10689,June 1993,New Jersey,6125486,4020183,65.6,3713025,60.6,307158,7.6
10690,June 1993,New Mexico,1189914,759663,63.8,705981,59.3,53682,7.1
10691,June 1993,New York,14155397,8713337,61.6,8034630,56.8,678707,7.8
10692,June 1993,North Carolina,5371458,3628855,67.6,3443698,64.1,185157,5.1
10693,June 1993,North Dakota,470023,322719,68.7,308797,65.7,13922,4.3
10694,June 1993,Ohio,8394034,5490638,65.4,5131641,61.1,358997,6.5
10695,June 1993,Oklahoma,2411929,1534321,63.6,1440929,59.7,93392,6.1
10696,June 1993,Oregon,2348361,1597141,68.0,1481189,63.1,115952,7.3
10697,June 1993,Pennsylvania,9319621,5907516,63.4,5490882,58.9,416634,7.1
10698,June 1993,Rhode Island,779507,522632,67.0,482290,61.9,40342,7.7
10699,June 1993,South Carolina,2738075,1835429,67.0,1696898,62.0,138531,7.5
10700,June 1993,South Dakota,518731,364768,70.3,352596,68.0,12172,3.3
10701,June 1993,Tennessee,3931993,2522936,64.2,2371366,60.3,151570,6.0
10702,June 1993,Texas,13279257,9177544,69.1,8523613,64.2,653931,7.1
10703,June 1993,Utah,1300834,939043,72.2,900453,69.2,38590,4.1
10704,June 1993,Vermont,438024,312515,71.3,296455,67.7,16060,5.1
10705,June 1993,Virginia,4850361,3382100,69.7,3203534,66.0,178566,5.3
10706,June 1993,Washington,3951214,2688674,68.0,2489525,63.0,199149,7.4
10707,June 1993,West Virginia,1425812,781116,54.8,695831,48.8,85285,10.9
10708,June 1993,Wisconsin,3816130,2754509,72.2,2619674,68.6,134835,4.9
10709,June 1993,Wyoming,345902,242386,70.1,229366,66.3,13020,5.4
10710,July 1993,Alabama,3196490,2010370,62.9,1859740,58.2,150630,7.5
10711,July 1993,Alaska,403629,296001,73.3,273300,67.7,22701,7.7
10712,July 1993,Arizona,3069703,1950430,63.5,1829401,59.6,121029,6.2
10713,July 1993,Arkansas,1859706,1182516,63.6,1110058,59.7,72458,6.1
10714,July 1993,California,23147936,15266447,66.0,13823754,59.7,1442693,9.5
10715,July 1993,Colorado,2717033,1934823,71.2,1834513,67.5,100310,5.2
10716,July 1993,Connecticut,2550912,1794250,70.3,1676904,65.7,117346,6.5
10717,July 1993,Delaware,537271,377694,70.3,358476,66.7,19218,5.1
10718,July 1993,District of Columbia,470721,316476,67.2,289737,61.6,26739,8.4
10719,July 1993,Florida,10888274,6769578,62.2,6292228,57.8,477350,7.1
10720,July 1993,Georgia,5202468,3486258,67.0,3279881,63.0,206377,5.9
10721,July 1993,Hawaii,850640,586134,68.9,561240,66.0,24894,4.2
10722,July 1993,Idaho,804005,555494,69.1,522243,65.0,33251,6.0
10723,July 1993,Illinois,8933703,6088057,68.1,5624196,63.0,463861,7.6
10724,July 1993,Indiana,4344398,2946852,67.8,2804941,64.6,141911,4.8
10725,July 1993,Iowa,2143108,1566503,73.1,1502177,70.1,64326,4.1
10726,July 1993,Kansas,1880508,1336293,71.1,1269338,67.5,66955,5.0
10727,July 1993,Kentucky,2897141,1807273,62.4,1693494,58.5,113779,6.3
10728,July 1993,Louisiana,3143916,1892364,60.2,1751242,55.7,141122,7.5
10729,July 1993,Maine,949004,628936,66.3,582613,61.4,46323,7.4
10730,July 1993,Maryland,3765461,2662044,70.7,2494471,66.2,167573,6.3
10731,July 1993,Massachusetts,4691573,3172466,67.6,2956145,63.0,216321,6.8
10732,July 1993,Michigan,7174090,4754472,66.3,4412031,61.5,342441,7.2
10733,July 1993,Minnesota,3394458,2517417,74.2,2391894,70.5,125523,5.0
10734,July 1993,Mississippi,1950381,1216587,62.4,1137384,58.3,79203,6.5
10735,July 1993,Missouri,3963007,2690734,67.9,2520523,63.6,170211,6.3
10736,July 1993,Montana,626550,423464,67.6,397685,63.5,25779,6.1
10737,July 1993,Nebraska,1202482,865038,71.9,841614,70.0,23424,2.7
10738,July 1993,Nevada,1094801,770108,70.3,716496,65.4,53612,7.0
10739,July 1993,New Hampshire,857116,617078,72.0,580645,67.7,36433,5.9
10740,July 1993,New Jersey,6128664,4019687,65.6,3717694,60.7,301993,7.5
10741,July 1993,New Mexico,1192126,760722,63.8,707109,59.3,53613,7.0
10742,July 1993,New York,14159478,8715058,61.5,8036330,56.8,678728,7.8
10743,July 1993,North Carolina,5380945,3628850,67.4,3449495,64.1,179355,4.9
10744,July 1993,North Dakota,470095,323856,68.9,309967,65.9,13889,4.3
10745,July 1993,Ohio,8398963,5497930,65.5,5140282,61.2,357648,6.5
10746,July 1993,Oklahoma,2414118,1536771,63.7,1443154,59.8,93617,6.1
10747,July 1993,Oregon,2352631,1602744,68.1,1487370,63.2,115374,7.2
10748,July 1993,Pennsylvania,9322231,5909580,63.4,5494331,58.9,415249,7.0
10749,July 1993,Rhode Island,779995,522557,67.0,482555,61.9,40002,7.7
10750,July 1993,South Carolina,2741053,1836253,67.0,1699106,62.0,137147,7.5
10751,July 1993,South Dakota,519820,365780,70.4,353627,68.0,12153,3.3
10752,July 1993,Tennessee,3937588,2531933,64.3,2384331,60.6,147602,5.8
10753,July 1993,Texas,13300858,9199698,69.2,8546565,64.3,653133,7.1
10754,July 1993,Utah,1305282,944141,72.3,906127,69.4,38014,4.0
10755,July 1993,Vermont,439048,313117,71.3,297092,67.7,16025,5.1
10756,July 1993,Virginia,4856489,3381303,69.6,3204228,66.0,177075,5.2
10757,July 1993,Washington,3959458,2695662,68.1,2497258,63.1,198404,7.4
10758,July 1993,West Virginia,1426689,781139,54.8,697226,48.9,83913,10.7
10759,July 1993,Wisconsin,3820586,2759110,72.2,2625720,68.7,133390,4.8
10760,July 1993,Wyoming,345924,243097,70.3,230057,66.5,13040,5.4
10761,August 1993,Alabama,3199292,2009879,62.8,1861677,58.2,148202,7.4
10762,August 1993,Alaska,404621,296827,73.4,274170,67.8,22657,7.6
10763,August 1993,Arizona,3083487,1962111,63.6,1841901,59.7,120210,6.1
10764,August 1993,Arkansas,1862118,1185640,63.7,1113657,59.8,71983,6.1
10765,August 1993,California,23155027,15260868,65.9,13823870,59.7,1436998,9.4
10766,August 1993,Colorado,2725010,1942756,71.3,1844166,67.7,98590,5.1
10767,August 1993,Connecticut,2551375,1789615,70.1,1676263,65.7,113352,6.3
10768,August 1993,Delaware,538347,378733,70.4,359138,66.7,19595,5.2
10769,August 1993,District of Columbia,471087,316540,67.2,289805,61.5,26735,8.4
10770,August 1993,Florida,10908630,6779077,62.1,6304465,57.8,474612,7.0
10771,August 1993,Georgia,5214478,3496343,67.1,3291284,63.1,205059,5.9
10772,August 1993,Hawaii,851771,585674,68.8,560795,65.8,24879,4.2
10773,August 1993,Idaho,806006,559252,69.4,526373,65.3,32879,5.9
10774,August 1993,Illinois,8939952,6091205,68.1,5636366,63.0,454839,7.5
10775,August 1993,Indiana,4348965,2949112,67.8,2816216,64.8,132896,4.5
10776,August 1993,Iowa,2144436,1568489,73.1,1505247,70.2,63242,4.0
10777,August 1993,Kansas,1882520,1337959,71.1,1270982,67.5,66977,5.0
10778,August 1993,Kentucky,2900190,1805398,62.3,1695505,58.5,109893,6.1
10779,August 1993,Louisiana,3145937,1894037,60.2,1751341,55.7,142696,7.5
10780,August 1993,Maine,948981,628349,66.2,581775,61.3,46574,7.4
10781,August 1993,Maryland,3769286,2663416,70.7,2497870,66.3,165546,6.2
10782,August 1993,Massachusetts,4693563,3172387,67.6,2959417,63.1,212970,6.7
10783,August 1993,Michigan,7179790,4762514,66.3,4419891,61.6,342623,7.2
10784,August 1993,Minnesota,3399143,2519561,74.1,2396522,70.5,123039,4.9
10785,August 1993,Mississippi,1953483,1218418,62.4,1140165,58.4,78253,6.4
10786,August 1993,Missouri,3967588,2694792,67.9,2526545,63.7,168247,6.2
10787,August 1993,Montana,628516,423541,67.4,398099,63.3,25442,6.0
10788,August 1993,Nebraska,1203725,866666,72.0,843606,70.1,23060,2.7
10789,August 1993,Nevada,1100727,773715,70.3,720287,65.4,53428,6.9
10790,August 1993,New Hampshire,858212,617896,72.0,581531,67.8,36365,5.9
10791,August 1993,New Jersey,6131842,4018647,65.5,3721698,60.7,296949,7.4
10792,August 1993,New Mexico,1195338,761281,63.7,707940,59.2,53341,7.0
10793,August 1993,New York,14162559,8715040,61.5,8035066,56.7,679974,7.8
10794,August 1993,North Carolina,5390432,3628351,67.3,3454839,64.1,173512,4.8
10795,August 1993,North Dakota,470167,325117,69.1,311288,66.2,13829,4.3
10796,August 1993,Ohio,8402893,5505353,65.5,5148077,61.3,357276,6.5
10797,August 1993,Oklahoma,2416307,1538302,63.7,1445179,59.8,93123,6.1
10798,August 1993,Oregon,2356902,1608198,68.2,1494366,63.4,113832,7.1
10799,August 1993,Pennsylvania,9326841,5909787,63.4,5497301,58.9,412486,7.0
10800,August 1993,Rhode Island,780483,522319,66.9,482585,61.8,39734,7.6
10801,August 1993,South Carolina,2744031,1835677,66.9,1700927,62.0,134750,7.3
10802,August 1993,South Dakota,520909,366818,70.4,354648,68.1,12170,3.3
10803,August 1993,Tennessee,3943183,2539673,64.4,2396934,60.8,142739,5.6
10804,August 1993,Texas,13325460,9219355,69.2,8567153,64.3,652202,7.1
10805,August 1993,Utah,1309730,949010,72.5,911658,69.6,37352,3.9
10806,August 1993,Vermont,439072,313605,71.4,297617,67.8,15988,5.1
10807,August 1993,Virginia,4862616,3378982,69.5,3204142,65.9,174840,5.2
10808,August 1993,Washington,3966701,2702306,68.1,2505404,63.2,196902,7.3
10809,August 1993,West Virginia,1427565,780780,54.7,698598,48.9,82182,10.5
10810,August 1993,Wisconsin,3824041,2763194,72.3,2631898,68.8,131296,4.8
10811,August 1993,Wyoming,346945,243796,70.3,230740,66.5,13056,5.4
10812,September 1993,Alabama,3203094,2009108,62.7,1863791,58.2,145317,7.2
10813,September 1993,Alaska,404612,297629,73.6,275002,68.0,22627,7.6
10814,September 1993,Arizona,3096271,1974708,63.8,1854529,59.9,120179,6.1
10815,September 1993,Arkansas,1864530,1188210,63.7,1116839,59.9,71371,6.0
10816,September 1993,California,23163119,15254773,65.9,13824414,59.7,1430359,9.4
10817,September 1993,Colorado,2732988,1950782,71.4,1853684,67.8,97098,5.0
10818,September 1993,Connecticut,2551838,1784937,69.9,1675402,65.7,109535,6.1
10819,September 1993,Delaware,539423,379609,70.4,359681,66.7,19928,5.2
10820,September 1993,District of Columbia,470452,316411,67.3,289678,61.6,26733,8.4
10821,September 1993,Florida,10929985,6789508,62.1,6317133,57.8,472375,7.0
10822,September 1993,Georgia,5227489,3506749,67.1,3302459,63.2,204290,5.8
10823,September 1993,Hawaii,852902,585411,68.6,560144,65.7,25267,4.3
10824,September 1993,Idaho,809006,562798,69.6,530213,65.5,32585,5.8
10825,September 1993,Illinois,8946201,6092782,68.1,5649146,63.1,443636,7.3
10826,September 1993,Indiana,4353532,2959751,68.0,2826047,64.9,133704,4.5
10827,September 1993,Iowa,2146765,1569473,73.1,1507580,70.2,61893,3.9
10828,September 1993,Kansas,1884532,1339145,71.1,1272200,67.5,66945,5.0
10829,September 1993,Kentucky,2902240,1803515,62.1,1697326,58.5,106189,5.9
10830,September 1993,Louisiana,3148958,1897843,60.3,1752637,55.7,145206,7.7
10831,September 1993,Maine,949957,627599,66.1,580993,61.2,46606,7.4
10832,September 1993,Maryland,3772110,2664198,70.6,2501521,66.3,162677,6.1
10833,September 1993,Massachusetts,4696553,3173492,67.6,2963148,63.1,210344,6.6
10834,September 1993,Michigan,7185489,4770569,66.4,4427950,61.6,342619,7.2
10835,September 1993,Minnesota,3403828,2522573,74.1,2401759,70.6,120814,4.8
10836,September 1993,Mississippi,1955585,1220856,62.4,1143168,58.5,77688,6.4
10837,September 1993,Missouri,3972170,2698733,67.9,2533124,63.8,165609,6.1
10838,September 1993,Montana,629482,423611,67.3,398631,63.3,24980,5.9
10839,September 1993,Nebraska,1204969,868483,72.1,845658,70.2,22825,2.6
10840,September 1993,Nevada,1106653,777739,70.3,724657,65.5,53082,6.8
10841,September 1993,New Hampshire,859308,618630,72.0,582290,67.8,36340,5.9
10842,September 1993,New Jersey,6136021,4018542,65.5,3726006,60.7,292536,7.3
10843,September 1993,New Mexico,1197551,761891,63.6,708952,59.2,52939,6.9
10844,September 1993,New York,14166640,8714887,61.5,8034395,56.7,680492,7.8
10845,September 1993,North Carolina,5400919,3628773,67.2,3460222,64.1,168551,4.6
10846,September 1993,North Dakota,471239,326549,69.3,312798,66.4,13751,4.2
10847,September 1993,Ohio,8406822,5512303,65.6,5155572,61.3,356731,6.5
10848,September 1993,Oklahoma,2418496,1539557,63.7,1447221,59.8,92336,6.0
10849,September 1993,Oregon,2361172,1613671,68.3,1502132,63.6,111539,6.9
10850,September 1993,Pennsylvania,9330451,5907677,63.3,5499723,58.9,407954,6.9
10851,September 1993,Rhode Island,779972,521910,66.9,482364,61.8,39546,7.6
10852,September 1993,South Carolina,2748008,1834741,66.8,1702741,62.0,132000,7.2
10853,September 1993,South Dakota,521997,367868,70.5,355675,68.1,12193,3.3
10854,September 1993,Tennessee,3949778,2548260,64.5,2410046,61.0,138214,5.4
10855,September 1993,Texas,13350061,9238054,69.2,8587507,64.3,650547,7.0
10856,September 1993,Utah,1315179,953711,72.5,917054,69.7,36657,3.8
10857,September 1993,Vermont,439097,313923,71.5,298001,67.9,15922,5.1
10858,September 1993,Virginia,4868744,3377428,69.4,3204987,65.8,172441,5.1
10859,September 1993,Washington,3973944,2709201,68.2,2514512,63.3,194689,7.2
10860,September 1993,West Virginia,1428442,780357,54.6,699880,49.0,80477,10.3
10861,September 1993,Wisconsin,3828497,2769189,72.3,2638784,68.9,130405,4.7
10862,September 1993,Wyoming,347967,244489,70.3,231407,66.5,13082,5.4
10863,October 1993,Alabama,3206896,2008985,62.6,1866302,58.2,142683,7.1
10864,October 1993,Alaska,405603,298416,73.6,275786,68.0,22630,7.6
10865,October 1993,Arizona,3110054,1988469,63.9,1867564,60.0,120905,6.1
10866,October 1993,Arkansas,1867942,1190400,63.7,1119719,59.9,70681,5.9
10867,October 1993,California,23171210,15251892,65.8,13828431,59.7,1423461,9.3
10868,October 1993,Colorado,2741965,1959085,71.4,1863171,68.0,95914,4.9
10869,October 1993,Connecticut,2551301,1780318,69.8,1674103,65.6,106215,6.0
10870,October 1993,Delaware,539499,380381,70.5,360165,66.8,20216,5.3
10871,October 1993,District of Columbia,469818,315896,67.2,289187,61.6,26709,8.5
10872,October 1993,Florida,10950340,6803359,62.1,6332081,57.8,471278,6.9
10873,October 1993,Georgia,5239500,3518048,67.1,3313776,63.2,204272,5.8
10874,October 1993,Hawaii,854033,585413,68.5,559336,65.5,26077,4.5
10875,October 1993,Idaho,811006,566156,69.8,533796,65.8,32360,5.7
10876,October 1993,Illinois,8952450,6094454,68.1,5662291,63.2,432163,7.1
10877,October 1993,Indiana,4357100,2973450,68.2,2835196,65.1,138254,4.6
10878,October 1993,Iowa,2148093,1569982,73.1,1509312,70.3,60670,3.9
10879,October 1993,Kansas,1886543,1340243,71.0,1273278,67.5,66965,5.0
10880,October 1993,Kentucky,2905290,1802674,62.0,1699200,58.5,103474,5.7
10881,October 1993,Louisiana,3150980,1903875,60.4,1755422,55.7,148453,7.8
10882,October 1993,Maine,949934,626792,66.0,580302,61.1,46490,7.4
10883,October 1993,Maryland,3774935,2664858,70.6,2505326,66.4,159532,6.0
10884,October 1993,Massachusetts,4699543,3175986,67.6,2967624,63.1,208362,6.6
10885,October 1993,Michigan,7190189,4779818,66.5,4436892,61.7,342926,7.2
10886,October 1993,Minnesota,3408513,2526632,74.1,2407430,70.6,119202,4.7
10887,October 1993,Mississippi,1957687,1224084,62.5,1146382,58.6,77702,6.3
10888,October 1993,Missouri,3976752,2703326,68.0,2540778,63.9,162548,6.0
10889,October 1993,Montana,630448,423790,67.2,399327,63.3,24463,5.8
10890,October 1993,Nebraska,1206213,870592,72.2,847772,70.3,22820,2.6
10891,October 1993,Nevada,1111578,782333,70.4,729663,65.6,52670,6.7
10892,October 1993,New Hampshire,860403,619193,72.0,583111,67.8,36082,5.8
10893,October 1993,New Jersey,6139199,4019983,65.5,3730682,60.8,289301,7.2
10894,October 1993,New Mexico,1200763,762977,63.5,710493,59.2,52484,6.9
10895,October 1993,New York,14170721,8715671,61.5,8035928,56.7,679743,7.8
10896,October 1993,North Carolina,5410406,3630914,67.1,3465709,64.1,165205,4.5
10897,October 1993,North Dakota,471311,328153,69.6,314466,66.7,13687,4.2
10898,October 1993,Ohio,8411751,5519375,65.6,5163552,61.4,355823,6.4
10899,October 1993,Oklahoma,2420684,1540902,63.7,1449262,59.9,91640,5.9
10900,October 1993,Oregon,2366443,1618987,68.4,1510007,63.8,108980,6.7
10901,October 1993,Pennsylvania,9335061,5903568,63.2,5501393,58.9,402175,6.8
10902,October 1993,Rhode Island,780460,521359,66.8,481949,61.8,39410,7.6
10903,October 1993,South Carolina,2750986,1834486,66.7,1704877,62.0,129609,7.1
10904,October 1993,South Dakota,523086,368921,70.5,356705,68.2,12216,3.3
10905,October 1993,Tennessee,3956373,2559017,64.7,2423980,61.3,135037,5.3
10906,October 1993,Texas,13374662,9257367,69.2,8608603,64.4,648764,7.0
10907,October 1993,Utah,1319627,958283,72.6,922271,69.9,36012,3.8
10908,October 1993,Vermont,440121,314101,71.4,298298,67.8,15803,5.0
10909,October 1993,Virginia,4874872,3378018,69.3,3207369,65.8,170649,5.1
10910,October 1993,Washington,3981187,2716037,68.2,2523711,63.4,192326,7.1
10911,October 1993,West Virginia,1429318,780082,54.6,700995,49.0,79087,10.1
10912,October 1993,Wisconsin,3831952,2777780,72.5,2646179,69.1,131601,4.7
10913,October 1993,Wyoming,347988,245187,70.5,232069,66.7,13118,5.4
10914,November 1993,Alabama,3209698,2009717,62.6,1869179,58.2,140538,7.0
10915,November 1993,Alaska,405595,299169,73.8,276489,68.2,22680,7.6
10916,November 1993,Arizona,3122838,2003309,64.2,1881064,60.2,122245,6.1
10917,November 1993,Arkansas,1869353,1192475,63.8,1122480,60.0,69995,5.9
10918,November 1993,California,23175302,15255336,65.8,13837182,59.7,1418154,9.3
10919,November 1993,Colorado,2749943,1967832,71.6,1872609,68.1,95223,4.8
10920,November 1993,Connecticut,2551765,1775858,69.6,1672302,65.5,103556,5.8
10921,November 1993,Delaware,540575,381132,70.5,360667,66.7,20465,5.4
10922,November 1993,District of Columbia,469183,314965,67.1,288324,61.5,26641,8.5
10923,November 1993,Florida,10969695,6821359,62.2,6349287,57.9,472072,6.9
10924,November 1993,Georgia,5250511,3530463,67.2,3325145,63.3,205318,5.8
10925,November 1993,Hawaii,854165,585643,68.6,558409,65.4,27234,4.7
10926,November 1993,Idaho,814006,569424,70.0,537287,66.0,32137,5.6
10927,November 1993,Illinois,8957699,6097013,68.1,5674944,63.4,422069,6.9
10928,November 1993,Indiana,4361667,2988376,68.5,2843920,65.2,144456,4.8
10929,November 1993,Iowa,2149421,1570433,73.1,1510632,70.3,59801,3.8
10930,November 1993,Kansas,1887555,1341661,71.1,1274458,67.5,67203,5.0
10931,November 1993,Kentucky,2908340,1803232,62.0,1701303,58.5,101929,5.7
10932,November 1993,Louisiana,3153001,1911399,60.6,1759377,55.8,152022,8.0
10933,November 1993,Maine,949911,625927,65.9,579683,61.0,46244,7.4
10934,November 1993,Maryland,3777760,2665812,70.6,2509190,66.4,156622,5.9
10935,November 1993,Massachusetts,4701533,3179520,67.6,2972495,63.2,207025,6.5
10936,November 1993,Michigan,7194889,4790264,66.6,4446594,61.8,343670,7.2
10937,November 1993,Minnesota,3412198,2531618,74.2,2413243,70.7,118375,4.7
10938,November 1993,Mississippi,1960789,1227761,62.6,1149521,58.6,78240,6.4
10939,November 1993,Missouri,3980333,2709142,68.1,2549310,64.0,159832,5.9
10940,November 1993,Montana,632415,424160,67.1,400202,63.3,23958,5.6
10941,November 1993,Nebraska,1206457,872908,72.4,849839,70.4,23069,2.6
10942,November 1993,Nevada,1117504,787380,70.5,735102,65.8,52278,6.6
10943,November 1993,New Hampshire,860499,619702,72.0,584196,67.9,35506,5.7
10944,November 1993,New Jersey,6141377,4023087,65.5,3735418,60.8,287669,7.2
10945,November 1993,New Mexico,1203975,764682,63.5,712655,59.2,52027,6.8
10946,November 1993,New York,14172801,8718020,61.5,8039549,56.7,678471,7.8
10947,November 1993,North Carolina,5419893,3634898,67.1,3471168,64.0,163730,4.5
10948,November 1993,North Dakota,471383,329855,70.0,316215,67.1,13640,4.1
10949,November 1993,Ohio,8414681,5527505,65.7,5172462,61.5,355043,6.4
10950,November 1993,Oklahoma,2421873,1542538,63.7,1451197,59.9,91341,5.9
10951,November 1993,Oregon,2369713,1623749,68.5,1517234,64.0,106515,6.6
10952,November 1993,Pennsylvania,9337671,5899019,63.2,5502447,58.9,396572,6.7
10953,November 1993,Rhode Island,780948,520675,66.7,481453,61.6,39222,7.5
10954,November 1993,South Carolina,2753964,1835595,66.7,1707378,62.0,128217,7.0
10955,November 1993,South Dakota,523175,369986,70.7,357758,68.4,12228,3.3
10956,November 1993,Tennessee,3961969,2572125,64.9,2438564,61.5,133561,5.2
10957,November 1993,Texas,13397264,9278286,69.3,8630206,64.4,648080,7.0
10958,November 1993,Utah,1324076,962796,72.7,927221,70.0,35575,3.7
10959,November 1993,Vermont,440145,314195,71.4,298572,67.8,15623,5.0
10960,November 1993,Virginia,4880999,3381318,69.3,3211144,65.8,170174,5.0
10961,November 1993,Washington,3988430,2721995,68.2,2531395,63.5,190600,7.0
10962,November 1993,West Virginia,1429195,780040,54.6,701934,49.1,78106,10.0
10963,November 1993,Wisconsin,3836408,2787878,72.7,2653658,69.2,134220,4.8
10964,November 1993,Wyoming,349010,245901,70.5,232740,66.7,13161,5.4
10965,December 1993,Alabama,3212500,2010972,62.6,1872369,58.3,138603,6.9
10966,December 1993,Alaska,406586,299872,73.8,277074,68.1,22798,7.6
10967,December 1993,Arizona,3135622,2018834,64.4,1895036,60.4,123798,6.1
10968,December 1993,Arkansas,1871765,1194855,63.8,1125520,60.1,69335,5.8
10969,December 1993,California,23178393,15265213,65.9,13851811,59.8,1413402,9.3
10970,December 1993,Colorado,2756920,1977212,71.7,1882263,68.3,94949,4.8
10971,December 1993,Connecticut,2551228,1771718,69.4,1670228,65.5,101490,5.7
10972,December 1993,Delaware,540651,381940,70.6,361275,66.8,20665,5.4
10973,December 1993,District of Columbia,468549,313798,67.0,287295,61.3,26503,8.4
10974,December 1993,Florida,10988050,6843187,62.3,6369020,58.0,474167,6.9
10975,December 1993,Georgia,5261522,3543861,67.4,3336755,63.4,207106,5.8
10976,December 1993,Hawaii,855296,585979,68.5,557381,65.2,28598,4.9
10977,December 1993,Idaho,816006,572712,70.2,540829,66.3,31883,5.6
10978,December 1993,Illinois,8961948,6100111,68.1,5687275,63.5,412836,6.8
10979,December 1993,Indiana,4364235,3002784,68.8,2852530,65.4,150254,5.0
10980,December 1993,Iowa,2150749,1571150,73.1,1511864,70.3,59286,3.8
10981,December 1993,Kansas,1889567,1343640,71.1,1276048,67.5,67592,5.0
10982,December 1993,Kentucky,2910390,1805187,62.0,1703912,58.5,101275,5.6
10983,December 1993,Louisiana,3155022,1919138,60.8,1763958,55.9,155180,8.1
10984,December 1993,Maine,950888,625022,65.7,579139,60.9,45883,7.3
10985,December 1993,Maryland,3780584,2667332,70.6,2513134,66.5,154198,5.8
10986,December 1993,Massachusetts,4702523,3183527,67.7,2977514,63.3,206013,6.5
10987,December 1993,Michigan,7199589,4800161,66.7,4457015,61.9,343146,7.1
10988,December 1993,Minnesota,3415883,2536726,74.3,2419063,70.8,117663,4.6
10989,December 1993,Mississippi,1962891,1231348,62.7,1152333,58.7,79015,6.4
10990,December 1993,Missouri,3983915,2715912,68.2,2558600,64.2,157312,5.8
10991,December 1993,Montana,633381,424780,67.1,401266,63.4,23514,5.5
10992,December 1993,Nebraska,1207700,875264,72.5,851807,70.5,23457,2.7
10993,December 1993,Nevada,1123429,792584,70.6,740641,65.9,51943,6.6
10994,December 1993,New Hampshire,861595,620298,72.0,585612,68.0,34686,5.6
10995,December 1993,New Jersey,6143555,4027311,65.6,3740050,60.9,287261,7.1
10996,December 1993,New Mexico,1207187,766927,63.5,715297,59.3,51630,6.7
10997,December 1993,New York,14173882,8721201,61.5,8045541,56.8,675660,7.7
10998,December 1993,North Carolina,5428380,3640386,67.1,3476872,64.0,163514,4.5
10999,December 1993,North Dakota,472455,331539,70.2,317961,67.3,13578,4.1
11000,December 1993,Ohio,8417610,5536611,65.8,5182613,61.6,353998,6.4
11001,December 1993,Oklahoma,2424062,1544499,63.7,1453066,59.9,91433,5.9
11002,December 1993,Oregon,2373984,1627758,68.6,1523579,64.2,104179,6.4
11003,December 1993,Pennsylvania,9339281,5895465,63.1,5503495,58.9,391970,6.6
11004,December 1993,Rhode Island,781437,519833,66.5,480964,61.5,38869,7.5
11005,December 1993,South Carolina,2756942,1837973,66.7,1710120,62.0,127853,7.0
11006,December 1993,South Dakota,524264,371075,70.8,358837,68.4,12238,3.3
11007,December 1993,Tennessee,3967564,2587211,65.2,2453881,61.8,133330,5.2
11008,December 1993,Texas,13418865,9300743,69.3,8652603,64.5,648140,7.0
11009,December 1993,Utah,1328524,967373,72.8,931929,70.1,35444,3.7
11010,December 1993,Vermont,441170,314278,71.2,298865,67.7,15413,4.9
11011,December 1993,Virginia,4886127,3387370,69.3,3216386,65.8,170984,5.0
11012,December 1993,Washington,3994674,2726372,68.3,2536587,63.5,189785,7.0
11013,December 1993,West Virginia,1430071,780294,54.6,702922,49.2,77372,9.9
11014,December 1993,Wisconsin,3839863,2798084,72.9,2661099,69.3,136985,4.9
11015,December 1993,Wyoming,349031,246640,70.7,233435,66.9,13205,5.4
11016,January 1994,Alabama,3215302,2012200,62.6,1875794,58.3,136406,6.8
11017,January 1994,Alaska,406578,300484,73.9,277521,68.3,22963,7.6
11018,January 1994,Arizona,3147406,2034248,64.6,1908943,60.7,125305,6.2
11019,January 1994,Arkansas,1874177,1197813,63.9,1129100,60.2,68713,5.7
11020,January 1994,California,23179485,15276329,65.9,13870212,59.8,1406117,9.2
11021,January 1994,Colorado,2764898,1986872,71.9,1892138,68.4,94734,4.8
11022,January 1994,Connecticut,2550691,1767946,69.3,1667991,65.4,99955,5.7
11023,January 1994,Delaware,541727,382814,70.7,362042,66.8,20772,5.4
11024,January 1994,District of Columbia,467915,312700,66.8,286420,61.2,26280,8.4
11025,January 1994,Florida,11006406,6865821,62.4,6389922,58.1,475899,6.9
11026,January 1994,Georgia,5272533,3556382,67.5,3348260,63.5,208122,5.9
11027,January 1994,Hawaii,855427,586184,68.5,556270,65.0,29914,5.1
11028,January 1994,Idaho,818006,576030,70.4,544452,66.6,31578,5.5
11029,January 1994,Illinois,8966197,6101856,68.1,5699115,63.6,402741,6.6
11030,January 1994,Indiana,4367802,3014477,69.0,2860807,65.5,153670,5.1
11031,January 1994,Iowa,2152077,1572160,73.1,1513163,70.3,58997,3.8
11032,January 1994,Kansas,1890579,1345857,71.2,1278094,67.6,67763,5.0
11033,January 1994,Kentucky,2912439,1807949,62.1,1707026,58.6,100923,5.6
11034,January 1994,Louisiana,3156043,1925497,61.0,1768358,56.0,157139,8.2
11035,January 1994,Maine,950865,624064,65.6,578628,60.9,45436,7.3
11036,January 1994,Maryland,3782409,2669164,70.6,2517036,66.5,152128,5.7
11037,January 1994,Massachusetts,4704513,3187092,67.7,2982298,63.4,204794,6.4
11038,January 1994,Michigan,7203288,4806248,66.7,4467373,62.0,338875,7.1
11039,January 1994,Minnesota,3419568,2540841,74.3,2424787,70.9,116054,4.6
11040,January 1994,Mississippi,1963993,1234414,62.9,1154702,58.8,79712,6.5
11041,January 1994,Missouri,3987496,2722062,68.3,2567941,64.4,154121,5.7
11042,January 1994,Montana,634347,425592,67.1,402470,63.4,23122,5.4
11043,January 1994,Nebraska,1208944,877514,72.6,853703,70.6,23811,2.7
11044,January 1994,Nevada,1128355,797406,70.7,745750,66.1,51656,6.5
11045,January 1994,New Hampshire,862690,620978,72.0,587290,68.1,33688,5.4
11046,January 1994,New Jersey,6145734,4031301,65.6,3744017,60.9,287284,7.1
11047,January 1994,New Mexico,1209400,769450,63.6,718157,59.4,51293,6.7
11048,January 1994,New York,14173963,8721845,61.5,8052421,56.8,669424,7.7
11049,January 1994,North Carolina,5436867,3646424,67.1,3482846,64.1,163578,4.5
11050,January 1994,North Dakota,472527,333081,70.5,319620,67.6,13461,4.0
11051,January 1994,Ohio,8419540,5545039,65.9,5193443,61.7,351596,6.3
11052,January 1994,Oklahoma,2425251,1546322,63.8,1454672,60.0,91650,5.9
11053,January 1994,Oregon,2377254,1631066,68.6,1529150,64.3,101916,6.2
11054,January 1994,Pennsylvania,9340891,5893529,63.1,5505230,58.9,388299,6.6
11055,January 1994,Rhode Island,780925,518839,66.4,480517,61.5,38322,7.4
11056,January 1994,South Carolina,2759920,1840806,66.7,1712901,62.1,127905,6.9
11057,January 1994,South Dakota,525353,372196,70.8,359937,68.5,12259,3.3
11058,January 1994,Tennessee,3973159,2602566,65.5,2469277,62.1,133289,5.1
11059,January 1994,Texas,13440466,9322445,69.4,8675074,64.5,647371,6.9
11060,January 1994,Utah,1332973,971968,72.9,936406,70.2,35562,3.7
11061,January 1994,Vermont,441194,314410,71.3,299204,67.8,15206,4.8
11062,January 1994,Virginia,4891255,3394765,69.4,3222338,65.9,172427,5.1
11063,January 1994,Washington,4000917,2728381,68.2,2538962,63.5,189419,6.9
11064,January 1994,West Virginia,1429948,780846,54.6,704162,49.2,76684,9.8
11065,January 1994,Wisconsin,3842319,2806638,73.0,2668076,69.4,138562,4.9
11066,January 1994,Wyoming,350052,247386,70.7,234157,66.9,13229,5.3
11067,February 1994,Alabama,3217104,2012672,62.6,1879198,58.4,133474,6.6
11068,February 1994,Alaska,406569,300978,74.0,277835,68.3,23143,7.7
11069,February 1994,Arizona,3159189,2048581,64.8,1921951,60.8,126630,6.2
11070,February 1994,Arkansas,1875589,1201288,64.0,1133136,60.4,68152,5.7
11071,February 1994,California,23176576,15281312,65.9,13887456,59.9,1393856,9.1
11072,February 1994,Colorado,2771875,1996135,72.0,1901929,68.6,94206,4.7
11073,February 1994,Connecticut,2549154,1764430,69.2,1665618,65.3,98812,5.6
11074,February 1994,Delaware,541803,383698,70.8,362955,67.0,20743,5.4
11075,February 1994,District of Columbia,467280,311930,66.8,285953,61.2,25977,8.3
11076,February 1994,Florida,11022761,6884889,62.5,6409472,58.1,475417,6.9
11077,February 1994,Georgia,5282544,3565960,67.5,3358771,63.6,207189,5.8
11078,February 1994,Hawaii,856558,586117,68.4,555128,64.8,30989,5.3
11079,February 1994,Idaho,820006,579270,70.6,547986,66.8,31284,5.4
11080,February 1994,Illinois,8968446,6100723,68.0,5709701,63.7,391022,6.4
11081,February 1994,Indiana,4369369,3022132,69.2,2868029,65.6,154103,5.1
11082,February 1994,Iowa,2152405,1573033,73.1,1514569,70.4,58464,3.7
11083,February 1994,Kansas,1891591,1347644,71.2,1280175,67.7,67469,5.0
11084,February 1994,Kentucky,2913489,1810792,62.2,1710289,58.7,100503,5.6
11085,February 1994,Louisiana,3157065,1929402,61.1,1771906,56.1,157496,8.2
11086,February 1994,Maine,950842,623091,65.5,578084,60.8,45007,7.2
11087,February 1994,Maryland,3784234,2670717,70.6,2520725,66.6,149992,5.6
11088,February 1994,Massachusetts,4704503,3189369,67.8,2986360,63.5,203009,6.4
11089,February 1994,Michigan,7204988,4806463,66.7,4476472,62.1,329991,6.9
11090,February 1994,Minnesota,3423253,2543268,74.3,2430187,71.0,113081,4.4
11091,February 1994,Mississippi,1966095,1237005,62.9,1156889,58.8,80116,6.5
11092,February 1994,Missouri,3990078,2726122,68.3,2576413,64.6,149709,5.5
11093,February 1994,Montana,635313,426494,67.1,403725,63.5,22769,5.3
11094,February 1994,Nebraska,1209188,879538,72.7,855568,70.8,23970,2.7
11095,February 1994,Nevada,1134281,801349,70.6,749986,66.1,51363,6.4
11096,February 1994,New Hampshire,862786,621683,72.1,589048,68.3,32635,5.2
11097,February 1994,New Jersey,6146912,4033885,65.6,3747013,61.0,286872,7.1
11098,February 1994,New Mexico,1211612,771961,63.7,720972,59.5,50989,6.6
11099,February 1994,New York,14171044,8716537,61.5,8057256,56.9,659281,7.6
11100,February 1994,North Carolina,5444354,3651367,67.1,3488364,64.1,163003,4.5
11101,February 1994,North Dakota,472599,334402,70.8,321124,67.9,13278,4.0
11102,February 1994,Ohio,8419469,5550710,65.9,5203392,61.8,347318,6.3
11103,February 1994,Oklahoma,2426439,1547287,63.8,1455664,60.0,91623,5.9
11104,February 1994,Oregon,2380525,1633744,68.6,1534216,64.4,99528,6.1
11105,February 1994,Pennsylvania,9340501,5892737,63.1,5507631,59.0,385106,6.5
11106,February 1994,Rhode Island,781413,517744,66.3,480096,61.4,37648,7.3
11107,February 1994,South Carolina,2761898,1842887,66.7,1715454,62.1,127433,6.9
11108,February 1994,South Dakota,525442,373367,71.1,361087,68.7,12280,3.3
11109,February 1994,Tennessee,3977754,2616109,65.8,2483403,62.4,132706,5.1
11110,February 1994,Texas,13458068,9340297,69.4,8695954,64.6,644343,6.9
11111,February 1994,Utah,1337421,976422,73.0,940576,70.3,35846,3.7
11112,February 1994,Vermont,441218,314597,71.3,299584,67.9,15013,4.8
11113,February 1994,Virginia,4895382,3401254,69.5,3227729,65.9,173525,5.1
11114,February 1994,Washington,4006160,2727596,68.1,2538872,63.4,188724,6.9
11115,February 1994,West Virginia,1429824,781525,54.7,705662,49.4,75863,9.7
11116,February 1994,Wisconsin,3844774,2812397,73.1,2674189,69.6,138208,4.9
11117,February 1994,Wyoming,350074,248091,70.9,234883,67.1,13208,5.3
11118,March 1994,Alabama,3219906,2012379,62.5,1882383,58.5,129996,6.5
11119,March 1994,Alaska,407560,301384,73.9,278067,68.2,23317,7.7
11120,March 1994,Arizona,3171973,2061374,65.0,1933465,61.0,127909,6.2
11121,March 1994,Arkansas,1878000,1205068,64.2,1137356,60.6,67712,5.6
11122,March 1994,California,23176668,15276679,65.9,13898973,60.0,1377706,9.0
11123,March 1994,Colorado,2779853,2004611,72.1,1911414,68.8,93197,4.6
11124,March 1994,Connecticut,2548617,1761136,69.1,1663135,65.3,98001,5.6
11125,March 1994,Delaware,542879,384499,70.8,363950,67.0,20549,5.3
11126,March 1994,District of Columbia,466646,311595,66.8,285977,61.3,25618,8.2
11127,March 1994,Florida,11040116,6898052,62.5,6425898,58.2,472154,6.8
11128,March 1994,Georgia,5292555,3571833,67.5,3367681,63.6,204152,5.7
11129,March 1994,Hawaii,856689,585762,68.4,554011,64.7,31751,5.4
11130,March 1994,Idaho,822006,582157,70.8,551073,67.0,31084,5.3
11131,March 1994,Illinois,8972695,6097199,68.0,5718376,63.7,378823,6.2
11132,March 1994,Indiana,4372937,3026656,69.2,2874039,65.7,152617,5.0
11133,March 1994,Iowa,2153733,1573472,73.1,1516068,70.4,57404,3.6
11134,March 1994,Kansas,1892603,1348589,71.3,1281766,67.7,66823,5.0
11135,March 1994,Kentucky,2915539,1813285,62.2,1713372,58.8,99913,5.5
11136,March 1994,Louisiana,3159086,1931094,61.1,1774501,56.2,156593,8.1
11137,March 1994,Maine,950818,622136,65.4,577425,60.7,44711,7.2
11138,March 1994,Maryland,3786058,2671687,70.6,2524104,66.7,147583,5.5
11139,March 1994,Massachusetts,4705493,3190196,67.8,2989483,63.5,200713,6.3
11140,March 1994,Michigan,7207688,4802080,66.6,4483958,62.2,318122,6.6
11141,March 1994,Minnesota,3426938,2544271,74.2,2435036,71.1,109235,4.3
11142,March 1994,Mississippi,1968196,1239547,63.0,1159333,58.9,80214,6.5
11143,March 1994,Missouri,3993659,2728415,68.3,2583767,64.7,144648,5.3
11144,March 1994,Montana,636280,427472,67.2,405016,63.7,22456,5.3
11145,March 1994,Nebraska,1210432,881260,72.8,857376,70.8,23884,2.7
11146,March 1994,Nevada,1139206,804322,70.6,753290,66.1,51032,6.3
11147,March 1994,New Hampshire,863882,622366,72.0,590685,68.4,31681,5.1
11148,March 1994,New Jersey,6148090,4035169,65.6,3749601,61.0,285568,7.1
11149,March 1994,New Mexico,1214824,774225,63.7,723528,59.6,50697,6.5
11150,March 1994,New York,14170125,8704544,61.4,8057843,56.9,646701,7.4
11151,March 1994,North Carolina,5452841,3654622,67.0,3492808,64.1,161814,4.4
11152,March 1994,North Dakota,472671,335483,71.0,322432,68.2,13051,3.9
11153,March 1994,Ohio,8421398,5552436,65.9,5210562,61.9,341874,6.2
11154,March 1994,Oklahoma,2427628,1547084,63.7,1455865,60.0,91219,5.9
11155,March 1994,Oregon,2384795,1636198,68.6,1539262,64.5,96936,5.9
11156,March 1994,Pennsylvania,9342111,5892005,63.1,5509890,59.0,382115,6.5
11157,March 1994,Rhode Island,780901,516658,66.2,479673,61.4,36985,7.2
11158,March 1994,South Carolina,2763876,1843463,66.7,1717605,62.1,125858,6.8
11159,March 1994,South Dakota,526530,374567,71.1,362271,68.8,12296,3.3
11160,March 1994,Tennessee,3982349,2626812,66.0,2495137,62.7,131675,5.0
11161,March 1994,Texas,13478669,9353175,69.4,8713907,64.6,639268,6.8
11162,March 1994,Utah,1341869,980604,73.1,944369,70.4,36235,3.7
11163,March 1994,Vermont,441243,314827,71.4,299980,68.0,14847,4.7
11164,March 1994,Virginia,4899510,3405452,69.5,3231803,66.0,173649,5.1
11165,March 1994,Washington,4012403,2724820,67.9,2537628,63.2,187192,6.9
11166,March 1994,West Virginia,1430701,782114,54.7,707326,49.4,74788,9.6
11167,March 1994,Wisconsin,3847230,2815391,73.2,2679224,69.6,136167,4.8
11168,March 1994,Wyoming,351095,248744,70.8,235624,67.1,13120,5.3
11169,April 1994,Alabama,3222708,2012245,62.4,1885667,58.5,126578,6.3
11170,April 1994,Alaska,407552,301760,74.0,278336,68.3,23424,7.8
11171,April 1994,Arizona,3184757,2072933,65.1,1943611,61.0,129322,6.2
11172,April 1994,Arkansas,1880412,1209161,64.3,1141811,60.7,67350,5.6
11173,April 1994,California,23180760,15264372,65.8,13904749,60.0,1359623,8.9
11174,April 1994,Colorado,2786830,2012651,72.2,1920993,68.9,91658,4.6
11175,April 1994,Connecticut,2549080,1758295,69.0,1660694,65.1,97601,5.6
11176,April 1994,Delaware,542955,385111,70.9,364933,67.2,20178,5.2
11177,April 1994,District of Columbia,466011,311654,66.9,286418,61.5,25236,8.1
11178,April 1994,Florida,11058471,6906739,62.5,6440050,58.2,466689,6.8
11179,April 1994,Georgia,5304565,3574885,67.4,3375557,63.6,199328,5.6
11180,April 1994,Hawaii,857820,585218,68.2,552984,64.5,32234,5.5
11181,April 1994,Idaho,825007,584506,70.8,553504,67.1,31002,5.3
11182,April 1994,Illinois,8977944,6092954,67.9,5726024,63.8,366930,6.0
11183,April 1994,Indiana,4376504,3030504,69.2,2879961,65.8,150543,5.0
11184,April 1994,Iowa,2155061,1573920,73.0,1517787,70.4,56133,3.6
11185,April 1994,Kansas,1894614,1348668,71.2,1282585,67.7,66083,4.9
11186,April 1994,Kentucky,2917589,1815505,62.2,1716379,58.8,99126,5.5
11187,April 1994,Louisiana,3161107,1931906,61.1,1776819,56.2,155087,8.0
11188,April 1994,Maine,950795,621192,65.3,576681,60.7,44511,7.2
11189,April 1994,Maryland,3788883,2672478,70.5,2527435,66.7,145043,5.4
11190,April 1994,Massachusetts,4707483,3190265,67.8,2992191,63.6,198074,6.2
11191,April 1994,Michigan,7212388,4796455,66.5,4491011,62.3,305444,6.4
11192,April 1994,Minnesota,3430623,2544912,74.2,2439560,71.1,105352,4.1
11193,April 1994,Mississippi,1970298,1242350,63.1,1162446,59.0,79904,6.4
11194,April 1994,Missouri,3997241,2730721,68.3,2590922,64.8,139799,5.1
11195,April 1994,Montana,637246,428631,67.3,406413,63.8,22218,5.2
11196,April 1994,Nebraska,1210675,882674,72.9,859074,71.0,23600,2.7
11197,April 1994,Nevada,1145132,806611,70.4,755949,66.0,50662,6.3
11198,April 1994,New Hampshire,863978,623053,72.1,592153,68.5,30900,5.0
11199,April 1994,New Jersey,6150268,4036407,65.6,3753156,61.0,283251,7.0
11200,April 1994,New Mexico,1218036,776153,63.7,725725,59.6,50428,6.5
11201,April 1994,New York,14172206,8688016,61.3,8054927,56.8,633089,7.3
11202,April 1994,North Carolina,5462328,3657638,67.0,3497022,64.0,160616,4.4
11203,April 1994,North Dakota,473743,336355,71.0,323545,68.3,12810,3.8
11204,April 1994,Ohio,8424328,5550476,65.9,5214576,61.9,335900,6.1
11205,April 1994,Oklahoma,2429817,1546091,63.6,1455669,59.9,90422,5.8
11206,April 1994,Oregon,2388066,1639000,68.6,1544757,64.7,94243,5.8
11207,April 1994,Pennsylvania,9344721,5891221,63.0,5512103,59.0,379118,6.4
11208,April 1994,Rhode Island,781390,515665,66.0,479251,61.3,36414,7.1
11209,April 1994,South Carolina,2766854,1842657,66.6,1719518,62.1,123139,6.7
11210,April 1994,South Dakota,527619,375768,71.2,363459,68.9,12309,3.3
11211,April 1994,Tennessee,3987944,2634915,66.1,2504462,62.8,130453,5.0
11212,April 1994,Texas,13501270,9362455,69.3,8729666,64.7,632789,6.8
11213,April 1994,Utah,1346318,984472,73.1,947815,70.4,36657,3.7
11214,April 1994,Vermont,442267,315063,71.2,300349,67.9,14714,4.7
11215,April 1994,Virginia,4905638,3407810,69.5,3235227,65.9,172583,5.1
11216,April 1994,Washington,4018646,2721848,67.7,2537180,63.1,184668,6.8
11217,April 1994,West Virginia,1431577,782472,54.7,709092,49.5,73380,9.4
11218,April 1994,Wisconsin,3851685,2816782,73.1,2683564,69.7,133218,4.7
11219,April 1994,Wyoming,351117,249363,71.0,236398,67.3,12965,5.2
11220,May 1994,Alabama,3225510,2013314,62.4,1889553,58.6,123761,6.1
11221,May 1994,Alaska,408543,302121,74.0,278710,68.2,23411,7.7
11222,May 1994,Arizona,3196541,2084187,65.2,1953341,61.1,130846,6.3
11223,May 1994,Arkansas,1881824,1213570,64.5,1146607,60.9,66963,5.5
11224,May 1994,California,23181851,15250343,65.8,13909425,60.0,1340918,8.8
11225,May 1994,Colorado,2794808,2021248,72.3,1931617,69.1,89631,4.4
11226,May 1994,Connecticut,2547543,1756171,68.9,1658587,65.1,97584,5.6
11227,May 1994,Delaware,544032,385458,70.9,365820,67.2,19638,5.1
11228,May 1994,District of Columbia,465377,311885,67.0,287027,61.7,24858,8.0
11229,May 1994,Florida,11076827,6914985,62.4,6455191,58.3,459794,6.6
11230,May 1994,Georgia,5314576,3577343,67.3,3383883,63.7,193460,5.4
11231,May 1994,Hawaii,857951,584690,68.1,552120,64.4,32570,5.6
11232,May 1994,Idaho,827007,586332,70.9,555267,67.1,31065,5.3
11233,May 1994,Illinois,8981193,6090808,67.8,5734624,63.9,356184,5.8
11234,May 1994,Indiana,4379071,3036489,69.3,2887486,65.9,149003,4.9
11235,May 1994,Iowa,2156389,1574929,73.0,1519950,70.5,54979,3.5
11236,May 1994,Kansas,1895626,1348148,71.1,1282730,67.7,65418,4.9
11237,May 1994,Kentucky,2919638,1818062,62.3,1719716,58.9,98346,5.4
11238,May 1994,Louisiana,3162129,1933432,61.1,1779870,56.3,153562,7.9
11239,May 1994,Maine,950772,620367,65.2,575997,60.6,44370,7.2
11240,May 1994,Maryland,3790708,2673805,70.5,2531188,66.8,142617,5.3
11241,May 1994,Massachusetts,4708474,3190923,67.8,2995577,63.6,195346,6.1
11242,May 1994,Michigan,7216088,4793373,66.4,4499258,62.4,294115,6.1
11243,May 1994,Minnesota,3434308,2546361,74.1,2444089,71.2,102272,4.0
11244,May 1994,Mississippi,1972400,1245502,63.1,1166338,59.1,79164,6.4
11245,May 1994,Missouri,4000822,2735659,68.4,2599873,65.0,135786,5.0
11246,May 1994,Montana,639212,430022,67.3,407936,63.8,22086,5.1
11247,May 1994,Nebraska,1211919,883868,72.9,860619,71.0,23249,2.6
11248,May 1994,Nevada,1150058,808627,70.3,758341,65.9,50286,6.2
11249,May 1994,New Hampshire,865073,623741,72.1,593508,68.6,30233,4.8
11250,May 1994,New Jersey,6152446,4039547,65.7,3759282,61.1,280265,6.9
11251,May 1994,New Mexico,1220248,777784,63.7,727548,59.6,50236,6.5
11252,May 1994,New York,14172287,8671546,61.2,8052095,56.8,619451,7.1
11253,May 1994,North Carolina,5469815,3662796,67.0,3502677,64.0,160119,4.4
11254,May 1994,North Dakota,473815,337074,71.1,324476,68.5,12598,3.7
11255,May 1994,Ohio,8426257,5546585,65.8,5217403,61.9,329182,5.9
11256,May 1994,Oklahoma,2431006,1545061,63.6,1455864,59.9,89197,5.8
11257,May 1994,Oregon,2392336,1642396,68.7,1550817,64.8,91579,5.6
11258,May 1994,Pennsylvania,9346331,5890827,63.0,5514911,59.0,375916,6.4
11259,May 1994,Rhode Island,781878,514760,65.8,478814,61.2,35946,7.0
11260,May 1994,South Carolina,2769832,1841246,66.5,1721564,62.2,119682,6.5
11261,May 1994,South Dakota,527708,376948,71.4,364614,69.1,12334,3.3
11262,May 1994,Tennessee,3993539,2642091,66.2,2512841,62.9,129250,4.9
11263,May 1994,Texas,13521872,9371442,69.3,8746267,64.7,625175,6.7
11264,May 1994,Utah,1350766,988022,73.1,950968,70.4,37054,3.8
11265,May 1994,Vermont,442292,315274,71.3,300660,68.0,14614,4.6
11266,May 1994,Virginia,4909765,3410327,69.5,3239865,66.0,170462,5.0
11267,May 1994,Washington,4024890,2720619,67.6,2539306,63.1,181313,6.7
11268,May 1994,West Virginia,1431454,782607,54.7,710935,49.7,71672,9.2
11269,May 1994,Wisconsin,3854141,2818502,73.1,2688151,69.7,130351,4.6
11270,May 1994,Wyoming,352138,249934,71.0,237173,67.4,12761,5.1
11271,June 1994,Alabama,3228313,2016484,62.5,1894454,58.7,122030,6.1
11272,June 1994,Alaska,408534,302444,74.0,279176,68.3,23268,7.7
11273,June 1994,Arizona,3209325,2095934,65.3,1963668,61.2,132266,6.3
11274,June 1994,Arkansas,1884236,1218020,64.6,1151585,61.1,66435,5.5
11275,June 1994,California,23185943,15240009,65.7,13917365,60.0,1322644,8.7
11276,June 1994,Colorado,2802785,2031107,72.5,1943763,69.4,87344,4.3
11277,June 1994,Connecticut,2548006,1754833,68.9,1656956,65.0,97877,5.6
11278,June 1994,Delaware,544108,385544,70.9,366564,67.4,18980,4.9
11279,June 1994,District of Columbia,464743,312003,67.1,287496,61.9,24507,7.9
11280,June 1994,Florida,11096182,6926352,62.4,6473911,58.3,452441,6.5
11281,June 1994,Georgia,5326587,3581473,67.2,3393738,63.7,187735,5.2
11282,June 1994,Hawaii,859083,584364,68.0,551513,64.2,32851,5.6
11283,June 1994,Idaho,829007,587725,70.9,556461,67.1,31264,5.3
11284,June 1994,Illinois,8986441,6093077,67.8,5744841,63.9,348236,5.7
11285,June 1994,Indiana,4382639,3046306,69.5,2897639,66.1,148667,4.9
11286,June 1994,Iowa,2157717,1576740,73.1,1522540,70.6,54200,3.4
11287,June 1994,Kansas,1897638,1347501,71.0,1282551,67.6,64950,4.8
11288,June 1994,Kentucky,2921688,1821308,62.3,1723548,59.0,97760,5.4
11289,June 1994,Louisiana,3164150,1936554,61.2,1784180,56.4,152374,7.9
11290,June 1994,Maine,951749,619779,65.1,575555,60.5,44224,7.1
11291,June 1994,Maryland,3793532,2676077,70.5,2535580,66.8,140497,5.3
11292,June 1994,Massachusetts,4710464,3193210,67.8,3000287,63.7,192923,6.0
11293,June 1994,Michigan,7220787,4795139,66.4,4509746,62.5,285393,6.0
11294,June 1994,Minnesota,3437993,2549142,74.1,2448709,71.2,100433,3.9
11295,June 1994,Mississippi,1974502,1248788,63.2,1170534,59.3,78254,6.3
11296,June 1994,Missouri,4004404,2745188,68.6,2611935,65.2,133253,4.9
11297,June 1994,Montana,640179,431564,67.4,409503,64.0,22061,5.1
11298,June 1994,Nebraska,1213163,885019,73.0,862060,71.1,22959,2.6
11299,June 1994,Nevada,1155983,810660,70.1,760672,65.8,49988,6.2
11300,June 1994,New Hampshire,866169,624461,72.1,594850,68.7,29611,4.7
11301,June 1994,New Jersey,6154625,4045887,65.7,3768475,61.2,277412,6.9
11302,June 1994,New Mexico,1223461,779360,63.7,729183,59.6,50177,6.4
11303,June 1994,New York,14173368,8659424,61.1,8052845,56.8,606579,7.0
11304,June 1994,North Carolina,5479303,3671478,67.0,3510712,64.1,160766,4.4
11305,June 1994,North Dakota,473887,337648,71.3,325222,68.6,12426,3.7
11306,June 1994,Ohio,8429186,5542982,65.8,5221697,61.9,321285,5.8
11307,June 1994,Oklahoma,2433195,1544582,63.5,1457018,59.9,87564,5.7
11308,June 1994,Oregon,2395607,1646239,68.7,1557072,65.0,89167,5.4
11309,June 1994,Pennsylvania,9348941,5890851,63.0,5518433,59.0,372418,6.3
11310,June 1994,Rhode Island,781366,513934,65.8,478393,61.2,35541,6.9
11311,June 1994,South Carolina,2772810,1840283,66.4,1724195,62.2,116088,6.3
11312,June 1994,South Dakota,528797,378032,71.5,365651,69.1,12381,3.3
11313,June 1994,Tennessee,3999134,2650141,66.3,2521860,63.1,128281,4.8
11314,June 1994,Texas,13544473,9382844,69.3,8766113,64.7,616731,6.6
11315,June 1994,Utah,1355215,991218,73.1,953806,70.4,37412,3.8
11316,June 1994,Vermont,442316,315433,71.3,300907,68.0,14526,4.6
11317,June 1994,Virginia,4915893,3414821,69.5,3246997,66.1,167824,4.9
11318,June 1994,Washington,4031133,2722653,67.5,2544767,63.1,177886,6.5
11319,June 1994,West Virginia,1432330,782618,54.6,712827,49.8,69791,8.9
11320,June 1994,Wisconsin,3857596,2821970,73.2,2693759,69.8,128211,4.5
11321,June 1994,Wyoming,353160,250466,70.9,237942,67.4,12524,5.0
11322,July 1994,Alabama,3231115,2021986,62.6,1900507,58.8,121479,6.0
11323,July 1994,Alaska,409526,302742,73.9,279706,68.3,23036,7.6
11324,July 1994,Arizona,3222108,2108495,65.4,1975290,61.3,133205,6.3
11325,July 1994,Arkansas,1886648,1222154,64.8,1156451,61.3,65703,5.4
11326,July 1994,California,23189034,15237155,65.7,13931605,60.1,1305550,8.6
11327,July 1994,Colorado,2810763,2042303,72.7,1957208,69.6,85095,4.2
11328,July 1994,Connecticut,2547469,1754127,68.9,1655723,65.0,98404,5.6
11329,July 1994,Delaware,545184,385441,70.7,367161,67.3,18280,4.7
11330,July 1994,District of Columbia,465108,311761,67.0,287547,61.8,24214,7.8
11331,July 1994,Florida,11114537,6943167,62.5,6497563,58.5,445604,6.4
11332,July 1994,Georgia,5337598,3588980,67.2,3405726,63.8,183254,5.1
11333,July 1994,Hawaii,860214,584337,67.9,551269,64.1,33068,5.7
11334,July 1994,Idaho,831007,588865,70.9,557274,67.1,31591,5.4
11335,July 1994,Illinois,8990690,6099941,67.8,5756268,64.0,343673,5.6
11336,July 1994,Indiana,4386206,3060290,69.8,2910901,66.4,149389,4.9
11337,July 1994,Iowa,2159046,1579280,73.1,1525347,70.6,53933,3.4
11338,July 1994,Kansas,1899650,1347241,70.9,1282396,67.5,64845,4.8
11339,July 1994,Kentucky,2923738,1825509,62.4,1727955,59.1,97554,5.3
11340,July 1994,Louisiana,3166171,1941537,61.3,1789853,56.5,151684,7.8
11341,July 1994,Maine,951726,619541,65.1,575628,60.5,43913,7.1
11342,July 1994,Maryland,3796357,2679541,70.6,2540592,66.9,138949,5.2
11343,July 1994,Massachusetts,4712454,3197602,67.9,3006463,63.8,191139,6.0
11344,July 1994,Michigan,7224487,4801740,66.5,4522658,62.6,279082,5.8
11345,July 1994,Minnesota,3441678,2553450,74.2,2453500,71.3,99950,3.9
11346,July 1994,Mississippi,1976604,1251899,63.3,1174405,59.4,77494,6.2
11347,July 1994,Missouri,4008986,2760339,68.9,2627512,65.5,132827,4.8
11348,July 1994,Montana,641145,433164,67.6,410996,64.1,22168,5.1
11349,July 1994,Nebraska,1214407,886389,73.0,863533,71.1,22856,2.6
11350,July 1994,Nevada,1161909,812969,70.0,763159,65.7,49810,6.1
11351,July 1994,New Hampshire,866265,625269,72.2,596248,68.8,29021,4.6
11352,July 1994,New Jersey,6156803,4055447,65.9,3780228,61.4,275219,6.8
11353,July 1994,New Mexico,1225673,781280,63.7,731005,59.6,50275,6.4
11354,July 1994,New York,14175449,8654246,61.1,8059480,56.9,594766,6.9
11355,July 1994,North Carolina,5487790,3683785,67.1,3521343,64.2,162442,4.4
11356,July 1994,North Dakota,473959,338046,71.3,325757,68.7,12289,3.6
11357,July 1994,Ohio,8432116,5541695,65.7,5229780,62.0,311915,5.6
11358,July 1994,Oklahoma,2434383,1545307,63.5,1459429,60.0,85878,5.6
11359,July 1994,Oregon,2399877,1650145,68.8,1562961,65.1,87184,5.3
11360,July 1994,Pennsylvania,9350551,5891537,63.0,5522587,59.1,368950,6.3
11361,July 1994,Rhode Island,781854,513148,65.6,478007,61.1,35141,6.8
11362,July 1994,South Carolina,2774788,1840473,66.3,1727658,62.3,112815,6.1
11363,July 1994,South Dakota,529886,378996,71.5,366554,69.2,12442,3.3
11364,July 1994,Tennessee,4004729,2660308,66.4,2532609,63.2,127699,4.8
11365,July 1994,Texas,13567074,9398705,69.3,8790544,64.8,608161,6.5
11366,July 1994,Utah,1359663,994097,73.1,956310,70.3,37787,3.8
11367,July 1994,Vermont,443340,315568,71.2,301142,67.9,14426,4.6
11368,July 1994,Virginia,4921021,3422597,69.6,3257130,66.2,165467,4.8
11369,July 1994,Washington,4038376,2728736,67.6,2553368,63.2,175368,6.4
11370,July 1994,West Virginia,1432207,782718,54.7,714715,49.9,68003,8.7
11371,July 1994,Wisconsin,3861052,2827568,73.2,2700737,69.9,126831,4.5
11372,July 1994,Wyoming,353181,250985,71.1,238704,67.6,12281,4.9
11373,August 1994,Alabama,3232917,2029140,62.8,1907323,59.0,121817,6.0
11374,August 1994,Alaska,409517,303026,74.0,280243,68.4,22783,7.5
11375,August 1994,Arizona,3233892,2121816,65.6,1988510,61.5,133306,6.3
11376,August 1994,Arkansas,1889059,1225654,64.9,1160938,61.5,64716,5.3
11377,August 1994,California,23197126,15240365,65.7,13951800,60.1,1288565,8.5
11378,August 1994,Colorado,2817740,2054339,72.9,1971234,70.0,83105,4.0
11379,August 1994,Connecticut,2547932,1753620,68.8,1654707,64.9,98913,5.6
11380,August 1994,Delaware,546260,385242,70.5,367640,67.3,17602,4.6
11381,August 1994,District of Columbia,463474,311074,67.1,287071,61.9,24003,7.7
11382,August 1994,Florida,11134892,6964069,62.5,6524669,58.6,439400,6.3
11383,August 1994,Georgia,5348609,3599244,67.3,3419359,63.9,179885,5.0
11384,August 1994,Hawaii,860345,584564,67.9,551398,64.1,33166,5.7
11385,August 1994,Idaho,834007,589870,70.7,557899,66.9,31971,5.4
11386,August 1994,Illinois,8995939,6108875,67.9,5768247,64.1,340628,5.6
11387,August 1994,Indiana,4390774,3076833,70.1,2926870,66.7,149963,4.9
11388,August 1994,Iowa,2160374,1582093,73.2,1527987,70.7,54106,3.4
11389,August 1994,Kansas,1901662,1347650,70.9,1282471,67.4,65179,4.8
11390,August 1994,Kentucky,2926788,1830539,62.5,1732925,59.2,97614,5.3
11391,August 1994,Louisiana,3169192,1947614,61.5,1796344,56.7,151270,7.8
11392,August 1994,Maine,951703,619761,65.1,576362,60.6,43399,7.0
11393,August 1994,Maryland,3798182,2683941,70.7,2546041,67.0,137900,5.1
11394,August 1994,Massachusetts,4715444,3203481,67.9,3013604,63.9,189877,5.9
11395,August 1994,Michigan,7230187,4810144,66.5,4536378,62.7,273766,5.7
11396,August 1994,Minnesota,3446363,2558919,74.2,2458543,71.3,100376,3.9
11397,August 1994,Mississippi,1978706,1254538,63.4,1177399,59.5,77139,6.1
11398,August 1994,Missouri,4012567,2779832,69.3,2645630,65.9,134202,4.8
11399,August 1994,Montana,642111,434602,67.7,412266,64.2,22336,5.1
11400,August 1994,Nebraska,1215650,888097,73.1,865094,71.2,23003,2.6
11401,August 1994,Nevada,1166834,815468,69.9,765742,65.6,49726,6.1
11402,August 1994,New Hampshire,867360,626099,72.2,597644,68.9,28455,4.5
11403,August 1994,New Jersey,6160981,4066666,66.0,3793101,61.6,273565,6.7
11404,August 1994,New Mexico,1228885,783599,63.8,733126,59.7,50473,6.4
11405,August 1994,New York,14177529,8654979,61.0,8071359,56.9,583620,6.7
11406,August 1994,North Carolina,5498277,3698107,67.3,3534171,64.3,163936,4.4
11407,August 1994,North Dakota,475031,338233,71.2,326045,68.6,12188,3.6
11408,August 1994,Ohio,8437045,5542992,65.7,5242222,62.1,300770,5.4
11409,August 1994,Oklahoma,2436572,1547277,63.5,1462891,60.0,84386,5.5
11410,August 1994,Oregon,2404148,1653462,68.8,1567959,65.2,85503,5.2
11411,August 1994,Pennsylvania,9354161,5892666,63.0,5527251,59.1,365415,6.2
11412,August 1994,Rhode Island,782343,512403,65.5,477689,61.1,34714,6.8
11413,August 1994,South Carolina,2778766,1841698,66.3,1731720,62.3,109978,6.0
11414,August 1994,South Dakota,529975,379892,71.7,367395,69.3,12497,3.3
11415,August 1994,Tennessee,4011324,2672412,66.6,2544994,63.4,127418,4.8
11416,August 1994,Texas,13589676,9418583,69.3,8818901,64.9,599682,6.4
11417,August 1994,Utah,1364112,996620,73.1,958431,70.3,38189,3.8
11418,August 1994,Vermont,443365,315733,71.2,301455,68.0,14278,4.5
11419,August 1994,Virginia,4926148,3433267,69.7,3269598,66.4,163669,4.8
11420,August 1994,Washington,4045619,2737861,67.7,2564015,63.4,173846,6.3
11421,August 1994,West Virginia,1433083,782863,54.6,716471,50.0,66392,8.5
11422,August 1994,Wisconsin,3865507,2834356,73.3,2708805,70.1,125551,4.4
11423,August 1994,Wyoming,354203,251504,71.0,239444,67.6,12060,4.8
11424,September 1994,Alabama,3235719,2036731,62.9,1914325,59.2,122406,6.0
11425,September 1994,Alaska,410509,303264,73.9,280702,68.4,22562,7.4
11426,September 1994,Arizona,3244676,2135426,65.8,2003240,61.7,132186,6.2
11427,September 1994,Arkansas,1891471,1228688,65.0,1165036,61.6,63652,5.2
11428,September 1994,California,23206217,15244859,65.7,13975746,60.2,1269113,8.3
11429,September 1994,Colorado,2824718,2066291,73.2,1984891,70.3,81400,3.9
11430,September 1994,Connecticut,2548395,1752995,68.8,1653851,64.9,99144,5.7
11431,September 1994,Delaware,546336,385043,70.5,368062,67.4,16981,4.4
11432,September 1994,District of Columbia,462839,310069,67.0,286163,61.8,23906,7.7
11433,September 1994,Florida,11155247,6985415,62.6,6552643,58.7,432772,6.2
11434,September 1994,Georgia,5359620,3610092,67.4,3433518,64.1,176574,4.9
11435,September 1994,Hawaii,861476,584865,67.9,551797,64.1,33068,5.7
11436,September 1994,Idaho,836007,590837,70.7,558518,66.8,32319,5.5
11437,September 1994,Illinois,9001188,6117223,68.0,5781134,64.2,336089,5.5
11438,September 1994,Indiana,4394341,3093353,70.4,2944368,67.0,148985,4.8
11439,September 1994,Iowa,2162702,1584553,73.3,1530164,70.8,54389,3.4
11440,September 1994,Kansas,1903673,1348732,70.8,1282969,67.4,65763,4.9
11441,September 1994,Kentucky,2930838,1835729,62.6,1738196,59.3,97533,5.3
11442,September 1994,Louisiana,3171214,1953467,61.6,1802851,56.9,150616,7.7
11443,September 1994,Maine,952679,620460,65.1,577758,60.6,42702,6.9
11444,September 1994,Maryland,3801006,2688802,70.7,2551767,67.1,137035,5.1
11445,September 1994,Massachusetts,4719434,3209560,68.0,3020877,64.0,188683,5.9
11446,September 1994,Michigan,7236887,4816585,66.6,4548733,62.9,267852,5.6
11447,September 1994,Minnesota,3451048,2565028,74.3,2463986,71.4,101042,3.9
11448,September 1994,Mississippi,1980808,1256446,63.4,1179396,59.5,77050,6.1
11449,September 1994,Missouri,4016149,2800867,69.7,2664480,66.3,136387,4.9
11450,September 1994,Montana,644077,435868,67.7,413262,64.2,22606,5.2
11451,September 1994,Nebraska,1216894,890008,73.1,866745,71.2,23263,2.6
11452,September 1994,Nevada,1172760,817886,69.7,768224,65.5,49662,6.1
11453,September 1994,New Hampshire,868456,626794,72.2,598899,69.0,27895,4.5
11454,September 1994,New Jersey,6165159,4077636,66.1,3805690,61.7,271946,6.7
11455,September 1994,New Mexico,1231097,786080,63.9,735419,59.7,50661,6.4
11456,September 1994,New York,14180610,8658712,61.1,8086242,57.0,572470,6.6
11457,September 1994,North Carolina,5508764,3712111,67.4,3548251,64.4,163860,4.4
11458,September 1994,North Dakota,475103,338186,71.2,326062,68.6,12124,3.6
11459,September 1994,Ohio,8442975,5545416,65.7,5257568,62.3,287848,5.2
11460,September 1994,Oklahoma,2438761,1549869,63.6,1466964,60.2,82905,5.3
11461,September 1994,Oregon,2408418,1655792,68.8,1571824,65.3,83968,5.1
11462,September 1994,Pennsylvania,9357771,5893905,63.0,5532511,59.1,361394,6.1
11463,September 1994,Rhode Island,781831,511816,65.5,477520,61.1,34296,6.7
11464,September 1994,South Carolina,2782744,1843410,66.2,1736031,62.4,107379,5.8
11465,September 1994,South Dakota,531063,380760,71.7,368246,69.3,12514,3.3
11466,September 1994,Tennessee,4017919,2685014,66.8,2558079,63.7,126935,4.7
11467,September 1994,Texas,13613277,9439746,69.3,8849295,65.0,590451,6.3
11468,September 1994,Utah,1368560,998790,73.0,960221,70.2,38569,3.9
11469,September 1994,Vermont,444389,315978,71.1,301892,67.9,14086,4.5
11470,September 1994,Virginia,4932276,3445238,69.9,3283243,66.6,161995,4.7
11471,September 1994,Washington,4052862,2748428,67.8,2575300,63.5,173128,6.3
11472,September 1994,West Virginia,1432960,782883,54.6,717993,50.1,64890,8.3
11473,September 1994,Wisconsin,3869963,2840897,73.4,2717491,70.2,123406,4.3
11474,September 1994,Wyoming,354224,252046,71.2,240146,67.8,11900,4.7
11475,October 1994,Alabama,3237521,2043615,63.1,1921001,59.3,122614,6.0
11476,October 1994,Alaska,410500,303421,73.9,281008,68.5,22413,7.4
11477,October 1994,Arizona,3256460,2148679,66.0,2018930,62.0,129749,6.0
11478,October 1994,Arkansas,1893883,1231560,65.0,1168936,61.7,62624,5.1
11479,October 1994,California,23215309,15245724,65.7,14001208,60.3,1244516,8.2
11480,October 1994,Colorado,2832695,2077183,73.3,1997342,70.5,79841,3.8
11481,October 1994,Connecticut,2548858,1752169,68.7,1653215,64.9,98954,5.6
11482,October 1994,Delaware,547412,384926,70.3,368511,67.3,16415,4.3
11483,October 1994,District of Columbia,462205,308892,66.8,284956,61.7,23936,7.7
11484,October 1994,Florida,11175603,7003963,62.7,6580107,58.9,423856,6.1
11485,October 1994,Georgia,5371631,3619547,67.4,3447464,64.2,172083,4.8
11486,October 1994,Hawaii,861607,585074,67.9,552335,64.1,32739,5.6
11487,October 1994,Idaho,839007,591879,70.5,559320,66.7,32559,5.5
11488,October 1994,Illinois,9006437,6123827,68.0,5796007,64.4,327820,5.4
11489,October 1994,Indiana,4398908,3107720,70.6,2961943,67.3,145777,4.7
11490,October 1994,Iowa,2165030,1586209,73.3,1531821,70.8,54388,3.4
11491,October 1994,Kansas,1905685,1350185,70.9,1284058,67.4,66127,4.9
11492,October 1994,Kentucky,2933887,1840312,62.7,1743432,59.4,96880,5.3
11493,October 1994,Louisiana,3174235,1958029,61.7,1808801,57.0,149228,7.6
11494,October 1994,Maine,952656,621571,65.2,579722,60.9,41849,6.7
11495,October 1994,Maryland,3803831,2693351,70.8,2557658,67.2,135693,5.0
11496,October 1994,Massachusetts,4723424,3214574,68.1,3027616,64.1,186958,5.8
11497,October 1994,Michigan,7242586,4818959,66.5,4558367,62.9,260592,5.4
11498,October 1994,Minnesota,3455733,2571084,74.4,2469877,71.5,101207,3.9
11499,October 1994,Mississippi,1983910,1257482,63.4,1180679,59.5,76803,6.1
11500,October 1994,Missouri,4020730,2820601,70.2,2682504,66.7,138097,4.9
11501,October 1994,Montana,645044,437067,67.8,414068,64.2,22999,5.3
11502,October 1994,Nebraska,1219138,891857,73.2,868490,71.2,23367,2.6
11503,October 1994,Nevada,1177686,820080,69.6,770566,65.4,49514,6.0
11504,October 1994,New Hampshire,870552,627303,72.1,599950,68.9,27353,4.4
11505,October 1994,New Jersey,6169338,4086681,66.2,3817412,61.9,269269,6.6
11506,October 1994,New Mexico,1234310,788590,63.9,737867,59.8,50723,6.4
11507,October 1994,New York,14184691,8662816,61.1,8102511,57.1,560305,6.5
11508,October 1994,North Carolina,5519251,3723791,67.5,3562512,64.5,161279,4.3
11509,October 1994,North Dakota,475175,337927,71.1,325864,68.6,12063,3.6
11510,October 1994,Ohio,8447904,5547166,65.7,5273969,62.4,273197,4.9
11511,October 1994,Oklahoma,2439950,1552435,63.6,1471257,60.3,81178,5.2
11512,October 1994,Oregon,2413689,1657124,68.7,1574818,65.2,82306,5.0
11513,October 1994,Pennsylvania,9361381,5894902,63.0,5538803,59.2,356099,6.0
11514,October 1994,Rhode Island,782319,511496,65.4,477554,61.0,33942,6.6
11515,October 1994,South Carolina,2786722,1844739,66.2,1740227,62.4,104512,5.7
11516,October 1994,South Dakota,532152,381624,71.7,369194,69.4,12430,3.3
11517,October 1994,Tennessee,4024514,2696428,67.0,2570916,63.9,125512,4.7
11518,October 1994,Texas,13636878,9459029,69.4,8880061,65.1,578968,6.1
11519,October 1994,Utah,1373008,1000630,72.9,961853,70.1,38777,3.9
11520,October 1994,Vermont,444413,316334,71.2,302452,68.1,13882,4.4
11521,October 1994,Virginia,4938404,3456934,70.0,3297258,66.8,159676,4.6
11522,October 1994,Washington,4061106,2759163,67.9,2586482,63.7,172681,6.3
11523,October 1994,West Virginia,1433836,782676,54.6,719277,50.2,63399,8.1
11524,October 1994,Wisconsin,3874418,2846366,73.5,2726460,70.4,119906,4.2
11525,October 1994,Wyoming,355246,252614,71.1,240808,67.8,11806,4.7
11526,November 1994,Alabama,3239323,2049433,63.3,1927053,59.5,122380,6.0
11527,November 1994,Alaska,411491,303456,73.7,281141,68.3,22315,7.4
11528,November 1994,Arizona,3267244,2161555,66.2,2035017,62.3,126538,5.9
11529,November 1994,Arkansas,1896295,1234320,65.1,1172677,61.8,61643,5.0
11530,November 1994,California,23221400,15242989,65.6,14025994,60.4,1216995,8.0
11531,November 1994,Colorado,2839673,2086652,73.5,2008132,70.7,78520,3.8
11532,November 1994,Connecticut,2549321,1751243,68.7,1652752,64.8,98491,5.6
11533,November 1994,Delaware,548488,384964,70.2,369036,67.3,15928,4.1
11534,November 1994,District of Columbia,461571,307625,66.6,283516,61.4,24109,7.8
11535,November 1994,Florida,11194958,7018794,62.7,6606438,59.0,412356,5.9
11536,November 1994,Georgia,5381642,3627506,67.4,3460802,64.3,166704,4.6
11537,November 1994,Hawaii,862738,585139,67.8,552878,64.1,32261,5.5
11538,November 1994,Idaho,841007,593055,70.5,560435,66.6,32620,5.5
11539,November 1994,Illinois,9010686,6130474,68.0,5813398,64.5,317076,5.2
11540,November 1994,Indiana,4403476,3119559,70.8,2978109,67.6,141450,4.5
11541,November 1994,Iowa,2166358,1587074,73.3,1533053,70.8,54021,3.4
11542,November 1994,Kansas,1907697,1351697,70.9,1285734,67.4,65963,4.9
11543,November 1994,Kentucky,2936937,1844201,62.8,1748410,59.5,95791,5.2
11544,November 1994,Louisiana,3176256,1961217,61.7,1813959,57.1,147258,7.5
11545,November 1994,Maine,953633,623034,65.3,582069,61.0,40965,6.6
11546,November 1994,Maryland,3805656,2697283,70.9,2563436,67.4,133847,5.0
11547,November 1994,Massachusetts,4726414,3218021,68.1,3033524,64.2,184497,5.7
11548,November 1994,Michigan,7248286,4818057,66.5,4564727,63.0,253330,5.3
11549,November 1994,Minnesota,3459418,2576619,74.5,2476092,71.6,100527,3.9
11550,November 1994,Mississippi,1986012,1257906,63.3,1181661,59.5,76245,6.1
11551,November 1994,Missouri,4024312,2837376,70.5,2698750,67.1,138626,4.9
11552,November 1994,Montana,647010,438154,67.7,414723,64.1,23431,5.3
11553,November 1994,Nebraska,1220382,893536,73.2,870315,71.3,23221,2.6
11554,November 1994,Nevada,1183611,822112,69.5,772883,65.3,49229,6.0
11555,November 1994,New Hampshire,871648,627698,72.0,600831,68.9,26867,4.3
11556,November 1994,New Jersey,6172516,4093423,66.3,3828101,62.0,265322,6.5
11557,November 1994,New Mexico,1236522,790943,64.0,740310,59.9,50633,6.4
11558,November 1994,New York,14185772,8666851,61.1,8118839,57.2,548012,6.3
11559,November 1994,North Carolina,5529738,3732654,67.5,3575867,64.7,156787,4.2
11560,November 1994,North Dakota,476247,337549,70.9,325580,68.4,11969,3.5
11561,November 1994,Ohio,8452833,5548433,65.6,5289968,62.6,258465,4.7
11562,November 1994,Oklahoma,2442139,1554565,63.7,1475462,60.4,79103,5.1
11563,November 1994,Oregon,2416959,1657967,68.6,1577490,65.3,80477,4.9
11564,November 1994,Pennsylvania,9362991,5895948,63.0,5546278,59.2,349670,5.9
11565,November 1994,Rhode Island,782807,511502,65.3,477797,61.0,33705,6.6
11566,November 1994,South Carolina,2789700,1845282,66.1,1744156,62.5,101126,5.5
11567,November 1994,South Dakota,532241,382505,71.9,370262,69.6,12243,3.2
11568,November 1994,Tennessee,4030109,2706214,67.1,2582595,64.1,123619,4.6
11569,November 1994,Texas,13658480,9476550,69.4,8910047,65.2,566503,6.0
11570,November 1994,Utah,1376457,1002231,72.8,963548,70.0,38683,3.9
11571,November 1994,Vermont,445438,316798,71.1,303114,68.0,13684,4.3
11572,November 1994,Virginia,4943531,3467404,70.1,3310762,67.0,156642,4.5
11573,November 1994,Washington,4068349,2769677,68.1,2597407,63.8,172270,6.2
11574,November 1994,West Virginia,1433713,782313,54.6,720408,50.2,61905,7.9
11575,November 1994,Wisconsin,3878874,2851171,73.5,2735480,70.5,115691,4.1
11576,November 1994,Wyoming,355267,253198,71.3,241430,68.0,11768,4.6
11577,December 1994,Alabama,3241125,2054089,63.4,1931896,59.6,122193,5.9
11578,December 1994,Alaska,412483,303324,73.5,281127,68.2,22197,7.3
11579,December 1994,Arizona,3279027,2173783,66.3,2050404,62.5,123379,5.7
11580,December 1994,Arkansas,1898706,1236476,65.1,1175675,61.9,60801,4.9
11581,December 1994,California,23225492,15237141,65.6,14043658,60.5,1193483,7.8
11582,December 1994,Colorado,2846650,2094281,73.6,2016502,70.8,77779,3.7
11583,December 1994,Connecticut,2548785,1749922,68.7,1651893,64.8,98029,5.6
11584,December 1994,Delaware,549564,385148,70.1,369581,67.2,15567,4.0
11585,December 1994,District of Columbia,460936,306295,66.5,281859,61.1,24436,8.0
11586,December 1994,Florida,11212313,7027968,62.7,6627758,59.1,400210,5.7
11587,December 1994,Georgia,5391652,3634283,67.4,3471944,64.4,162339,4.5
11588,December 1994,Hawaii,862870,585140,67.8,553303,64.1,31837,5.4
11589,December 1994,Idaho,843008,594287,70.5,561767,66.6,32520,5.5
11590,December 1994,Illinois,9013935,6138463,68.1,5830245,64.7,308218,5.0
11591,December 1994,Indiana,4407043,3128865,71.0,2990586,67.9,138279,4.4
11592,December 1994,Iowa,2167686,1587132,73.2,1533580,70.7,53552,3.4
11593,December 1994,Kansas,1909709,1352848,70.8,1287483,67.4,65365,4.8
11594,December 1994,Kentucky,2938987,1847324,62.9,1752462,59.6,94862,5.1
11595,December 1994,Louisiana,3178278,1963029,61.8,1817679,57.2,145350,7.4
11596,December 1994,Maine,953610,624722,65.5,584566,61.3,40156,6.4
11597,December 1994,Maryland,3808480,2700413,70.9,2568296,67.4,132117,4.9
11598,December 1994,Massachusetts,4728404,3219418,68.1,3037759,64.2,181659,5.6
11599,December 1994,Michigan,7252986,4815589,66.4,4566881,63.0,248708,5.2
11600,December 1994,Minnesota,3463104,2581596,74.5,2482075,71.7,99521,3.9
11601,December 1994,Mississippi,1988113,1257824,63.3,1182349,59.5,75475,6.0
11602,December 1994,Missouri,4026893,2849956,70.8,2711449,67.3,138507,4.9
11603,December 1994,Montana,647976,439015,67.8,415177,64.1,23838,5.4
11604,December 1994,Nebraska,1221625,894987,73.3,872021,71.4,22966,2.6
11605,December 1994,Nevada,1188537,824048,69.3,775225,65.2,48823,5.9
11606,December 1994,New Hampshire,871743,628089,72.0,601613,69.0,26476,4.2
11607,December 1994,New Jersey,6175694,4098206,66.4,3836875,62.1,261331,6.4
11608,December 1994,New Mexico,1238734,792946,64.0,742483,59.9,50463,6.4
11609,December 1994,New York,14185853,8669405,61.1,8130782,57.3,538623,6.2
11610,December 1994,North Carolina,5539225,3738175,67.5,3585889,64.7,152286,4.1
11611,December 1994,North Dakota,476319,337179,70.8,325343,68.3,11836,3.5
11612,December 1994,Ohio,8455763,5549831,65.6,5302904,62.7,246927,4.4
11613,December 1994,Oklahoma,2443327,1555729,63.7,1478876,60.5,76853,4.9
11614,December 1994,Oregon,2421230,1658830,68.5,1579878,65.3,78952,4.8
11615,December 1994,Pennsylvania,9364601,5896696,63.0,5552956,59.3,343740,5.8
11616,December 1994,Rhode Island,782296,511776,65.4,478153,61.1,33623,6.6
11617,December 1994,South Carolina,2792678,1845273,66.1,1747655,62.6,97618,5.3
11618,December 1994,South Dakota,533330,383371,71.9,371355,69.6,12016,3.1
11619,December 1994,Tennessee,4036705,2713893,67.2,2591156,64.2,122737,4.5
11620,December 1994,Texas,13679081,9492061,69.4,8935454,65.3,556607,5.9
11621,December 1994,Utah,1380905,1003593,72.7,965292,69.9,38301,3.8
11622,December 1994,Vermont,445462,317319,71.2,303810,68.2,13509,4.3
11623,December 1994,Virginia,4948659,3474822,70.2,3321048,67.1,153774,4.4
11624,December 1994,Washington,4074592,2779358,68.2,2607115,64.0,172243,6.2
11625,December 1994,West Virginia,1433589,781841,54.5,721215,50.3,60626,7.8
11626,December 1994,Wisconsin,3882329,2855608,73.6,2743629,70.7,111979,3.9
11627,December 1994,Wyoming,355289,253755,71.4,241961,68.1,11794,4.6
11628,January 1995,Alabama,3242927,2057652,63.5,1935169,59.7,122483,6.0
11629,January 1995,Alaska,412474,303073,73.5,281032,68.1,22041,7.3
11630,January 1995,Arizona,3289811,2185082,66.4,2064110,62.7,120972,5.5
11631,January 1995,Arkansas,1900118,1237573,65.1,1177459,62.0,60114,4.9
11632,January 1995,California,23229583,15228773,65.6,14049009,60.5,1179764,7.7
11633,January 1995,Colorado,2853628,2099899,73.6,2022022,70.9,77877,3.7
11634,January 1995,Connecticut,2549248,1747822,68.6,1650118,64.7,97704,5.6
11635,January 1995,Delaware,550640,385415,70.0,370020,67.2,15395,4.0
11636,January 1995,District of Columbia,460302,304974,66.3,280064,60.8,24910,8.2
11637,January 1995,Florida,11231668,7030505,62.6,6640570,59.1,389935,5.5
11638,January 1995,Georgia,5402663,3640453,67.4,3479692,64.4,160761,4.4
11639,January 1995,Hawaii,864001,585249,67.7,553561,64.1,31688,5.4
11640,January 1995,Idaho,845008,595476,70.5,563155,66.6,32321,5.4
11641,January 1995,Illinois,9018184,6147030,68.2,5842877,64.8,304153,4.9
11642,January 1995,Indiana,4410611,3135383,71.1,2997531,68.0,137852,4.4
11643,January 1995,Iowa,2169014,1586432,73.1,1533113,70.7,53319,3.4
11644,January 1995,Kansas,1910721,1353240,70.8,1288674,67.4,64566,4.8
11645,January 1995,Kentucky,2942037,1849725,62.9,1755082,59.7,94643,5.1
11646,January 1995,Louisiana,3180299,1963446,61.7,1819482,57.2,143964,7.3
11647,January 1995,Maine,953587,626577,65.7,587090,61.6,39487,6.3
11648,January 1995,Maryland,3810305,2702822,70.9,2571579,67.5,131243,4.9
11649,January 1995,Massachusetts,4731394,3218615,68.0,3039715,64.2,178900,5.6
11650,January 1995,Michigan,7257686,4813413,66.3,4564838,62.9,248575,5.2
11651,January 1995,Minnesota,3466789,2585994,74.6,2487331,71.7,98663,3.8
11652,January 1995,Mississippi,1990215,1257237,63.2,1182451,59.4,74786,5.9
11653,January 1995,Missouri,4030475,2857777,70.9,2719304,67.5,138473,4.8
11654,January 1995,Montana,648942,439659,67.8,415464,64.0,24195,5.5
11655,January 1995,Nebraska,1222869,896167,73.3,873387,71.4,22780,2.5
11656,January 1995,Nevada,1193462,826043,69.2,777694,65.2,48349,5.9
11657,January 1995,New Hampshire,872839,628594,72.0,602393,69.0,26201,4.2
11658,January 1995,New Jersey,6178872,4101828,66.4,3843110,62.2,258718,6.3
11659,January 1995,New Mexico,1240946,794477,64.0,744180,60.0,50297,6.3
11660,January 1995,New York,14186934,8668788,61.1,8134523,57.3,534265,6.2
11661,January 1995,North Carolina,5548712,3740248,67.4,3590658,64.7,149590,4.0
11662,January 1995,North Dakota,476391,336945,70.7,325287,68.3,11658,3.5
11663,January 1995,Ohio,8459692,5551915,65.6,5310778,62.8,241137,4.3
11664,January 1995,Oklahoma,2444516,1555693,63.6,1480945,60.6,74748,4.8
11665,January 1995,Oregon,2425500,1659955,68.4,1581769,65.2,78186,4.7
11666,January 1995,Pennsylvania,9366211,5896844,63.0,5556847,59.3,339997,5.8
11667,January 1995,Rhode Island,782784,512098,65.4,478441,61.1,33657,6.6
11668,January 1995,South Carolina,2796656,1845119,66.0,1750536,62.6,94583,5.1
11669,January 1995,South Dakota,533419,384168,72.0,372375,69.8,11793,3.1
11670,January 1995,Tennessee,4042300,2719116,67.3,2595079,64.2,124037,4.6
11671,January 1995,Texas,13699683,9504877,69.4,8952868,65.4,552009,5.8
11672,January 1995,Utah,1384354,1004691,72.6,966947,69.8,37744,3.8
11673,January 1995,Vermont,445487,317790,71.3,304413,68.3,13377,4.2
11674,January 1995,Virginia,4953786,3477784,70.2,3325813,67.1,151971,4.4
11675,January 1995,Washington,4081835,2787709,68.3,2614677,64.1,173032,6.2
11676,January 1995,West Virginia,1433466,781292,54.5,721525,50.3,59767,7.6
11677,January 1995,Wisconsin,3886785,2859800,73.6,2750202,70.8,109598,3.8
11678,January 1995,Wyoming,356310,254250,71.4,242369,68.0,11881,4.7
11679,February 1995,Alabama,3244729,2060579,63.5,1937313,59.7,123266,6.0
11680,February 1995,Alaska,413465,302819,73.2,280945,67.9,21874,7.2
11681,February 1995,Arizona,3299595,2195922,66.6,2076346,62.9,119576,5.4
11682,February 1995,Arkansas,1902530,1237595,65.0,1178058,61.9,59537,4.8
11683,February 1995,California,23232675,15221749,65.5,14044498,60.5,1177251,7.7
11684,February 1995,Colorado,2860605,2104241,73.6,2025415,70.8,78826,3.7
11685,February 1995,Connecticut,2548711,1745023,68.5,1647510,64.6,97513,5.6
11686,February 1995,Delaware,551716,385688,69.9,370261,67.1,15427,4.0
11687,February 1995,District of Columbia,459668,303744,66.1,278272,60.5,25472,8.4
11688,February 1995,Florida,11248024,7029552,62.5,6646235,59.1,383317,5.5
11689,February 1995,Georgia,5411674,3647151,67.4,3484568,64.4,162583,4.5
11690,February 1995,Hawaii,864132,585579,67.8,553665,64.1,31914,5.4
11691,February 1995,Idaho,847008,596596,70.4,564483,66.6,32113,5.4
11692,February 1995,Illinois,9020433,6155478,68.2,5850507,64.9,304971,5.0
11693,February 1995,Indiana,4413178,3139472,71.1,2999377,68.0,140095,4.5
11694,February 1995,Iowa,2170342,1585389,73.0,1531895,70.6,53494,3.4
11695,February 1995,Kansas,1912733,1353028,70.7,1289278,67.4,63750,4.7
11696,February 1995,Kentucky,2944086,1851694,62.9,1756438,59.7,95256,5.1
11697,February 1995,Louisiana,3182320,1962983,61.7,1819883,57.2,143100,7.3
11698,February 1995,Maine,953564,628602,65.9,589604,61.8,38998,6.2
11699,February 1995,Maryland,3811130,2704905,71.0,2573363,67.5,131542,4.9
11700,February 1995,Massachusetts,4733384,3216660,68.0,3040132,64.2,176528,5.5
11701,February 1995,Michigan,7262385,4813280,66.3,4560613,62.8,252667,5.2
11702,February 1995,Minnesota,3470474,2590013,74.6,2491849,71.8,98164,3.8
11703,February 1995,Mississippi,1992317,1256336,63.1,1181858,59.3,74478,5.9
11704,February 1995,Missouri,4033056,2862043,71.0,2723224,67.5,138819,4.9
11705,February 1995,Montana,650909,440184,67.6,415716,63.9,24468,5.6
11706,February 1995,Nebraska,1224113,897138,73.3,874354,71.4,22784,2.5
11707,February 1995,Nevada,1199388,828389,69.1,780499,65.1,47890,5.8
11708,February 1995,New Hampshire,873935,629182,72.0,603174,69.0,26008,4.1
11709,February 1995,New Jersey,6181051,4105555,66.4,3847336,62.2,258219,6.3
11710,February 1995,New Mexico,1243159,795482,64.0,745245,59.9,50237,6.3
11711,February 1995,New York,14186015,8665605,61.1,8131282,57.3,534323,6.2
11712,February 1995,North Carolina,5557199,3740826,67.3,3591059,64.6,149767,4.0
11713,February 1995,North Dakota,476463,336963,70.7,325518,68.3,11445,3.4
11714,February 1995,Ohio,8462621,5555847,65.7,5314355,62.8,241492,4.3
11715,February 1995,Oklahoma,2445705,1554891,63.6,1481868,60.6,73023,4.7
11716,February 1995,Oregon,2428771,1661573,68.4,1583301,65.2,78272,4.7
11717,February 1995,Pennsylvania,9367821,5896815,62.9,5557864,59.3,338951,5.7
11718,February 1995,Rhode Island,783272,512243,65.4,478513,61.1,33730,6.6
11719,February 1995,South Carolina,2799634,1845467,65.9,1752891,62.6,92576,5.0
11720,February 1995,South Dakota,534508,384850,72.0,373227,69.8,11623,3.0
11721,February 1995,Tennessee,4047895,2722783,67.3,2595213,64.1,127570,4.7
11722,February 1995,Texas,13719284,9516781,69.4,8963533,65.3,553248,5.8
11723,February 1995,Utah,1388802,1005645,72.4,968511,69.7,37134,3.7
11724,February 1995,Vermont,446511,318185,71.3,304863,68.3,13322,4.2
11725,February 1995,Virginia,4957914,3476917,70.1,3325455,67.1,151462,4.4
11726,February 1995,Washington,4088079,2794905,68.4,2620320,64.1,174585,6.2
11727,February 1995,West Virginia,1433342,780954,54.5,721490,50.3,59464,7.6
11728,February 1995,Wisconsin,3890240,2864093,73.6,2755567,70.8,108526,3.8
11729,February 1995,Wyoming,356332,254644,71.5,242652,68.1,11992,4.7
11730,March 1995,Alabama,3245531,2063237,63.6,1938871,59.7,124366,6.0
11731,March 1995,Alaska,413457,302642,73.2,280936,67.9,21706,7.2
11732,March 1995,Arizona,3310379,2206541,66.7,2087415,63.1,119126,5.4
11733,March 1995,Arkansas,1904942,1236692,64.9,1177624,61.8,59068,4.8
11734,March 1995,California,23234766,15218201,65.5,14034480,60.4,1183721,7.8
11735,March 1995,Colorado,2866583,2108101,73.5,2027665,70.7,80436,3.8
11736,March 1995,Connecticut,2549174,1741784,68.3,1644379,64.5,97405,5.6
11737,March 1995,Delaware,552792,385900,69.8,370291,67.0,15609,4.0
11738,March 1995,District of Columbia,459033,302640,65.9,276620,60.3,26020,8.6
11739,March 1995,Florida,11266379,7027919,62.4,6647001,59.0,380918,5.4
11740,March 1995,Georgia,5421685,3654737,67.4,3487374,64.3,167363,4.6
11741,March 1995,Hawaii,865263,586106,67.7,553615,64.0,32491,5.5
11742,March 1995,Idaho,850008,597638,70.3,565640,66.5,31998,5.4
11743,March 1995,Illinois,9023682,6162415,68.3,5853051,64.9,309364,5.0
11744,March 1995,Indiana,4416745,3141204,71.1,2997461,67.9,143743,4.6
11745,March 1995,Iowa,2172670,1584311,72.9,1530290,70.4,54021,3.4
11746,March 1995,Kansas,1914744,1352389,70.6,1289431,67.3,62958,4.7
11747,March 1995,Kentucky,2946136,1853467,62.9,1756795,59.6,96672,5.2
11748,March 1995,Louisiana,3184342,1961873,61.6,1819472,57.1,142401,7.3
11749,March 1995,Maine,954540,630736,66.1,592064,62.0,38672,6.1
11750,March 1995,Maryland,3812954,2706805,71.0,2573987,67.5,132818,4.9
11751,March 1995,Massachusetts,4736374,3214614,67.9,3039883,64.2,174731,5.4
11752,March 1995,Michigan,7266085,4814908,66.3,4556114,62.7,258794,5.4
11753,March 1995,Minnesota,3474159,2593696,74.7,2495787,71.8,97909,3.8
11754,March 1995,Mississippi,1994419,1255457,62.9,1180644,59.2,74813,6.0
11755,March 1995,Missouri,4035638,2863795,71.0,2724395,67.5,139400,4.9
11756,March 1995,Montana,651875,440652,67.6,415998,63.8,24654,5.6
11757,March 1995,Nebraska,1225357,898086,73.3,875083,71.4,23003,2.6
11758,March 1995,Nevada,1204314,831228,69.0,783718,65.1,47510,5.7
11759,March 1995,New Hampshire,875031,629734,72.0,603874,69.0,25860,4.1
11760,March 1995,New Jersey,6183229,4109807,66.5,3849918,62.3,259889,6.3
11761,March 1995,New Mexico,1245371,796005,63.9,745678,59.9,50327,6.3
11762,March 1995,New York,14185096,8661084,61.1,8123523,57.3,537561,6.2
11763,March 1995,North Carolina,5566686,3741611,67.2,3588915,64.5,152696,4.1
11764,March 1995,North Dakota,477535,337273,70.6,326062,68.3,11211,3.3
11765,March 1995,Ohio,8465551,5562169,65.7,5315303,62.8,246866,4.4
11766,March 1995,Oklahoma,2446894,1553800,63.5,1482016,60.6,71784,4.6
11767,March 1995,Oregon,2433041,1663676,68.4,1584604,65.1,79072,4.8
11768,March 1995,Pennsylvania,9368431,5896760,62.9,5556610,59.3,340150,5.8
11769,March 1995,Rhode Island,782760,512104,65.4,478359,61.1,33745,6.6
11770,March 1995,South Carolina,2802612,1846724,65.9,1754904,62.6,91820,5.0
11771,March 1995,South Dakota,535596,385415,72.0,373873,69.8,11542,3.0
11772,March 1995,Tennessee,4053490,2725676,67.2,2593031,64.0,132645,4.9
11773,March 1995,Texas,13738885,9529224,69.4,8969916,65.3,559308,5.9
11774,March 1995,Utah,1392250,1006574,72.3,970025,69.7,36549,3.6
11775,March 1995,Vermont,446535,318519,71.3,305168,68.3,13351,4.2
11776,March 1995,Virginia,4963042,3473146,70.0,3320996,66.9,152150,4.4
11777,March 1995,Washington,4094322,2801145,68.4,2624336,64.1,176809,6.3
11778,March 1995,West Virginia,1434219,781063,54.5,721299,50.3,59764,7.7
11779,March 1995,Wisconsin,3893696,2868571,73.7,2760321,70.9,108250,3.8
11780,March 1995,Wyoming,357353,254870,71.3,242782,67.9,12088,4.7
11781,April 1995,Alabama,3247333,2065730,63.6,1940081,59.7,125649,6.1
11782,April 1995,Alaska,414448,302618,73.0,281019,67.8,21599,7.1
11783,April 1995,Arizona,3322163,2216498,66.7,2097218,63.1,119280,5.4
11784,April 1995,Arkansas,1906353,1235257,64.8,1176497,61.7,58760,4.8
11785,April 1995,California,23240858,15218092,65.5,14023229,60.3,1194863,7.9
11786,April 1995,Colorado,2873560,2112014,73.5,2029599,70.6,82415,3.9
11787,April 1995,Connecticut,2549637,1738417,68.2,1641140,64.4,97277,5.6
11788,April 1995,Delaware,552868,386030,69.8,370153,67.0,15877,4.1
11789,April 1995,District of Columbia,458399,301654,65.8,275171,60.0,26483,8.8
11790,April 1995,Florida,11284734,7027097,62.3,6644963,58.9,382134,5.4
11791,April 1995,Georgia,5432696,3663194,67.4,3489121,64.2,174073,4.8
11792,April 1995,Hawaii,865394,586677,67.8,553359,63.9,33318,5.7
11793,April 1995,Idaho,852008,598557,70.3,566516,66.5,32041,5.4
11794,April 1995,Illinois,9027931,6166548,68.3,5851199,64.8,315349,5.1
11795,April 1995,Indiana,4421313,3140734,71.0,2993570,67.7,147164,4.7
11796,April 1995,Iowa,2173998,1583317,72.8,1528677,70.3,54640,3.5
11797,April 1995,Kansas,1916756,1351435,70.5,1289259,67.3,62176,4.6
11798,April 1995,Kentucky,2949186,1855213,62.9,1756411,59.6,98802,5.3
11799,April 1995,Louisiana,3186363,1960325,61.5,1818863,57.1,141462,7.2
11800,April 1995,Maine,954517,632953,66.3,594457,62.3,38496,6.1
11801,April 1995,Maryland,3815779,2708520,71.0,2573914,67.5,134606,5.0
11802,April 1995,Massachusetts,4739364,3213019,67.8,3039510,64.1,173509,5.4
11803,April 1995,Michigan,7271785,4816678,66.2,4552397,62.6,264281,5.5
11804,April 1995,Minnesota,3477844,2596775,74.7,2499174,71.9,97601,3.8
11805,April 1995,Mississippi,1996521,1255124,62.9,1179172,59.1,75952,6.1
11806,April 1995,Missouri,4039219,2863976,70.9,2724082,67.4,139894,4.9
11807,April 1995,Montana,652841,441134,67.6,416357,63.8,24777,5.6
11808,April 1995,Nebraska,1226600,899174,73.3,875809,71.4,23365,2.6
11809,April 1995,Nevada,1209239,834551,69.0,787340,65.1,47211,5.7
11810,April 1995,New Hampshire,876126,630182,71.9,604448,69.0,25734,4.1
11811,April 1995,New Jersey,6186407,4114191,66.5,3851167,62.3,263024,6.4
11812,April 1995,New Mexico,1248583,796307,63.8,745739,59.7,50568,6.4
11813,April 1995,New York,14187176,8656628,61.0,8113625,57.2,543003,6.3
11814,April 1995,North Carolina,5577173,3743134,67.1,3586001,64.3,157133,4.2
11815,April 1995,North Dakota,477607,337864,70.7,326877,68.4,10987,3.3
11816,April 1995,Ohio,8469480,5570600,65.8,5315273,62.8,255327,4.6
11817,April 1995,Oklahoma,2449083,1552825,63.4,1481723,60.5,71102,4.6
11818,April 1995,Oregon,2437312,1665880,68.3,1585710,65.1,80170,4.8
11819,April 1995,Pennsylvania,9371041,5896904,62.9,5554135,59.3,342769,5.8
11820,April 1995,Rhode Island,783249,511748,65.3,478099,61.0,33649,6.6
11821,April 1995,South Carolina,2805590,1848900,65.9,1756747,62.6,92153,5.0
11822,April 1995,South Dakota,535685,385929,72.0,374375,69.9,11554,3.0
11823,April 1995,Tennessee,4059085,2728294,67.2,2589893,63.8,138401,5.1
11824,April 1995,Texas,13760487,9542504,69.3,8974183,65.2,568321,6.0
11825,April 1995,Utah,1396699,1007653,72.1,971593,69.6,36060,3.6
11826,April 1995,Vermont,446560,318819,71.4,305378,68.4,13441,4.2
11827,April 1995,Virginia,4968169,3467285,69.8,3313583,66.7,153702,4.4
11828,April 1995,Washington,4101565,2806498,68.4,2627100,64.1,179398,6.4
11829,April 1995,West Virginia,1434095,781678,54.5,721110,50.3,60568,7.7
11830,April 1995,Wisconsin,3897151,2872991,73.7,2764785,70.9,108206,3.8
11831,April 1995,Wyoming,357375,254949,71.3,242788,67.9,12161,4.8
11832,May 1995,Alabama,3249135,2068167,63.7,1941298,59.7,126869,6.1
11833,May 1995,Alaska,414440,302812,73.1,281209,67.9,21603,7.1
11834,May 1995,Arizona,3332946,2225584,66.8,2105982,63.2,119602,5.4
11835,May 1995,Arkansas,1908765,1234006,64.6,1175349,61.6,58657,4.8
11836,May 1995,California,23244949,15222611,65.5,14016852,60.3,1205759,7.9
11837,May 1995,Colorado,2880538,2116444,73.5,2032023,70.5,84421,4.0
11838,May 1995,Connecticut,2549100,1735309,68.1,1638287,64.3,97022,5.6
11839,May 1995,Delaware,553944,386099,69.7,369937,66.8,16162,4.2
11840,May 1995,District of Columbia,457764,300800,65.7,273989,59.9,26811,8.9
11841,May 1995,Florida,11303089,7029365,62.2,6643612,58.8,385753,5.5
11842,May 1995,Georgia,5442707,3672460,67.5,3491538,64.2,180922,4.9
11843,May 1995,Hawaii,866525,587123,67.8,552872,63.8,34251,5.8
11844,May 1995,Idaho,854008,599317,70.2,567127,66.4,32190,5.4
11845,May 1995,Illinois,9031180,6168412,68.3,5848054,64.8,320358,5.2
11846,May 1995,Indiana,4423880,3138922,71.0,2990075,67.6,148847,4.7
11847,May 1995,Iowa,2175327,1582795,72.8,1527695,70.2,55100,3.5
11848,May 1995,Kansas,1917768,1350543,70.4,1289146,67.2,61397,4.5
11849,May 1995,Kentucky,2952236,1856981,62.9,1755776,59.5,101205,5.4
11850,May 1995,Louisiana,3188384,1958881,61.4,1818921,57.0,139960,7.1
11851,May 1995,Maine,954494,635190,66.5,596815,62.5,38375,6.0
11852,May 1995,Maryland,3817604,2710114,71.0,2573754,67.4,136360,5.0
11853,May 1995,Massachusetts,4742354,3212440,67.7,3039754,64.1,172686,5.4
11854,May 1995,Michigan,7276485,4817370,66.2,4550729,62.5,266641,5.5
11855,May 1995,Minnesota,3481529,2599328,74.7,2502265,71.9,97063,3.7
11856,May 1995,Mississippi,1998623,1255805,62.8,1178160,58.9,77645,6.2
11857,May 1995,Missouri,4042801,2864118,70.8,2724036,67.4,140082,4.9
11858,May 1995,Montana,653807,441752,67.6,416883,63.8,24869,5.6
11859,May 1995,Nebraska,1227844,900471,73.3,876690,71.4,23781,2.6
11860,May 1995,Nevada,1214165,838290,69.0,791327,65.2,46963,5.6
11861,May 1995,New Hampshire,877222,630578,71.9,604972,69.0,25606,4.1
11862,May 1995,New Jersey,6189585,4118462,66.5,3852248,62.2,266214,6.5
11863,May 1995,New Mexico,1250795,796725,63.7,745771,59.6,50954,6.4
11864,May 1995,New York,14187257,8654154,61.0,8105053,57.1,549101,6.3
11865,May 1995,North Carolina,5585660,3746215,67.1,3584799,64.2,161416,4.3
11866,May 1995,North Dakota,477679,338680,70.9,327864,68.6,10816,3.2
11867,May 1995,Ohio,8473410,5580164,65.9,5315834,62.7,264330,4.7
11868,May 1995,Oklahoma,2450271,1552573,63.4,1481555,60.5,71018,4.6
11869,May 1995,Oregon,2440582,1668127,68.3,1586973,65.0,81154,4.9
11870,May 1995,Pennsylvania,9372651,5898056,62.9,5552511,59.2,345545,5.9
11871,May 1995,Rhode Island,783737,511342,65.2,477939,61.0,33403,6.5
11872,May 1995,South Carolina,2808568,1851884,65.9,1758642,62.6,93242,5.0
11873,May 1995,South Dakota,536774,386436,72.0,374819,69.8,11617,3.0
11874,May 1995,Tennessee,4065680,2731349,67.2,2587458,63.6,143891,5.3
11875,May 1995,Texas,13781088,9557531,69.4,8979518,65.2,578013,6.0
11876,May 1995,Utah,1400147,1009063,72.1,973365,69.5,35698,3.5
11877,May 1995,Vermont,447584,319135,71.3,305574,68.3,13561,4.2
11878,May 1995,Virginia,4972297,3460886,69.6,3305287,66.5,155599,4.5
11879,May 1995,Washington,4108808,2810903,68.4,2629235,64.0,181668,6.5
11880,May 1995,West Virginia,1433972,782738,54.6,721151,50.3,61587,7.9
11881,May 1995,Wisconsin,3901607,2877219,73.7,2769263,71.0,107956,3.8
11882,May 1995,Wyoming,358396,255002,71.2,242788,67.7,12214,4.8
11883,June 1995,Alabama,3250938,2070177,63.7,1942725,59.8,127452,6.2
11884,June 1995,Alaska,415431,303239,73.0,281509,67.8,21730,7.2
11885,June 1995,Arizona,3343730,2233479,66.8,2113832,63.2,119647,5.4
11886,June 1995,Arkansas,1911177,1233709,64.6,1174929,61.5,58780,4.8
11887,June 1995,California,23251041,15232334,65.5,14019657,60.3,1212677,8.0
11888,June 1995,Colorado,2887515,2121617,73.5,2035485,70.5,86132,4.1
11889,June 1995,Connecticut,2549563,1732659,68.0,1636205,64.2,96454,5.6
11890,June 1995,Delaware,555020,386127,69.6,369712,66.6,16415,4.3
11891,June 1995,District of Columbia,457130,300081,65.6,273103,59.7,26978,9.0
11892,June 1995,Florida,11322444,7035498,62.1,6645518,58.7,389980,5.5
11893,June 1995,Georgia,5452718,3682026,67.5,3495898,64.1,186128,5.1
11894,June 1995,Hawaii,866657,587287,67.8,552189,63.7,35098,6.0
11895,June 1995,Idaho,856008,600035,70.1,567632,66.3,32403,5.4
11896,June 1995,Illinois,9035428,6169533,68.3,5847071,64.7,322462,5.2
11897,June 1995,Indiana,4428448,3136886,70.8,2988599,67.5,148287,4.7
11898,June 1995,Iowa,2176655,1583202,72.7,1527896,70.2,55306,3.5
11899,June 1995,Kansas,1919780,1349848,70.3,1289328,67.2,60520,4.5
11900,June 1995,Kentucky,2954286,1858667,62.9,1755323,59.4,103344,5.6
11901,June 1995,Louisiana,3191405,1957818,61.3,1820063,57.0,137755,7.0
11902,June 1995,Maine,955471,637364,66.7,599145,62.7,38219,6.0
11903,June 1995,Maryland,3819428,2711693,71.0,2573988,67.4,137705,5.1
11904,June 1995,Massachusetts,4745344,3212984,67.7,3041126,64.1,171858,5.3
11905,June 1995,Michigan,7281184,4816465,66.1,4551474,62.5,264991,5.5
11906,June 1995,Minnesota,3486214,2601710,74.6,2505429,71.9,96281,3.7
11907,June 1995,Mississippi,2000725,1257535,62.9,1178191,58.9,79344,6.3
11908,June 1995,Missouri,4046383,2864649,70.8,2725269,67.4,139380,4.9
11909,June 1995,Montana,655774,442582,67.5,417591,63.7,24991,5.6
11910,June 1995,Nebraska,1230088,901878,73.3,877755,71.4,24123,2.7
11911,June 1995,Nevada,1220090,842284,69.0,795543,65.2,46741,5.5
11912,June 1995,New Hampshire,878318,630969,71.8,605547,68.9,25422,4.0
11913,June 1995,New Jersey,6192764,4122382,66.6,3854259,62.2,268123,6.5
11914,June 1995,New Mexico,1253008,797504,63.6,746022,59.5,51482,6.5
11915,June 1995,New York,14188338,8654069,61.0,8100273,57.1,553796,6.4
11916,June 1995,North Carolina,5596148,3751445,67.0,3587160,64.1,164285,4.4
11917,June 1995,North Dakota,477751,339650,71.1,328909,68.8,10741,3.2
11918,June 1995,Ohio,8477339,5589736,65.9,5317856,62.7,271880,4.9
11919,June 1995,Oklahoma,2451460,1553350,63.4,1481992,60.5,71358,4.6
11920,June 1995,Oregon,2444853,1670402,68.3,1588627,65.0,81775,4.9
11921,June 1995,Pennsylvania,9374261,5901019,62.9,5553542,59.2,347477,5.9
11922,June 1995,Rhode Island,783225,511006,65.2,478014,61.0,32992,6.5
11923,June 1995,South Carolina,2812546,1855284,66.0,1760584,62.6,94700,5.1
11924,June 1995,South Dakota,536863,386991,72.1,375298,69.9,11693,3.0
11925,June 1995,Tennessee,4071275,2734622,67.2,2586680,63.5,147942,5.4
11926,June 1995,Texas,13802689,9574102,69.4,8987870,65.1,586232,6.1
11927,June 1995,Utah,1404596,1010865,72.0,975427,69.4,35438,3.5
11928,June 1995,Vermont,447608,319517,71.4,305822,68.3,13695,4.3
11929,June 1995,Virginia,4978425,3455196,69.4,3297824,66.2,157372,4.6
11930,June 1995,Washington,4116051,2814027,68.4,2630862,63.9,183165,6.5
11931,June 1995,West Virginia,1433848,784072,54.7,721537,50.3,62535,8.0
11932,June 1995,Wisconsin,3905062,2881281,73.8,2773790,71.0,107491,3.7
11933,June 1995,Wyoming,358418,255110,71.2,242846,67.8,12264,4.8
11934,July 1995,Alabama,3252740,2071540,63.7,1944371,59.8,127169,6.1
11935,July 1995,Alaska,416422,303844,73.0,281875,67.7,21969,7.2
11936,July 1995,Arizona,3354514,2239869,66.8,2120606,63.2,119263,5.3
11937,July 1995,Arkansas,1913589,1234815,64.5,1175685,61.4,59130,4.8
11938,July 1995,California,23257132,15245982,65.6,14031628,60.3,1214354,8.0
11939,July 1995,Colorado,2895493,2127527,73.5,2040160,70.5,87367,4.1
11940,July 1995,Connecticut,2550026,1730597,67.9,1635123,64.1,95474,5.5
11941,July 1995,Delaware,556097,386105,69.4,369485,66.4,16620,4.3
11942,July 1995,District of Columbia,456496,299491,65.6,272502,59.7,26989,9.0
11943,July 1995,Florida,11341800,7044713,62.1,6651054,58.6,393659,5.6
11944,July 1995,Georgia,5463729,3691197,67.6,3502330,64.1,188867,5.1
11945,July 1995,Hawaii,867788,587091,67.7,551425,63.5,35666,6.1
11946,July 1995,Idaho,859008,600835,69.9,568195,66.1,32640,5.4
11947,July 1995,Illinois,9039677,6172104,68.3,5849867,64.7,322237,5.2
11948,July 1995,Indiana,4432015,3135418,70.7,2989256,67.4,146162,4.7
11949,July 1995,Iowa,2178983,1584653,72.7,1529384,70.2,55269,3.5
11950,July 1995,Kansas,1921792,1349314,70.2,1289882,67.1,59432,4.4
11951,July 1995,Kentucky,2957335,1859800,62.9,1755169,59.3,104631,5.6
11952,July 1995,Louisiana,3193427,1957183,61.3,1821972,57.1,135211,6.9
11953,July 1995,Maine,955448,639351,66.9,601318,62.9,38033,5.9
11954,July 1995,Maryland,3822253,2713067,71.0,2574774,67.4,138293,5.1
11955,July 1995,Massachusetts,4748335,3214255,67.7,3043557,64.1,170698,5.3
11956,July 1995,Michigan,7286884,4814355,66.1,4554084,62.5,260271,5.4
11957,July 1995,Minnesota,3489899,2604297,74.6,2508775,71.9,95522,3.7
11958,July 1995,Mississippi,2003827,1259815,62.9,1179183,58.8,80632,6.4
11959,July 1995,Missouri,4049964,2865249,70.7,2727889,67.4,137360,4.8
11960,July 1995,Montana,656740,443562,67.5,418378,63.7,25184,5.7
11961,July 1995,Nebraska,1231332,903210,73.4,878887,71.4,24323,2.7
11962,July 1995,Nevada,1225016,846279,69.1,799715,65.3,46564,5.5
11963,July 1995,New Hampshire,879413,631369,71.8,606241,68.9,25128,4.0
11964,July 1995,New Jersey,6195942,4125828,66.6,3857454,62.3,268374,6.5
11965,July 1995,New Mexico,1255220,798683,63.6,746530,59.5,52153,6.5
11966,July 1995,New York,14190419,8656212,61.0,8099536,57.1,556676,6.4
11967,July 1995,North Carolina,5605635,3758905,67.1,3593380,64.1,165525,4.4
11968,July 1995,North Dakota,478823,340682,71.1,329925,68.9,10757,3.2
11969,July 1995,Ohio,8482268,5598452,66.0,5321259,62.7,277193,5.0
11970,July 1995,Oklahoma,2453649,1554833,63.4,1483161,60.4,71672,4.6
11971,July 1995,Oregon,2449123,1672732,68.3,1590648,64.9,82084,4.9
11972,July 1995,Pennsylvania,9376871,5906086,63.0,5557790,59.3,348296,5.9
11973,July 1995,Rhode Island,783713,510831,65.2,478360,61.0,32471,6.4
11974,July 1995,South Carolina,2815524,1858814,66.0,1762503,62.6,96311,5.2
11975,July 1995,South Dakota,537952,387620,72.1,375846,69.9,11774,3.0
11976,July 1995,Tennessee,4077870,2737424,67.1,2587727,63.5,149697,5.5
11977,July 1995,Texas,13824291,9591059,69.4,8999216,65.1,591843,6.2
11978,July 1995,Utah,1408044,1012954,71.9,977759,69.4,35195,3.5
11979,July 1995,Vermont,448633,319949,71.3,306127,68.2,13822,4.3
11980,July 1995,Virginia,4983552,3450232,69.2,3291725,66.1,158507,4.6
11981,July 1995,Washington,4123295,2815922,68.3,2632082,63.8,183840,6.5
11982,July 1995,West Virginia,1434725,785351,54.7,722236,50.3,63115,8.0
11983,July 1995,Wisconsin,3909518,2885176,73.8,2777957,71.1,107219,3.7
11984,July 1995,Wyoming,358439,255290,71.2,242968,67.8,12322,4.8
11985,August 1995,Alabama,3256542,2071980,63.6,1946204,59.8,125776,6.1
11986,August 1995,Alaska,416414,304540,73.1,282249,67.8,22291,7.3
11987,August 1995,Arizona,3364298,2244541,66.7,2125845,63.2,118696,5.3
11988,August 1995,Arkansas,1916001,1237244,64.6,1177585,61.5,59659,4.8
11989,August 1995,California,23274224,15259718,65.6,14048415,60.4,1211303,7.9
11990,August 1995,Colorado,2901470,2133672,73.5,2045503,70.5,88169,4.1
11991,August 1995,Connecticut,2550489,1729141,67.8,1634844,64.1,94297,5.5
11992,August 1995,Delaware,557173,386024,69.3,369184,66.3,16840,4.4
11993,August 1995,District of Columbia,455861,298945,65.6,272077,59.7,26868,9.0
11994,August 1995,Florida,11362155,7054662,62.1,6658902,58.6,395760,5.6
11995,August 1995,Georgia,5475739,3699090,67.6,3510115,64.1,188975,5.1
11996,August 1995,Hawaii,868919,586645,67.5,550742,63.4,35903,6.1
11997,August 1995,Idaho,860009,601733,70.0,568948,66.2,32785,5.4
11998,August 1995,Illinois,9045926,6176998,68.3,5855541,64.7,321457,5.2
11999,August 1995,Indiana,4436582,3134524,70.7,2990658,67.4,143866,4.6
12000,August 1995,Iowa,2180311,1586799,72.8,1531786,70.3,55013,3.5
12001,August 1995,Kansas,1923803,1348734,70.1,1290628,67.1,58106,4.3
12002,August 1995,Kentucky,2960385,1859790,62.8,1755018,59.3,104772,5.6
12003,August 1995,Louisiana,3196448,1956903,61.2,1823885,57.1,133018,6.8
12004,August 1995,Maine,956425,641047,67.0,603302,63.1,37745,5.9
12005,August 1995,Maryland,3825078,2713931,71.0,2575569,67.3,138362,5.1
12006,August 1995,Massachusetts,4751325,3215482,67.7,3046416,64.1,169066,5.3
12007,August 1995,Michigan,7294584,4811726,66.0,4557646,62.5,254080,5.3
12008,August 1995,Minnesota,3494584,2607286,74.6,2512192,71.9,95094,3.6
12009,August 1995,Mississippi,2005929,1261710,62.9,1180556,58.9,81154,6.4
12010,August 1995,Missouri,4053546,2865384,70.7,2731017,67.4,134367,4.7
12011,August 1995,Montana,657706,444555,67.6,419118,63.7,25437,5.7
12012,August 1995,Nebraska,1232575,904382,73.4,880007,71.4,24375,2.7
12013,August 1995,Nevada,1230942,850080,69.1,803625,65.3,46455,5.5
12014,August 1995,New Hampshire,880509,631817,71.8,607069,68.9,24748,3.9
12015,August 1995,New Jersey,6201120,4128540,66.6,3861188,62.3,267352,6.5
12016,August 1995,New Mexico,1258432,800123,63.6,747147,59.4,52976,6.6
12017,August 1995,New York,14195500,8659665,61.0,8101908,57.1,557757,6.4
12018,August 1995,North Carolina,5616122,3768177,67.1,3602043,64.1,166134,4.4
12019,August 1995,North Dakota,478895,341663,71.3,330865,69.1,10798,3.2
12020,August 1995,Ohio,8486198,5605560,66.1,5324796,62.7,280764,5.0
12021,August 1995,Oklahoma,2455838,1556443,63.4,1484825,60.5,71618,4.6
12022,August 1995,Oregon,2454394,1675245,68.3,1592912,64.9,82333,4.9
12023,August 1995,Pennsylvania,9380481,5912285,63.0,5563618,59.3,348667,5.9
12024,August 1995,Rhode Island,784202,510780,65.1,478904,61.1,31876,6.2
12025,August 1995,South Carolina,2818502,1862152,66.1,1764262,62.6,97890,5.3
12026,August 1995,South Dakota,539041,388264,72.0,376428,69.8,11836,3.0
12027,August 1995,Tennessee,4084465,2738908,67.1,2589821,63.4,149087,5.4
12028,August 1995,Texas,13846892,9606369,69.4,9011574,65.1,594795,6.2
12029,August 1995,Utah,1412493,1015155,71.9,980279,69.4,34876,3.4
12030,August 1995,Vermont,448657,320401,71.4,306490,68.3,13911,4.3
12031,August 1995,Virginia,4989680,3445173,69.0,3286146,65.9,159027,4.6
12032,August 1995,Washington,4129538,2817269,68.2,2633110,63.8,184159,6.5
12033,August 1995,West Virginia,1434601,786459,54.8,723165,50.4,63294,8.0
12034,August 1995,Wisconsin,3913973,2888842,73.8,2781382,71.1,107460,3.7
12035,August 1995,Wyoming,359461,255532,71.1,243155,67.6,12377,4.8
12036,September 1995,Alabama,3259344,2071273,63.5,1948061,59.8,123212,5.9
12037,September 1995,Alaska,417405,305218,73.1,282572,67.7,22646,7.4
12038,September 1995,Arizona,3374082,2247714,66.6,2129366,63.1,118348,5.3
12039,September 1995,Arkansas,1918412,1240309,64.7,1180034,61.5,60275,4.9
12040,September 1995,California,23292316,15270532,65.6,14064877,60.4,1205655,7.9
12041,September 1995,Colorado,2908448,2139306,73.6,2050601,70.5,88705,4.1
12042,September 1995,Connecticut,2551952,1728095,67.7,1634921,64.1,93174,5.4
12043,September 1995,Delaware,558249,385892,69.1,368740,66.1,17152,4.4
12044,September 1995,District of Columbia,456227,298322,65.4,271700,59.6,26622,8.9
12045,September 1995,Florida,11383510,7063035,62.0,6667219,58.6,395816,5.6
12046,September 1995,Georgia,5486750,3705241,67.5,3518423,64.1,186818,5.0
12047,September 1995,Hawaii,869050,586262,67.5,550338,63.3,35924,6.1
12048,September 1995,Idaho,862009,602779,69.9,569931,66.1,32848,5.4
12049,September 1995,Illinois,9052175,6183530,68.3,5861723,64.8,321807,5.2
12050,September 1995,Indiana,4441150,3133643,70.6,2990971,67.3,142672,4.6
12051,September 1995,Iowa,2181639,1589182,72.8,1534435,70.3,54747,3.4
12052,September 1995,Kansas,1925815,1347931,70.0,1291221,67.0,56710,4.2
12053,September 1995,Kentucky,2963435,1858686,62.7,1754667,59.2,104019,5.6
12054,September 1995,Louisiana,3198469,1956941,61.2,1825221,57.1,131720,6.7
12055,September 1995,Maine,956401,642499,67.2,605182,63.3,37317,5.8
12056,September 1995,Maryland,3828902,2714213,70.9,2575751,67.3,138462,5.1
12057,September 1995,Massachusetts,4754315,3216059,67.6,3049070,64.1,166989,5.2
12058,September 1995,Michigan,7302284,4809222,65.9,4561475,62.5,247747,5.2
12059,September 1995,Minnesota,3499269,2610669,74.6,2515478,71.9,95191,3.6
12060,September 1995,Mississippi,2008030,1262550,62.9,1181620,58.8,80930,6.4
12061,September 1995,Missouri,4058127,2864907,70.6,2733807,67.4,131100,4.6
12062,September 1995,Montana,658673,445316,67.6,419698,63.7,25618,5.8
12063,September 1995,Nebraska,1233819,905456,73.4,881062,71.4,24394,2.7
12064,September 1995,Nevada,1235867,853603,69.1,807235,65.3,46368,5.4
12065,September 1995,New Hampshire,882605,632337,71.6,607974,68.9,24363,3.9
12066,September 1995,New Jersey,6206298,4130493,66.6,3864736,62.3,265757,6.4
12067,September 1995,New Mexico,1260644,801645,63.6,747677,59.3,53968,6.7
12068,September 1995,New York,14200581,8662646,61.0,8106073,57.1,556573,6.4
12069,September 1995,North Carolina,5627609,3778597,67.1,3611539,64.2,167058,4.4
12070,September 1995,North Dakota,479967,342538,71.4,331734,69.1,10804,3.2
12071,September 1995,Ohio,8491127,5610804,66.1,5327515,62.7,283289,5.0
12072,September 1995,Oklahoma,2459027,1557928,63.4,1486605,60.5,71323,4.6
12073,September 1995,Oregon,2458664,1678210,68.3,1595277,64.9,82933,4.9
12074,September 1995,Pennsylvania,9385091,5918235,63.1,5568915,59.3,349320,5.9
12075,September 1995,Rhode Island,784690,510760,65.1,479515,61.1,31245,6.1
12076,September 1995,South Carolina,2822480,1864868,66.1,1765616,62.6,99252,5.3
12077,September 1995,South Dakota,539129,388874,72.1,376986,69.9,11888,3.1
12078,September 1995,Tennessee,4091060,2739091,67.0,2592010,63.4,147081,5.4
12079,September 1995,Texas,13869493,9618449,69.3,9022864,65.1,595585,6.2
12080,September 1995,Utah,1416941,1017351,71.8,982839,69.4,34512,3.4
12081,September 1995,Vermont,449682,320866,71.4,306917,68.3,13949,4.3
12082,September 1995,Virginia,4996808,3439224,68.8,3279997,65.6,159227,4.6
12083,September 1995,Washington,4135781,2818658,68.2,2634294,63.7,184364,6.5
12084,September 1995,West Virginia,1435478,787469,54.9,724188,50.4,63281,8.0
12085,September 1995,Wisconsin,3918429,2892414,73.8,2783948,71.0,108466,3.8
12086,September 1995,Wyoming,359482,255770,71.1,243380,67.7,12390,4.8
12087,October 1995,Alabama,3263146,2069833,63.4,1949801,59.8,120032,5.8
12088,October 1995,Alaska,417396,305806,73.3,282827,67.8,22979,7.5
12089,October 1995,Arizona,3384865,2250174,66.5,2131655,63.0,118519,5.3
12090,October 1995,Arkansas,1920824,1243190,64.7,1182297,61.6,60893,4.9
12091,October 1995,California,23311407,15277933,65.5,14077484,60.4,1200449,7.9
12092,October 1995,Colorado,2915425,2143813,73.5,2054614,70.5,89199,4.2
12093,October 1995,Connecticut,2553415,1727298,67.6,1634985,64.0,92313,5.3
12094,October 1995,Delaware,558325,385744,69.1,368130,65.9,17614,4.6
12095,October 1995,District of Columbia,455592,297669,65.3,271370,59.6,26299,8.8
12096,October 1995,Florida,11405865,7069141,62.0,6674603,58.5,394538,5.6
12097,October 1995,Georgia,5498761,3709988,67.5,3526512,64.1,183476,4.9
12098,October 1995,Hawaii,870181,586287,67.4,550383,63.2,35904,6.1
12099,October 1995,Idaho,864009,603967,69.9,571062,66.1,32905,5.4
12100,October 1995,Illinois,9059424,6190234,68.3,5866491,64.8,323743,5.2
12101,October 1995,Indiana,4446717,3131750,70.4,2989006,67.2,142744,4.6
12102,October 1995,Iowa,2182967,1591482,72.9,1536746,70.4,54736,3.4
12103,October 1995,Kansas,1927827,1347051,69.9,1291462,67.0,55589,4.1
12104,October 1995,Kentucky,2966485,1856883,62.6,1754054,59.1,102829,5.5
12105,October 1995,Louisiana,3201491,1957394,61.1,1825841,57.0,131553,6.7
12106,October 1995,Maine,957378,643886,67.3,607057,63.4,36829,5.7
12107,October 1995,Maryland,3833727,2714218,70.8,2575229,67.2,138989,5.1
12108,October 1995,Massachusetts,4758305,3215872,67.6,3051280,64.1,164592,5.1
12109,October 1995,Michigan,7309984,4807930,65.8,4565380,62.5,242550,5.0
12110,October 1995,Minnesota,3504954,2614576,74.6,2518567,71.9,96009,3.7
12111,October 1995,Mississippi,2010132,1262245,62.8,1181887,58.8,80358,6.4
12112,October 1995,Missouri,4061709,2864254,70.5,2735770,67.4,128484,4.5
12113,October 1995,Montana,659639,445699,67.6,420087,63.7,25612,5.7
12114,October 1995,Nebraska,1236063,906534,73.3,882033,71.4,24501,2.7
12115,October 1995,Nevada,1241793,856786,69.0,810511,65.3,46275,5.4
12116,October 1995,New Hampshire,883701,632872,71.6,608838,68.9,24034,3.8
12117,October 1995,New Jersey,6211476,4132549,66.5,3867877,62.3,264672,6.4
12118,October 1995,New Mexico,1262856,803042,63.6,747987,59.2,55055,6.9
12119,October 1995,New York,14207662,8664429,61.0,8110815,57.1,553614,6.4
12120,October 1995,North Carolina,5638096,3789610,67.2,3620972,64.2,168638,4.5
12121,October 1995,North Dakota,480039,343297,71.5,332543,69.3,10754,3.1
12122,October 1995,Ohio,8497056,5614038,66.1,5328824,62.7,285214,5.1
12123,October 1995,Oklahoma,2462215,1559133,63.3,1488270,60.4,70863,4.5
12124,October 1995,Oregon,2463935,1681904,68.3,1597670,64.8,84234,5.0
12125,October 1995,Pennsylvania,9389701,5923069,63.1,5572622,59.3,350447,5.9
12126,October 1995,Rhode Island,785178,510794,65.1,480126,61.1,30668,6.0
12127,October 1995,South Carolina,2825458,1866870,66.1,1766491,62.5,100379,5.4
12128,October 1995,South Dakota,540218,389408,72.1,377434,69.9,11974,3.1
12129,October 1995,Tennessee,4098655,2738695,66.8,2593827,63.3,144868,5.3
12130,October 1995,Texas,13894095,9627113,69.3,9032047,65.0,595066,6.2
12131,October 1995,Utah,1420389,1019434,71.8,985194,69.4,34240,3.4
12132,October 1995,Vermont,449706,321318,71.5,307385,68.4,13933,4.3
12133,October 1995,Virginia,5003935,3431794,68.6,3272666,65.4,159128,4.6
12134,October 1995,Washington,4142024,2820556,68.1,2636170,63.6,184386,6.5
12135,October 1995,West Virginia,1435354,788383,54.9,725158,50.5,63225,8.0
12136,October 1995,Wisconsin,3922884,2896035,73.8,2786090,71.0,109945,3.8
12137,October 1995,Wyoming,360504,255958,71.0,243598,67.6,12360,4.8
12138,November 1995,Alabama,3265948,2068153,63.3,1951379,59.7,116774,5.6
12139,November 1995,Alaska,417388,306340,73.4,283055,67.8,23285,7.6
12140,November 1995,Arizona,3393649,2252294,66.4,2133203,62.9,119091,5.3
12141,November 1995,Arkansas,1923236,1245323,64.8,1183791,61.6,61532,4.9
12142,November 1995,California,23325499,15280783,65.5,14085584,60.4,1195199,7.8
12143,November 1995,Colorado,2922403,2146808,73.5,2057165,70.4,89643,4.2
12144,November 1995,Connecticut,2553878,1726701,67.6,1634945,64.0,91756,5.3
12145,November 1995,Delaware,559401,385634,68.9,367434,65.7,18200,4.7
12146,November 1995,District of Columbia,454958,296914,65.3,270959,59.6,25955,8.7
12147,November 1995,Florida,11426221,7072625,61.9,6681065,58.5,391560,5.5
12148,November 1995,Georgia,5509772,3713490,67.4,3534185,64.1,179305,4.8
12149,November 1995,Hawaii,871312,586903,67.4,550912,63.2,35991,6.1
12150,November 1995,Idaho,866009,605260,69.9,572259,66.1,33001,5.5
12151,November 1995,Illinois,9064673,6194979,68.3,5869321,64.7,325658,5.3
12152,November 1995,Indiana,4450284,3127663,70.3,2984720,67.1,142943,4.6
12153,November 1995,Iowa,2184295,1593528,73.0,1538521,70.4,55007,3.5
12154,November 1995,Kansas,1928839,1346323,69.8,1291394,67.0,54929,4.1
12155,November 1995,Kentucky,2969534,1854845,62.5,1753225,59.0,101620,5.5
12156,November 1995,Louisiana,3203512,1958230,61.1,1826129,57.0,132101,6.7
12157,November 1995,Maine,958355,645391,67.3,609027,63.5,36364,5.6
12158,November 1995,Maryland,3836552,2714176,70.7,2574419,67.1,139757,5.1
12159,November 1995,Massachusetts,4761295,3215081,67.5,3053214,64.1,161867,5.0
12160,November 1995,Michigan,7316683,4808112,65.7,4569466,62.5,238646,5.0
12161,November 1995,Minnesota,3509639,2619111,74.6,2521491,71.8,97620,3.7
12162,November 1995,Mississippi,2012234,1261022,62.7,1181397,58.7,79625,6.3
12163,November 1995,Missouri,4065290,2864012,70.5,2736952,67.3,127060,4.4
12164,November 1995,Montana,660605,445906,67.5,420411,63.6,25495,5.7
12165,November 1995,Nebraska,1237307,907626,73.4,882935,71.4,24691,2.7
12166,November 1995,Nevada,1246719,859721,69.0,813579,65.3,46142,5.4
12167,November 1995,New Hampshire,884796,633337,71.6,609530,68.9,23807,3.8
12168,November 1995,New Jersey,6215655,4135262,66.5,3870707,62.3,264555,6.4
12169,November 1995,New Mexico,1265069,804225,63.6,748114,59.1,56111,7.0
12170,November 1995,New York,14210743,8665220,61.0,8115847,57.1,549373,6.3
12171,November 1995,North Carolina,5648583,3800611,67.3,3630068,64.3,170543,4.5
12172,November 1995,North Dakota,480111,343944,71.6,333262,69.4,10682,3.1
12173,November 1995,Ohio,8499986,5614589,66.1,5328667,62.7,285922,5.1
12174,November 1995,Oklahoma,2464404,1560032,63.3,1489863,60.5,70169,4.5
12175,November 1995,Oregon,2468205,1686419,68.3,1600190,64.8,86229,5.1
12176,November 1995,Pennsylvania,9392311,5926351,63.1,5575087,59.4,351264,5.9
12177,November 1995,Rhode Island,785666,510914,65.0,480717,61.2,30197,5.9
12178,November 1995,South Carolina,2828436,1868198,66.1,1766918,62.5,101280,5.4
12179,November 1995,South Dakota,541307,389836,72.0,377734,69.8,12102,3.1
12180,November 1995,Tennessee,4104250,2738196,66.7,2595405,63.2,142791,5.2
12181,November 1995,Texas,13914696,9632220,69.2,9039498,65.0,592722,6.2
12182,November 1995,Utah,1424838,1021336,71.7,987184,69.3,34152,3.3
12183,November 1995,Vermont,449730,321756,71.5,307848,68.5,13908,4.3
12184,November 1995,Virginia,5010063,3422800,68.3,3264539,65.2,158261,4.6
12185,November 1995,Washington,4148267,2823432,68.1,2639429,63.6,184003,6.5
12186,November 1995,West Virginia,1436231,789194,54.9,725990,50.5,63204,8.0
12187,November 1995,Wisconsin,3927340,2899740,73.8,2788582,71.0,111158,3.8
12188,November 1995,Wyoming,360525,256104,71.0,243771,67.6,12333,4.8
12189,December 1995,Alabama,3267750,2067044,63.3,1952949,59.8,114095,5.5
12190,December 1995,Alaska,418379,306874,73.3,283324,67.7,23550,7.7
12191,December 1995,Arizona,3403433,2254477,66.2,2134283,62.7,120194,5.3
12192,December 1995,Arkansas,1924648,1246562,64.8,1184345,61.5,62217,5.0
12193,December 1995,California,23337590,15281262,65.5,14091747,60.4,1189515,7.8
12194,December 1995,Colorado,2928380,2148577,73.4,2058539,70.3,90038,4.2
12195,December 1995,Connecticut,2554341,1726643,67.6,1635059,64.0,91584,5.3
12196,December 1995,Delaware,560477,385623,68.8,366826,65.4,18797,4.9
12197,December 1995,District of Columbia,455324,295855,65.0,270206,59.3,25649,8.7
12198,December 1995,Florida,11444576,7075076,61.8,6687884,58.4,387192,5.5
12199,December 1995,Georgia,5520783,3717074,67.3,3542011,64.2,175063,4.7
12200,December 1995,Hawaii,871443,588063,67.5,551836,63.3,36227,6.2
12201,December 1995,Idaho,868009,606616,69.9,573491,66.1,33125,5.5
12202,December 1995,Illinois,9068922,6197805,68.3,5870953,64.7,326852,5.3
12203,December 1995,Indiana,4453852,3121867,70.1,2979375,66.9,142492,4.6
12204,December 1995,Iowa,2185623,1595479,73.0,1540003,70.5,55476,3.5
12205,December 1995,Kansas,1929851,1346011,69.7,1291173,66.9,54838,4.1
12206,December 1995,Kentucky,2971584,1853287,62.4,1752568,59.0,100719,5.4
12207,December 1995,Louisiana,3205533,1959805,61.1,1826901,57.0,132904,6.8
12208,December 1995,Maine,958332,647037,67.5,611036,63.8,36001,5.6
12209,December 1995,Maryland,3839376,2714543,70.7,2574112,67.0,140431,5.2
12210,December 1995,Massachusetts,4763285,3214374,67.5,3055388,64.1,158986,4.9
12211,December 1995,Michigan,7322383,4810451,65.7,4574074,62.5,236377,4.9
12212,December 1995,Minnesota,3513324,2624187,74.7,2524356,71.9,99831,3.8
12213,December 1995,Mississippi,2013336,1259666,62.6,1180606,58.6,79060,6.3
12214,December 1995,Missouri,4068872,2865492,70.4,2738085,67.3,127407,4.4
12215,December 1995,Montana,661571,446185,67.4,420885,63.6,25300,5.7
12216,December 1995,Nebraska,1238550,908728,73.4,883830,71.4,24898,2.7
12217,December 1995,Nevada,1251644,862728,68.9,816743,65.3,45985,5.3
12218,December 1995,New Hampshire,886892,633712,71.5,609981,68.8,23731,3.7
12219,December 1995,New Jersey,6219833,4139211,66.5,3873859,62.3,265352,6.4
12220,December 1995,New Mexico,1267281,805252,63.5,748211,59.0,57041,7.1
12221,December 1995,New York,14212824,8667829,61.0,8122020,57.1,545809,6.3
12222,December 1995,North Carolina,5657070,3812202,67.4,3639651,64.3,172551,4.5
12223,December 1995,North Dakota,481183,344470,71.6,333862,69.4,10608,3.1
12224,December 1995,Ohio,8502915,5613439,66.0,5328054,62.7,285385,5.1
12225,December 1995,Oklahoma,2466593,1561058,63.3,1491717,60.5,69341,4.4
12226,December 1995,Oregon,2472476,1691764,68.4,1603112,64.8,88652,5.2
12227,December 1995,Pennsylvania,9394921,5929332,63.1,5578143,59.4,351189,5.9
12228,December 1995,Rhode Island,786155,511186,65.0,481350,61.2,29836,5.8
12229,December 1995,South Carolina,2831414,1869282,66.0,1767077,62.4,102205,5.5
12230,December 1995,South Dakota,541396,390184,72.1,377943,69.8,12241,3.1
12231,December 1995,Tennessee,4110845,2738406,66.6,2597255,63.2,141151,5.2
12232,December 1995,Texas,13934297,9635664,69.2,9046884,64.9,588780,6.1
12233,December 1995,Utah,1428286,1023117,71.6,988860,69.2,34257,3.3
12234,December 1995,Vermont,450755,322201,71.5,308297,68.4,13904,4.3
12235,December 1995,Virginia,5015191,3413457,68.1,3256934,64.9,156523,4.6
12236,December 1995,Washington,4153511,2828216,68.1,2644832,63.7,183384,6.5
12237,December 1995,West Virginia,1436107,789960,55.0,726822,50.6,63138,8.0
12238,December 1995,Wisconsin,3930795,2903798,73.9,2792154,71.0,111644,3.8
12239,December 1995,Wyoming,360546,256227,71.1,243901,67.6,12326,4.8
12240,January 1996,Alabama,3270552,2067195,63.2,1954711,59.8,112484,5.4
12241,January 1996,Alaska,418371,307401,73.5,283675,67.8,23726,7.7
12242,January 1996,Arizona,3412217,2257244,66.2,2135488,62.6,121756,5.4
12243,January 1996,Arkansas,1927059,1247123,64.7,1184140,61.4,62983,5.1
12244,January 1996,California,23347682,15284736,65.5,14101377,60.4,1183359,7.7
12245,January 1996,Colorado,2934358,2150136,73.3,2059492,70.2,90644,4.2
12246,January 1996,Connecticut,2554805,1727519,67.6,1635714,64.0,91805,5.3
12247,January 1996,Delaware,560553,385750,68.8,366495,65.4,19255,5.0
12248,January 1996,District of Columbia,454689,294341,64.7,268932,59.1,25409,8.6
12249,January 1996,Florida,11462931,7079505,61.8,6697131,58.4,382374,5.4
12250,January 1996,Georgia,5530794,3723010,67.3,3551048,64.2,171962,4.6
12251,January 1996,Hawaii,872575,589572,67.6,552979,63.4,36593,6.2
12252,January 1996,Idaho,869009,607949,70.0,574726,66.1,33223,5.5
12253,January 1996,Illinois,9072171,6201349,68.4,5873160,64.7,328189,5.3
12254,January 1996,Indiana,4457419,3116286,69.9,2974972,66.7,141314,4.5
12255,January 1996,Iowa,2185951,1597636,73.1,1541625,70.5,56011,3.5
12256,January 1996,Kansas,1931863,1346420,69.7,1291083,66.8,55337,4.1
12257,January 1996,Kentucky,2973634,1852859,62.3,1752646,58.9,100213,5.4
12258,January 1996,Louisiana,3207554,1962753,61.2,1829078,57.0,133675,6.8
12259,January 1996,Maine,959309,648716,67.6,612962,63.9,35754,5.5
12260,January 1996,Maryland,3842201,2715919,70.7,2575188,67.0,140731,5.2
12261,January 1996,Massachusetts,4765275,3214839,67.5,3058598,64.2,156241,4.9
12262,January 1996,Michigan,7327083,4816380,65.7,4580249,62.5,236131,4.9
12263,January 1996,Minnesota,3517009,2629620,74.8,2527318,71.9,102302,3.9
12264,January 1996,Mississippi,2015438,1259098,62.5,1180253,58.6,78845,6.3
12265,January 1996,Missouri,4071453,2870075,70.5,2740465,67.3,129610,4.5
12266,January 1996,Montana,662538,446667,67.4,421599,63.6,25068,5.6
12267,January 1996,Nebraska,1239794,909863,73.4,884800,71.4,25063,2.8
12268,January 1996,Nevada,1256570,866076,68.9,820260,65.3,45816,5.3
12269,January 1996,New Hampshire,887988,634075,71.4,610241,68.7,23834,3.8
12270,January 1996,New Jersey,6223011,4145119,66.6,3878733,62.3,266386,6.4
12271,January 1996,New Mexico,1269493,806201,63.5,748419,59.0,57782,7.2
12272,January 1996,New York,14213904,8676288,61.0,8131307,57.2,544981,6.3
12273,January 1996,North Carolina,5666557,3825650,67.5,3651343,64.4,174307,4.6
12274,January 1996,North Dakota,481255,344886,71.7,334357,69.5,10529,3.1
12275,January 1996,Ohio,8504845,5613163,66.0,5328691,62.7,284472,5.1
12276,January 1996,Oklahoma,2468782,1562824,63.3,1494385,60.5,68439,4.4
12277,January 1996,Oregon,2476746,1697759,68.5,1606620,64.9,91139,5.4
12278,January 1996,Pennsylvania,9395531,5933654,63.2,5583765,59.4,349889,5.9
12279,January 1996,Rhode Island,786643,511710,65.0,482162,61.3,29548,5.8
12280,January 1996,South Carolina,2833392,1871042,66.0,1767613,62.4,103429,5.5
12281,January 1996,South Dakota,542485,390468,72.0,378085,69.7,12383,3.2
12282,January 1996,Tennessee,4116441,2740565,66.6,2600325,63.2,140240,5.1
12283,January 1996,Texas,13952899,9640810,69.1,9056792,64.9,584018,6.1
12284,January 1996,Utah,1431735,1025002,71.6,990481,69.2,34521,3.4
12285,January 1996,Vermont,450779,322675,71.6,308748,68.5,13927,4.3
12286,January 1996,Virginia,5020318,3405903,67.8,3251535,64.8,154368,4.5
12287,January 1996,Washington,4158754,2835664,68.2,2652766,63.8,182898,6.4
12288,January 1996,West Virginia,1435984,790780,55.1,727892,50.7,62888,8.0
12289,January 1996,Wisconsin,3934251,2908624,73.9,2797296,71.1,111328,3.8
12290,January 1996,Wyoming,361568,256324,70.9,243989,67.5,12335,4.8
12291,February 1996,Alabama,3272354,2068764,63.2,1956785,59.8,111979,5.4
12292,February 1996,Alaska,419362,307912,73.4,284126,67.8,23786,7.7
12293,February 1996,Arizona,3421000,2260898,66.1,2137312,62.5,123586,5.5
12294,February 1996,Arkansas,1928471,1247304,64.7,1183466,61.4,63838,5.1
12295,February 1996,California,23357773,15294874,65.5,14118369,60.4,1176505,7.7
12296,February 1996,Colorado,2940335,2151994,73.2,2060381,70.1,91613,4.3
12297,February 1996,Connecticut,2555268,1729234,67.7,1636975,64.1,92259,5.3
12298,February 1996,Delaware,561629,386010,68.7,366533,65.3,19477,5.0
12299,February 1996,District of Columbia,454055,292378,64.4,267145,58.8,25233,8.6
12300,February 1996,Florida,11480286,7087634,61.7,6709463,58.4,378171,5.3
12301,February 1996,Georgia,5540805,3733188,67.4,3562595,64.3,170593,4.6
12302,February 1996,Hawaii,872706,591180,67.7,554172,63.5,37008,6.3
12303,February 1996,Idaho,871009,609197,69.9,575949,66.1,33248,5.5
12304,February 1996,Illinois,9076420,6208014,68.4,5877235,64.8,330779,5.3
12305,February 1996,Indiana,4460987,3112289,69.8,2972623,66.6,139666,4.5
12306,February 1996,Iowa,2186279,1600236,73.2,1543648,70.6,56588,3.5
12307,February 1996,Kansas,1932874,1347568,69.7,1291311,66.8,56257,4.2
12308,February 1996,Kentucky,2975684,1853877,62.3,1753804,58.9,100073,5.4
12309,February 1996,Louisiana,3209576,1967104,61.3,1832952,57.1,134152,6.8
12310,February 1996,Maine,959286,650424,67.8,614832,64.1,35592,5.5
12311,February 1996,Maryland,3845026,2718710,70.7,2578125,67.1,140585,5.2
12312,February 1996,Massachusetts,4767265,3217073,67.5,3063327,64.3,153746,4.8
12313,February 1996,Michigan,7332783,4826157,65.8,4588632,62.6,237525,4.9
12314,February 1996,Minnesota,3520694,2635184,74.8,2530462,71.9,104722,4.0
12315,February 1996,Mississippi,2016540,1259715,62.5,1180826,58.6,78889,6.3
12316,February 1996,Missouri,4075035,2877934,70.6,2744785,67.4,133149,4.6
12317,February 1996,Montana,663504,447346,67.4,422492,63.7,24854,5.6
12318,February 1996,Nebraska,1240038,911003,73.5,885797,71.4,25206,2.8
12319,February 1996,Nevada,1261495,869913,69.0,824258,65.3,45655,5.2
12320,February 1996,New Hampshire,889083,634551,71.4,610459,68.7,24092,3.8
12321,February 1996,New Jersey,6226189,4153193,66.7,3886458,62.4,266735,6.4
12322,February 1996,New Mexico,1271705,807227,63.5,748893,58.9,58334,7.2
12323,February 1996,New York,14214985,8692038,61.1,8144391,57.3,547647,6.3
12324,February 1996,North Carolina,5675044,3841096,67.7,3665637,64.6,175459,4.6
12325,February 1996,North Dakota,481327,345239,71.7,334797,69.6,10442,3.0
12326,February 1996,Ohio,8506774,5615771,66.0,5331806,62.7,283965,5.1
12327,February 1996,Oklahoma,2470970,1565542,63.4,1498087,60.6,67455,4.3
12328,February 1996,Oregon,2481017,1703991,68.7,1610539,64.9,93452,5.5
12329,February 1996,Pennsylvania,9397141,5940230,63.2,5593063,59.5,347167,5.8
12330,February 1996,Rhode Island,787131,512453,65.1,483189,61.4,29264,5.7
12331,February 1996,South Carolina,2836370,1874064,66.1,1768985,62.4,105079,5.6
12332,February 1996,South Dakota,542574,390676,72.0,378161,69.7,12515,3.2
12333,February 1996,Tennessee,4121036,2745075,66.6,2604930,63.2,140145,5.1
12334,February 1996,Texas,13971500,9649363,69.1,9070647,64.9,578716,6.0
12335,February 1996,Utah,1436183,1027106,71.5,992261,69.1,34845,3.4
12336,February 1996,Vermont,451803,323128,71.5,309160,68.4,13968,4.3
12337,February 1996,Virginia,5025446,3401919,67.7,3249208,64.7,152711,4.5
12338,February 1996,Washington,4163997,2845481,68.3,2662887,64.0,182594,6.4
12339,February 1996,West Virginia,1435860,791591,55.1,729264,50.8,62327,7.9
12340,February 1996,Wisconsin,3936706,2914305,74.0,2803734,71.2,110571,3.8
12341,February 1996,Wyoming,361589,256387,70.9,244008,67.5,12379,4.8
12342,March 1996,Alabama,3275156,2071436,63.2,1959534,59.8,111902,5.4
12343,March 1996,Alaska,419353,308436,73.6,284684,67.9,23752,7.7
12344,March 1996,Arizona,3429784,2265660,66.1,2140185,62.4,125475,5.5
12345,March 1996,Arkansas,1930883,1247530,64.6,1182858,61.3,64672,5.2
12346,March 1996,California,23370865,15312795,65.5,14145038,60.5,1167757,7.6
12347,March 1996,Colorado,2946313,2153925,73.1,2061146,70.0,92779,4.3
12348,March 1996,Connecticut,2555731,1731423,67.7,1638724,64.1,92699,5.4
12349,March 1996,Delaware,562705,386358,68.7,366864,65.2,19494,5.0
12350,March 1996,District of Columbia,454420,290214,63.9,265087,58.3,25127,8.7
12351,March 1996,Florida,11499641,7100222,61.7,6725047,58.5,375175,5.3
12352,March 1996,Georgia,5550816,3748186,67.5,3577439,64.4,170747,4.6
12353,March 1996,Hawaii,873837,592662,67.8,555318,63.5,37344,6.3
12354,March 1996,Idaho,873009,610438,69.9,577277,66.1,33161,5.4
12355,March 1996,Illinois,9080669,6218408,68.5,5884200,64.8,334208,5.4
12356,March 1996,Indiana,4464554,3110346,69.7,2972648,66.6,137698,4.4
12357,March 1996,Iowa,2187608,1603368,73.3,1546232,70.7,57136,3.6
12358,March 1996,Kansas,1933886,1349243,69.8,1291945,66.8,57298,4.2
12359,March 1996,Kentucky,2977734,1856155,62.3,1756270,59.0,99885,5.4
12360,March 1996,Louisiana,3211597,1972464,61.4,1838321,57.2,134143,6.8
12361,March 1996,Maine,960262,652229,67.9,616765,64.2,35464,5.4
12362,March 1996,Maryland,3847850,2723104,70.8,2583016,67.1,140088,5.1
12363,March 1996,Massachusetts,4769255,3221153,67.5,3069803,64.4,151350,4.7
12364,March 1996,Michigan,7338482,4838983,65.9,4599198,62.7,239785,5.0
12365,March 1996,Minnesota,3525379,2640731,74.9,2533903,71.9,106828,4.0
12366,March 1996,Mississippi,2018642,1261243,62.5,1182359,58.6,78884,6.3
12367,March 1996,Missouri,4077617,2888108,70.8,2751076,67.5,137032,4.7
12368,March 1996,Montana,664470,448133,67.4,423452,63.7,24681,5.5
12369,March 1996,Nebraska,1241282,912049,73.5,886715,71.4,25334,2.8
12370,March 1996,Nevada,1267421,874238,69.0,828725,65.4,45513,5.2
12371,March 1996,New Hampshire,890179,635247,71.4,610836,68.6,24411,3.8
12372,March 1996,New Jersey,6229368,4163258,66.8,3897594,62.6,265664,6.4
12373,March 1996,New Mexico,1273918,808459,63.5,749702,58.9,58757,7.3
12374,March 1996,New York,14218066,8713366,61.3,8161184,57.4,552182,6.3
12375,March 1996,North Carolina,5684531,3857675,67.9,3682202,64.8,175473,4.5
12376,March 1996,North Dakota,482399,345593,71.6,335240,69.5,10353,3.0
12377,March 1996,Ohio,8509703,5621900,66.1,5338191,62.7,283709,5.0
12378,March 1996,Oklahoma,2473159,1569139,63.4,1502807,60.8,66332,4.2
12379,March 1996,Oregon,2485287,1709889,68.8,1614513,65.0,95376,5.6
12380,March 1996,Pennsylvania,9398751,5949398,63.3,5606479,59.7,342919,5.8
12381,March 1996,Rhode Island,787620,513269,65.2,484341,61.5,28928,5.6
12382,March 1996,South Carolina,2838347,1878309,66.2,1771350,62.4,106959,5.7
12383,March 1996,South Dakota,543662,390829,71.9,378226,69.6,12603,3.2
12384,March 1996,Tennessee,4127631,2751127,66.7,2610823,63.3,140304,5.1
12385,March 1996,Texas,13991101,9661402,69.1,9088839,65.0,572563,5.9
12386,March 1996,Utah,1439632,1029468,71.5,994351,69.1,35117,3.4
12387,March 1996,Vermont,451828,323481,71.6,309472,68.5,14009,4.3
12388,March 1996,Virginia,5030574,3402166,67.6,3250303,64.6,151863,4.5
12389,March 1996,Washington,4170240,2856609,68.5,2674435,64.1,182174,6.4
12390,March 1996,West Virginia,1436737,792302,55.1,730911,50.9,61391,7.7
12391,March 1996,Wisconsin,3940162,2920496,74.1,2810834,71.3,109662,3.8
12392,March 1996,Wyoming,361611,256419,70.9,243960,67.5,12459,4.9
12393,April 1996,Alabama,3277958,2074463,63.3,1963195,59.9,111268,5.4
12394,April 1996,Alaska,419345,308960,73.7,285305,68.0,23655,7.7
12395,April 1996,Arizona,3439568,2271570,66.0,2144406,62.3,127164,5.6
12396,April 1996,Arkansas,1933295,1247994,64.6,1182655,61.2,65339,5.2
12397,April 1996,California,23385956,15336918,65.6,14181381,60.6,1155537,7.5
12398,April 1996,Colorado,2953290,2155459,73.0,2061625,69.8,93834,4.4
12399,April 1996,Connecticut,2556194,1733687,67.8,1640713,64.2,92974,5.4
12400,April 1996,Delaware,562781,386753,68.7,367330,65.3,19423,5.0
12401,April 1996,District of Columbia,453786,288169,63.5,263122,58.0,25047,8.7
12402,April 1996,Florida,11519997,7116787,61.8,6743715,58.5,373072,5.2
12403,April 1996,Georgia,5561826,3766629,67.7,3594828,64.6,171801,4.6
12404,April 1996,Hawaii,874968,593866,67.9,556372,63.6,37494,6.3
12405,April 1996,Idaho,874010,611772,70.0,578800,66.2,32972,5.4
12406,April 1996,Illinois,9085918,6231030,68.6,5893748,64.9,337282,5.4
12407,April 1996,Indiana,4468121,3110301,69.6,2974803,66.6,135498,4.4
12408,April 1996,Iowa,2188936,1606697,73.4,1549234,70.8,57463,3.6
12409,April 1996,Kansas,1935898,1351263,69.8,1293073,66.8,58190,4.3
12410,April 1996,Kentucky,2980783,1858990,62.4,1759887,59.0,99103,5.3
12411,April 1996,Louisiana,3213618,1978192,61.6,1844600,57.4,133592,6.8
12412,April 1996,Maine,961239,654069,68.0,618777,64.4,35292,5.4
12413,April 1996,Maryland,3850675,2728698,70.9,2589453,67.2,139245,5.1
12414,April 1996,Massachusetts,4772245,3226712,67.6,3077835,64.5,148877,4.6
12415,April 1996,Michigan,7345182,4853218,66.1,4611312,62.8,241906,5.0
12416,April 1996,Minnesota,3529064,2646070,75.0,2537763,71.9,108307,4.1
12417,April 1996,Mississippi,2020744,1262951,62.5,1184540,58.6,78411,6.2
12418,April 1996,Missouri,4081198,2898656,71.0,2758571,67.6,140085,4.8
12419,April 1996,Montana,665436,448879,67.5,424339,63.8,24540,5.5
12420,April 1996,Nebraska,1243525,912913,73.4,887499,71.4,25414,2.8
12421,April 1996,Nevada,1272347,878959,69.1,833540,65.5,45419,5.2
12422,April 1996,New Hampshire,891275,636148,71.4,611452,68.6,24696,3.9
12423,April 1996,New Jersey,6234546,4174679,67.0,3911746,62.7,262933,6.3
12424,April 1996,New Mexico,1276130,809799,63.5,750726,58.8,59073,7.3
12425,April 1996,New York,14221147,8736676,61.4,8181321,57.5,555355,6.4
12426,April 1996,North Carolina,5695018,3874107,68.0,3699980,65.0,174127,4.5
12427,April 1996,North Dakota,482471,345999,71.7,335734,69.6,10265,3.0
12428,April 1996,Ohio,8513633,5630367,66.1,5347209,62.8,283158,5.0
12429,April 1996,Oklahoma,2475348,1573234,63.6,1508220,60.9,65014,4.1
12430,April 1996,Oregon,2489558,1714936,68.9,1618206,65.0,96730,5.6
12431,April 1996,Pennsylvania,9402361,5959730,63.4,5622714,59.8,337016,5.7
12432,April 1996,Rhode Island,788108,514031,65.2,485497,61.6,28534,5.6
12433,April 1996,South Carolina,2841325,1883395,66.3,1774630,62.5,108765,5.8
12434,April 1996,South Dakota,543751,390925,71.9,378300,69.6,12625,3.2
12435,April 1996,Tennessee,4134226,2757078,66.7,2617425,63.3,139653,5.1
12436,April 1996,Texas,14012703,9675564,69.0,9110611,65.0,564953,5.8
12437,April 1996,Utah,1444080,1031988,71.5,996755,69.0,35233,3.4
12438,April 1996,Vermont,451852,323711,71.6,309674,68.5,14037,4.3
12439,April 1996,Virginia,5036701,3406020,67.6,3254467,64.6,151553,4.4
12440,April 1996,Washington,4175483,2867602,68.7,2686296,64.3,181306,6.3
12441,April 1996,West Virginia,1436613,792929,55.2,732734,51.0,60195,7.6
12442,April 1996,Wisconsin,3944617,2926573,74.2,2817937,71.4,108636,3.7
12443,April 1996,Wyoming,361632,256387,70.9,243835,67.4,12552,4.9
12444,May 1996,Alabama,3280760,2077461,63.3,1967795,60.0,109666,5.3
12445,May 1996,Alaska,420336,309455,73.6,285923,68.0,23532,7.6
12446,May 1996,Arizona,3448352,2278299,66.1,2149815,62.3,128484,5.6
12447,May 1996,Arkansas,1935707,1248668,64.5,1182901,61.1,65767,5.3
12448,May 1996,California,23400048,15364351,65.7,14225102,60.8,1139249,7.4
12449,May 1996,Colorado,2959268,2156234,72.9,2061758,69.7,94476,4.4
12450,May 1996,Connecticut,2556657,1735962,67.9,1642778,64.3,93184,5.4
12451,May 1996,Delaware,563857,387188,68.7,367783,65.2,19405,5.0
12452,May 1996,District of Columbia,453152,286512,63.2,261583,57.7,24929,8.7
12453,May 1996,Florida,11539352,7136131,61.8,6764935,58.6,371196,5.2
12454,May 1996,Georgia,5572837,3786308,67.9,3613303,64.8,173005,4.6
12455,May 1996,Hawaii,875099,594686,68.0,557303,63.7,37383,6.3
12456,May 1996,Idaho,876010,613262,70.0,580562,66.3,32700,5.3
12457,May 1996,Illinois,9091167,6243466,68.7,5904544,64.9,338922,5.4
12458,May 1996,Indiana,4472689,3111383,69.6,2978378,66.6,133005,4.3
12459,May 1996,Iowa,2190264,1609661,73.5,1552192,70.9,57469,3.6
12460,May 1996,Kansas,1936910,1353418,69.9,1294726,66.8,58692,4.3
12461,May 1996,Kentucky,2982833,1862132,62.4,1764339,59.1,97793,5.3
12462,May 1996,Louisiana,3215640,1983765,61.7,1851108,57.6,132657,6.7
12463,May 1996,Maine,961216,655829,68.2,620808,64.6,35021,5.3
12464,May 1996,Maryland,3854500,2734886,71.0,2596678,67.4,138208,5.1
12465,May 1996,Massachusetts,4775235,3233028,67.7,3086822,64.6,146206,4.5
12466,May 1996,Michigan,7351882,4867237,66.2,4624220,62.9,243017,5.0
12467,May 1996,Minnesota,3533750,2650775,75.0,2541989,71.9,108786,4.1
12468,May 1996,Mississippi,2021846,1264266,62.5,1186896,58.7,77370,6.1
12469,May 1996,Missouri,4084780,2907481,71.2,2766153,67.7,141328,4.9
12470,May 1996,Montana,666403,449455,67.4,425055,63.8,24400,5.4
12471,May 1996,Nebraska,1244769,913611,73.4,888224,71.4,25387,2.8
12472,May 1996,Nevada,1277272,883886,69.2,838502,65.6,45384,5.1
12473,May 1996,New Hampshire,892371,637154,71.4,612261,68.6,24893,3.9
12474,May 1996,New Jersey,6238724,4186732,67.1,3927602,63.0,259130,6.2
12475,May 1996,New Mexico,1278342,811142,63.5,751858,58.8,59284,7.3
12476,May 1996,New York,14225228,8758880,61.6,8204109,57.7,554771,6.3
12477,May 1996,North Carolina,5704505,3889227,68.2,3717541,65.2,171686,4.4
12478,May 1996,North Dakota,482543,346482,71.8,336322,69.7,10160,2.9
12479,May 1996,Ohio,8517562,5639401,66.2,5357440,62.9,281961,5.0
12480,May 1996,Oklahoma,2477537,1577254,63.7,1513726,61.1,63528,4.0
12481,May 1996,Oregon,2493828,1718792,68.9,1621309,65.0,97483,5.7
12482,May 1996,Pennsylvania,9404971,5969618,63.5,5639655,60.0,329963,5.5
12483,May 1996,Rhode Island,788596,514707,65.3,486587,61.7,28120,5.5
12484,May 1996,South Carolina,2844303,1888590,66.4,1778448,62.5,110142,5.8
12485,May 1996,South Dakota,544840,391011,71.8,378434,69.5,12577,3.2
12486,May 1996,Tennessee,4139821,2761868,66.7,2623888,63.4,137980,5.0
12487,May 1996,Texas,14033304,9690106,69.1,9134473,65.1,555633,5.7
12488,May 1996,Utah,1447528,1034545,71.5,999400,69.0,35145,3.4
12489,May 1996,Vermont,452876,323822,71.5,309789,68.4,14033,4.3
12490,May 1996,Virginia,5042829,3412222,67.7,3260716,64.7,151506,4.4
12491,May 1996,Washington,4181727,2877665,68.8,2697757,64.5,179908,6.3
12492,May 1996,West Virginia,1437490,793593,55.2,734587,51.1,59006,7.4
12493,May 1996,Wisconsin,3949073,2932006,74.2,2824582,71.5,107424,3.7
12494,May 1996,Wyoming,362654,256259,70.7,243627,67.2,12632,4.9
12495,June 1996,Alabama,3283563,2080809,63.4,1973242,60.1,107567,5.2
12496,June 1996,Alaska,420327,309891,73.7,286469,68.2,23422,7.6
12497,June 1996,Arizona,3458136,2285342,66.1,2155940,62.3,129402,5.7
12498,June 1996,Arkansas,1937118,1249485,64.5,1183501,61.1,65984,5.3
12499,June 1996,California,23416139,15394088,65.7,14273312,61.0,1120776,7.3
12500,June 1996,Colorado,2966245,2156090,72.7,2061578,69.5,94512,4.4
12501,June 1996,Connecticut,2558120,1738554,68.0,1644929,64.3,93625,5.4
12502,June 1996,Delaware,564933,387703,68.6,368152,65.2,19551,5.0
12503,June 1996,District of Columbia,453517,285422,62.9,260709,57.5,24713,8.7
12504,June 1996,Florida,11560707,7157364,61.9,6788180,58.7,369184,5.2
12505,June 1996,Georgia,5583848,3805493,68.2,3631467,65.0,174026,4.6
12506,June 1996,Hawaii,876230,595245,67.9,558100,63.7,37145,6.2
12507,June 1996,Idaho,878010,614969,70.0,582547,66.3,32422,5.3
12508,June 1996,Illinois,9097415,6253660,68.7,5915471,65.0,338189,5.4
12509,June 1996,Indiana,4477256,3112535,69.5,2982603,66.6,129932,4.2
12510,June 1996,Iowa,2191592,1611828,73.5,1554612,70.9,57216,3.5
12511,June 1996,Kansas,1938922,1355777,69.9,1296971,66.9,58806,4.3
12512,June 1996,Kentucky,2985883,1866020,62.5,1769309,59.3,96711,5.2
12513,June 1996,Louisiana,3217661,1989102,61.8,1857459,57.7,131643,6.6
12514,June 1996,Maine,962193,657431,68.3,622811,64.7,34620,5.3
12515,June 1996,Maryland,3858324,2741013,71.0,2603813,67.5,137200,5.0
12516,June 1996,Massachusetts,4778225,3239408,67.8,3095995,64.8,143413,4.4
12517,June 1996,Michigan,7359582,4879870,66.3,4637330,63.0,242540,5.0
12518,June 1996,Minnesota,3538435,2654642,75.0,2546392,72.0,108250,4.1
12519,June 1996,Mississippi,2023947,1265027,62.5,1189012,58.7,76015,6.0
12520,June 1996,Missouri,4089361,2914024,71.3,2773044,67.8,140980,4.8
12521,June 1996,Montana,667369,449844,67.4,425659,63.8,24185,5.4
12522,June 1996,Nebraska,1246013,914236,73.4,888964,71.3,25272,2.8
12523,June 1996,Nevada,1283198,888858,69.3,843521,65.7,45337,5.1
12524,June 1996,New Hampshire,894466,638153,71.3,613177,68.6,24976,3.9
12525,June 1996,New Jersey,6242902,4199186,67.3,3943774,63.2,255412,6.1
12526,June 1996,New Mexico,1281554,812463,63.4,753052,58.8,59411,7.3
12527,June 1996,New York,14230309,8779097,61.7,8228714,57.8,550383,6.3
12528,June 1996,North Carolina,5714993,3902681,68.3,3733876,65.3,168805,4.3
12529,June 1996,North Dakota,483615,347041,71.8,337002,69.7,10039,2.9
12530,June 1996,Ohio,8521491,5647563,66.3,5367315,63.0,280248,5.0
12531,June 1996,Oklahoma,2480726,1580870,63.7,1518695,61.2,62175,3.9
12532,June 1996,Oregon,2499099,1721491,68.9,1623694,65.0,97797,5.7
12533,June 1996,Pennsylvania,9408581,5978353,63.5,5655599,60.1,322754,5.4
12534,June 1996,Rhode Island,789084,515346,65.3,487592,61.8,27754,5.4
12535,June 1996,South Carolina,2847281,1893481,66.5,1782512,62.6,110969,5.9
12536,June 1996,South Dakota,544929,391162,71.8,378696,69.5,12466,3.2
12537,June 1996,Tennessee,4146416,2766009,66.7,2629443,63.4,136566,4.9
12538,June 1996,Texas,14054906,9705040,69.1,9159075,65.2,545965,5.6
12539,June 1996,Utah,1451977,1037180,71.4,1002243,69.0,34937,3.4
12540,June 1996,Vermont,452901,323865,71.5,309873,68.4,13992,4.3
12541,June 1996,Virginia,5048956,3419393,67.7,3267909,64.7,151484,4.4
12542,June 1996,Washington,4187970,2886454,68.9,2708656,64.7,177798,6.2
12543,June 1996,West Virginia,1437366,794433,55.3,736328,51.2,58105,7.3
12544,June 1996,Wisconsin,3952528,2936388,74.3,2830461,71.6,105927,3.6
12545,June 1996,Wyoming,362675,256074,70.6,243394,67.1,12680,5.0
12546,July 1996,Alabama,3286365,2084925,63.4,1979230,60.2,105695,5.1
12547,July 1996,Alaska,421319,310253,73.6,286902,68.1,23351,7.5
12548,July 1996,Arizona,3467919,2292324,66.1,2162351,62.4,129973,5.7
12549,July 1996,Arkansas,1939530,1250283,64.5,1184186,61.1,66097,5.3
12550,July 1996,California,23432231,15426880,65.8,14323690,61.1,1103190,7.2
12551,July 1996,Colorado,2972223,2155205,72.5,2061365,69.4,93840,4.4
12552,July 1996,Connecticut,2558583,1741756,68.1,1647182,64.4,94574,5.4
12553,July 1996,Delaware,566009,388336,68.6,368455,65.1,19881,5.1
12554,July 1996,District of Columbia,452883,284974,62.9,260585,57.5,24389,8.6
12555,July 1996,Florida,11581062,7180065,62.0,6813031,58.8,367034,5.1
12556,July 1996,Georgia,5595859,3823414,68.3,3648382,65.2,175032,4.6
12557,July 1996,Hawaii,877362,595831,67.9,558806,63.7,37025,6.2
12558,July 1996,Idaho,880010,616905,70.1,584704,66.4,32201,5.2
12559,July 1996,Illinois,9102664,6261105,68.8,5926243,65.1,334862,5.3
12560,July 1996,Indiana,4480824,3112948,69.5,2986738,66.7,126210,4.1
12561,July 1996,Iowa,2192920,1613086,73.6,1556242,71.0,56844,3.5
12562,July 1996,Kansas,1940933,1358480,70.0,1299866,67.0,58614,4.3
12563,July 1996,Kentucky,2988933,1871289,62.6,1774438,59.4,96851,5.2
12564,July 1996,Louisiana,3220682,1994275,61.9,1863472,57.9,130803,6.6
12565,July 1996,Maine,963170,658809,68.4,624737,64.9,34072,5.2
12566,July 1996,Maryland,3861149,2746555,71.1,2610080,67.6,136475,5.0
12567,July 1996,Massachusetts,4781215,3245447,67.9,3104681,64.9,140766,4.3
12568,July 1996,Michigan,7366281,4890859,66.4,4650160,63.1,240699,4.9
12569,July 1996,Minnesota,3543120,2657775,75.0,2550804,72.0,106971,4.0
12570,July 1996,Mississippi,2026049,1265450,62.5,1190757,58.8,74693,5.9
12571,July 1996,Missouri,4092943,2918732,71.3,2778768,67.9,139964,4.8
12572,July 1996,Montana,668335,450068,67.3,426221,63.8,23847,5.3
12573,July 1996,Nebraska,1247257,914869,73.4,889785,71.3,25084,2.7
12574,July 1996,Nevada,1288123,893786,69.4,848576,65.9,45210,5.1
12575,July 1996,New Hampshire,895562,639039,71.4,614125,68.6,24914,3.9
12576,July 1996,New Jersey,6248081,4212156,67.4,3959298,63.4,252858,6.0
12577,July 1996,New Mexico,1283767,813747,63.4,754317,58.8,59430,7.3
12578,July 1996,New York,14234390,8798180,61.8,8254302,58.0,543878,6.2
12579,July 1996,North Carolina,5725480,3914644,68.4,3748675,65.5,165969,4.2
12580,July 1996,North Dakota,483687,347667,71.9,337726,69.8,9941,2.9
12581,July 1996,Ohio,8525421,5653949,66.3,5375370,63.1,278579,4.9
12582,July 1996,Oklahoma,2482914,1584059,63.8,1522706,61.3,61353,3.9
12583,July 1996,Oregon,2503369,1723500,68.8,1625452,64.9,98048,5.7
12584,July 1996,Pennsylvania,9412191,5985979,63.6,5669575,60.2,316404,5.3
12585,July 1996,Rhode Island,789573,516054,65.4,488563,61.9,27491,5.3
12586,July 1996,South Carolina,2850259,1897883,66.6,1786501,62.7,111382,5.9
12587,July 1996,South Dakota,546018,391376,71.7,379057,69.4,12319,3.1
12588,July 1996,Tennessee,4153011,2770379,66.7,2633636,63.4,136743,4.9
12589,July 1996,Texas,14077507,9721533,69.1,9183484,65.2,538049,5.5
12590,July 1996,Utah,1455425,1039963,71.5,1005197,69.1,34766,3.3
12591,July 1996,Vermont,453925,323929,71.4,310000,68.3,13929,4.3
12592,July 1996,Virginia,5055084,3426421,67.8,3275045,64.8,151376,4.4
12593,July 1996,Washington,4194213,2893843,69.0,2718746,64.8,175097,6.1
12594,July 1996,West Virginia,1438243,795533,55.3,737852,51.3,57681,7.3
12595,July 1996,Wisconsin,3956984,2939652,74.3,2835444,71.7,104208,3.5
12596,July 1996,Wyoming,363697,255870,70.4,243182,66.9,12688,5.0
12597,August 1996,Alabama,3289167,2090109,63.5,1985361,60.4,104748,5.0
12598,August 1996,Alaska,421310,310549,73.7,287223,68.2,23326,7.5
12599,August 1996,Arizona,3478703,2298500,66.1,2168475,62.3,130025,5.7
12600,August 1996,Arkansas,1941942,1250740,64.4,1184536,61.0,66204,5.3
12601,August 1996,California,23469322,15463546,65.9,14373814,61.2,1089732,7.0
12602,August 1996,Colorado,2979200,2154341,72.3,2061822,69.2,92519,4.3
12603,August 1996,Connecticut,2560046,1745597,68.2,1649520,64.4,96077,5.5
12604,August 1996,Delaware,566085,389057,68.7,368769,65.1,20288,5.2
12605,August 1996,District of Columbia,453248,285083,62.9,261101,57.6,23982,8.4
12606,August 1996,Florida,11603417,7203603,62.1,6838271,58.9,365332,5.1
12607,August 1996,Georgia,5607870,3840119,68.5,3663361,65.3,176758,4.6
12608,August 1996,Hawaii,878493,596586,67.9,559516,63.7,37070,6.2
12609,August 1996,Idaho,882010,619133,70.2,586975,66.5,32158,5.2
12610,August 1996,Illinois,9108913,6266495,68.8,5936670,65.2,329825,5.3
12611,August 1996,Indiana,4484391,3112171,69.4,2990329,66.7,121842,3.9
12612,August 1996,Iowa,2194248,1613561,73.5,1557061,71.0,56500,3.5
12613,August 1996,Kansas,1941945,1361550,70.1,1303274,67.1,58276,4.3
12614,August 1996,Kentucky,2989983,1878184,62.8,1779373,59.5,98811,5.3
12615,August 1996,Louisiana,3222704,1999109,62.0,1869008,58.0,130101,6.5
12616,August 1996,Maine,964147,659899,68.4,626438,65.0,33461,5.1
12617,August 1996,Maryland,3863974,2751196,71.2,2615121,67.7,136075,4.9
12618,August 1996,Massachusetts,4785205,3251086,67.9,3112498,65.0,138588,4.3
12619,August 1996,Michigan,7369981,4900466,66.5,4661926,63.3,238540,4.9
12620,August 1996,Minnesota,3547805,2660238,75.0,2554945,72.0,105293,4.0
12621,August 1996,Mississippi,2028151,1265896,62.4,1192082,58.8,73814,5.8
12622,August 1996,Missouri,4096524,2922489,71.3,2783240,67.9,139249,4.8
12623,August 1996,Montana,668302,450193,67.4,426734,63.9,23459,5.2
12624,August 1996,Nebraska,1248501,915525,73.3,890684,71.3,24841,2.7
12625,August 1996,Nevada,1294049,898683,69.4,853693,66.0,44990,5.0
12626,August 1996,New Hampshire,896658,639764,71.3,615074,68.6,24690,3.9
12627,August 1996,New Jersey,6253259,4225563,67.6,3973437,63.5,252126,6.0
12628,August 1996,New Mexico,1284979,814934,63.4,755663,58.8,59271,7.3
12629,August 1996,New York,14241471,8817324,61.9,8278693,58.1,538631,6.1
12630,August 1996,North Carolina,5734967,3925530,68.4,3762175,65.6,163355,4.2
12631,August 1996,North Dakota,483759,348348,72.0,338440,70.0,9908,2.8
12632,August 1996,Ohio,8528350,5658635,66.4,5381219,63.1,277416,4.9
12633,August 1996,Oklahoma,2486103,1587071,63.8,1525678,61.4,61393,3.9
12634,August 1996,Oregon,2507640,1725358,68.8,1626753,64.9,98605,5.7
12635,August 1996,Pennsylvania,9413801,5993709,63.7,5681963,60.4,311746,5.2
12636,August 1996,Rhode Island,790061,516922,65.4,489563,62.0,27359,5.3
12637,August 1996,South Carolina,2855237,1901727,66.6,1790134,62.7,111593,5.9
12638,August 1996,South Dakota,546107,391591,71.7,379395,69.5,12196,3.1
12639,August 1996,Tennessee,4159606,2775277,66.7,2636336,63.4,138941,5.0
12640,August 1996,Texas,14103108,9740171,69.1,9206858,65.3,533313,5.5
12641,August 1996,Utah,1458874,1042877,71.5,1008115,69.1,34762,3.3
12642,August 1996,Vermont,453950,324059,71.4,310194,68.3,13865,4.3
12643,August 1996,Virginia,5061212,3432364,67.8,3281220,64.8,151144,4.4
12644,August 1996,Washington,4201456,2900078,69.0,2728024,64.9,172054,5.9
12645,August 1996,West Virginia,1438119,796817,55.4,739072,51.4,57745,7.2
12646,August 1996,Wisconsin,3960439,2941978,74.3,2839297,71.7,102681,3.5
12647,August 1996,Wyoming,363718,255675,70.3,242983,66.8,12692,5.0
12648,September 1996,Alabama,3290969,2096311,63.7,1991044,60.5,105267,5.0
12649,September 1996,Alaska,421302,310813,73.8,287472,68.2,23341,7.5
12650,September 1996,Arizona,3489487,2302584,66.0,2173121,62.3,129463,5.6
12651,September 1996,Arkansas,1944354,1250448,64.3,1184178,60.9,66270,5.3
12652,September 1996,California,23508414,15500647,65.9,14418861,61.3,1081786,7.0
12653,September 1996,Colorado,2986178,2154155,72.1,2063467,69.1,90688,4.2
12654,September 1996,Connecticut,2561509,1749567,68.3,1651661,64.5,97906,5.6
12655,September 1996,Delaware,567161,389723,68.7,369139,65.1,20584,5.3
12656,September 1996,District of Columbia,452614,285448,63.1,261908,57.9,23540,8.2
12657,September 1996,Florida,11626773,7225042,62.1,6860391,59.0,364651,5.0
12658,September 1996,Georgia,5620881,3855371,68.6,3675439,65.4,179932,4.7
12659,September 1996,Hawaii,879624,597508,67.9,560271,63.7,37237,6.2
12660,September 1996,Idaho,884010,621517,70.3,589218,66.7,32299,5.2
12661,September 1996,Illinois,9116162,6269711,68.8,5945094,65.2,324617,5.2
12662,September 1996,Indiana,4487958,3109758,69.3,2992760,66.7,116998,3.8
12663,September 1996,Iowa,2195576,1613306,73.5,1557048,70.9,56258,3.5
12664,September 1996,Kansas,1943957,1364753,70.2,1306729,67.2,58024,4.3
12665,September 1996,Kentucky,2992032,1885952,63.0,1783573,59.6,102379,5.4
12666,September 1996,Louisiana,3225725,2002807,62.1,1873458,58.1,129349,6.5
12667,September 1996,Maine,965123,660569,68.4,627636,65.0,32933,5.0
12668,September 1996,Maryland,3867798,2754523,71.2,2618617,67.7,135906,4.9
12669,September 1996,Massachusetts,4789195,3256128,68.0,3119015,65.1,137113,4.2
12670,September 1996,Michigan,7375681,4907980,66.5,4671137,63.3,236843,4.8
12671,September 1996,Minnesota,3551490,2661939,75.0,2558447,72.0,103492,3.9
12672,September 1996,Mississippi,2030253,1266412,62.4,1192833,58.8,73579,5.8
12673,September 1996,Missouri,4101106,2925353,71.3,2785909,67.9,139444,4.8
12674,September 1996,Montana,669268,450262,67.3,427150,63.8,23112,5.1
12675,September 1996,Nebraska,1249744,916164,73.3,891529,71.3,24635,2.7
12676,September 1996,Nevada,1299975,903538,69.5,858867,66.1,44671,4.9
12677,September 1996,New Hampshire,897754,640358,71.3,616022,68.6,24336,3.8
12678,September 1996,New Jersey,6259437,4238225,67.7,3985172,63.7,253053,6.0
12679,September 1996,New Mexico,1287191,815908,63.4,757010,58.8,58898,7.2
12680,September 1996,New York,14248551,8836157,62.0,8297868,58.2,538289,6.1
12681,September 1996,North Carolina,5745454,3935168,68.5,3773929,65.7,161239,4.1
12682,September 1996,North Dakota,484831,349023,72.0,339090,69.9,9933,2.8
12683,September 1996,Ohio,8532280,5661872,66.4,5384260,63.1,277612,4.9
12684,September 1996,Oklahoma,2488292,1589762,63.9,1527602,61.4,62160,3.9
12685,September 1996,Oregon,2511910,1727173,68.8,1627661,64.8,99512,5.8
12686,September 1996,Pennsylvania,9416411,6002031,63.7,5692735,60.5,309296,5.2
12687,September 1996,Rhode Island,790549,517936,65.5,490596,62.1,27340,5.3
12688,September 1996,South Carolina,2860215,1905026,66.6,1793307,62.7,111719,5.9
12689,September 1996,South Dakota,547195,391723,71.6,379594,69.4,12129,3.1
12690,September 1996,Tennessee,4166201,2779841,66.7,2637006,63.3,142835,5.1
12691,September 1996,Texas,14129710,9759857,69.1,9227004,65.3,532853,5.5
12692,September 1996,Utah,1462322,1045763,71.5,1010840,69.1,34923,3.3
12693,September 1996,Vermont,454974,324234,71.3,310437,68.2,13797,4.3
12694,September 1996,Virginia,5068339,3435785,67.8,3284873,64.8,150912,4.4
12695,September 1996,Washington,4209699,2905360,69.0,2736519,65.0,168841,5.8
12696,September 1996,West Virginia,1437995,798002,55.5,739868,51.5,58134,7.3
12697,September 1996,Wisconsin,3963894,2943239,74.3,2841486,71.7,101753,3.5
12698,September 1996,Wyoming,363740,255497,70.2,242773,66.7,12724,5.0
12699,October 1996,Alabama,3293771,2102959,63.8,1995899,60.6,107060,5.1
12700,October 1996,Alaska,422293,311052,73.7,287671,68.1,23381,7.5
12701,October 1996,Arizona,3501271,2303763,65.8,2175400,62.1,128363,5.6
12702,October 1996,Arkansas,1946765,1249328,64.2,1183025,60.8,66303,5.3
12703,October 1996,California,23547505,15535052,66.0,14455817,61.4,1079235,6.9
12704,October 1996,Colorado,2993155,2155280,72.0,2066611,69.0,88669,4.1
12705,October 1996,Connecticut,2561972,1752996,68.4,1653283,64.5,99713,5.7
12706,October 1996,Delaware,568238,390150,68.7,369557,65.0,20593,5.3
12707,October 1996,District of Columbia,452980,285650,63.1,262550,58.0,23100,8.1
12708,October 1996,Florida,11650128,7241649,62.2,6876583,59.0,365066,5.0
12709,October 1996,Georgia,5632892,3869227,68.7,3684680,65.4,184547,4.8
12710,October 1996,Hawaii,880755,598500,68.0,561037,63.7,37463,6.3
12711,October 1996,Idaho,885010,623747,70.5,591240,66.8,32507,5.2
12712,October 1996,Illinois,9122411,6271503,68.7,5950270,65.2,321233,5.1
12713,October 1996,Indiana,4491526,3106305,69.2,2993675,66.7,112630,3.6
12714,October 1996,Iowa,2196904,1612447,73.4,1556324,70.8,56123,3.5
12715,October 1996,Kansas,1945969,1367542,70.3,1309662,67.3,57880,4.2
12716,October 1996,Kentucky,2994082,1893663,63.2,1786700,59.7,106963,5.6
12717,October 1996,Louisiana,3228746,2005036,62.1,1876401,58.1,128635,6.4
12718,October 1996,Maine,965100,660756,68.5,628180,65.1,32576,4.9
12719,October 1996,Maryland,3870623,2756590,71.2,2620392,67.7,136198,4.9
12720,October 1996,Massachusetts,4794186,3260753,68.0,3124281,65.2,136472,4.2
12721,October 1996,Michigan,7380381,4912992,66.6,4677242,63.4,235750,4.8
12722,October 1996,Minnesota,3556175,2662772,74.9,2561173,72.0,101599,3.8
12723,October 1996,Mississippi,2032355,1267097,62.3,1193129,58.7,73968,5.8
12724,October 1996,Missouri,4105687,2926996,71.3,2786498,67.9,140498,4.8
12725,October 1996,Montana,670234,450269,67.2,427411,63.8,22858,5.1
12726,October 1996,Nebraska,1250988,916749,73.3,892252,71.3,24497,2.7
12727,October 1996,Nevada,1305900,908370,69.6,864121,66.2,44249,4.9
12728,October 1996,New Hampshire,898849,640855,71.3,616931,68.6,23924,3.7
12729,October 1996,New Jersey,6265615,4248706,67.8,3994057,63.7,254649,6.0
12730,October 1996,New Mexico,1288403,816590,63.4,758229,58.9,58361,7.1
12731,October 1996,New York,14256632,8854420,62.1,8310147,58.3,544273,6.1
12732,October 1996,North Carolina,5755941,3943728,68.5,3783649,65.7,160079,4.1
12733,October 1996,North Dakota,484903,349610,72.1,339658,70.0,9952,2.8
12734,October 1996,Ohio,8536209,5664673,66.4,5384572,63.1,280101,4.9
12735,October 1996,Oklahoma,2491481,1592104,63.9,1528683,61.4,63421,4.0
12736,October 1996,Oregon,2516181,1728940,68.7,1628194,64.7,100746,5.8
12737,October 1996,Pennsylvania,9419021,6010525,63.8,5701071,60.5,309454,5.1
12738,October 1996,Rhode Island,791037,518992,65.6,491610,62.1,27382,5.3
12739,October 1996,South Carolina,2864193,1907843,66.6,1796032,62.7,111811,5.9
12740,October 1996,South Dakota,547284,391709,71.6,379625,69.4,12084,3.1
12741,October 1996,Tennessee,4172796,2783154,66.7,2635261,63.2,147893,5.3
12742,October 1996,Texas,14156311,9779883,69.1,9242397,65.3,537486,5.5
12743,October 1996,Utah,1465770,1048543,71.5,1013422,69.1,35121,3.3
12744,October 1996,Vermont,454998,324430,71.3,310708,68.3,13722,4.2
12745,October 1996,Virginia,5074467,3436502,67.7,3285231,64.7,151271,4.4
12746,October 1996,Washington,4216943,2910309,69.0,2744438,65.1,165871,5.7
12747,October 1996,West Virginia,1437872,798938,55.6,740235,51.5,58703,7.3
12748,October 1996,Wisconsin,3967350,2943607,74.2,2841779,71.6,101828,3.5
12749,October 1996,Wyoming,363761,255299,70.2,242525,66.7,12774,5.0
12750,November 1996,Alabama,3296573,2109300,64.0,1999974,60.7,109326,5.2
12751,November 1996,Alaska,422284,311282,73.7,287853,68.2,23429,7.5
12752,November 1996,Arizona,3512055,2302445,65.6,2175866,62.0,126579,5.5
12753,November 1996,Arkansas,1949177,1247742,64.0,1181447,60.6,66295,5.3
12754,November 1996,California,23584597,15566100,66.0,14487027,61.4,1079073,6.9
12755,November 1996,Colorado,2999133,2158188,72.0,2071489,69.1,86699,4.0
12756,November 1996,Connecticut,2563435,1755415,68.5,1654398,64.5,101017,5.8
12757,November 1996,Delaware,568314,390185,68.7,369981,65.1,20204,5.2
12758,November 1996,District of Columbia,452345,285493,63.1,262823,58.1,22670,7.9
12759,November 1996,Florida,11672483,7253775,62.1,6887385,59.0,366390,5.1
12760,November 1996,Georgia,5645903,3882100,68.8,3692538,65.4,189562,4.9
12761,November 1996,Hawaii,881886,599423,68.0,561768,63.7,37655,6.3
12762,November 1996,Idaho,887010,625630,70.5,592926,66.8,32704,5.2
12763,November 1996,Illinois,9128660,6273219,68.7,5952830,65.2,320389,5.1
12764,November 1996,Indiana,4494093,3103157,69.0,2993736,66.6,109421,3.5
12765,November 1996,Iowa,2198232,1611323,73.3,1555279,70.8,56044,3.5
12766,November 1996,Kansas,1947981,1369578,70.3,1311881,67.3,57697,4.2
12767,November 1996,Kentucky,2996132,1900404,63.4,1789059,59.7,111345,5.9
12768,November 1996,Louisiana,3230767,2006039,62.1,1878162,58.1,127877,6.4
12769,November 1996,Maine,966077,660612,68.4,628093,65.0,32519,4.9
12770,November 1996,Maryland,3873448,2757893,71.2,2620957,67.7,136936,5.0
12771,November 1996,Massachusetts,4798176,3265546,68.1,3129085,65.2,136461,4.2
12772,November 1996,Michigan,7384080,4916377,66.6,4681622,63.4,234755,4.8
12773,November 1996,Minnesota,3559860,2662878,74.8,2563288,72.0,99590,3.7
12774,November 1996,Mississippi,2034457,1267969,62.3,1193283,58.7,74686,5.9
12775,November 1996,Missouri,4110269,2927371,71.2,2785978,67.8,141393,4.8
12776,November 1996,Montana,670200,450208,67.2,427445,63.8,22763,5.1
12777,November 1996,Nebraska,1252232,917257,73.2,892860,71.3,24397,2.7
12778,November 1996,Nevada,1312826,913103,69.6,869390,66.2,43713,4.8
12779,November 1996,New Hampshire,899945,641326,71.3,617789,68.6,23537,3.7
12780,November 1996,New Jersey,6270794,4256219,67.9,4001093,63.8,255126,6.0
12781,November 1996,New Mexico,1289616,816984,63.4,759267,58.9,57717,7.1
12782,November 1996,New York,14263713,8872559,62.2,8317522,58.3,555037,6.3
12783,November 1996,North Carolina,5765428,3951622,68.5,3792260,65.8,159362,4.0
12784,November 1996,North Dakota,484975,350073,72.2,340172,70.1,9901,2.8
12785,November 1996,Ohio,8539138,5668201,66.4,5383904,63.0,284297,5.0
12786,November 1996,Oklahoma,2493670,1594233,63.9,1529407,61.3,64826,4.1
12787,November 1996,Oregon,2519451,1730731,68.7,1628489,64.6,102242,5.9
12788,November 1996,Pennsylvania,9420631,6018794,63.9,5707096,60.6,311698,5.2
12789,November 1996,Rhode Island,791526,520057,65.7,492606,62.2,27451,5.3
12790,November 1996,South Carolina,2869171,1910109,66.6,1798614,62.7,111495,5.8
12791,November 1996,South Dakota,547373,391553,71.5,379508,69.3,12045,3.1
12792,November 1996,Tennessee,4179391,2784946,66.6,2631911,63.0,153035,5.5
12793,November 1996,Texas,14181912,9799683,69.1,9254285,65.3,545398,5.6
12794,November 1996,Utah,1469219,1051224,71.5,1016036,69.2,35188,3.3
12795,November 1996,Vermont,456023,324605,71.2,310966,68.2,13639,4.2
12796,November 1996,Virginia,5080595,3435564,67.6,3283325,64.6,152239,4.4
12797,November 1996,Washington,4225186,2915661,69.0,2752374,65.1,163287,5.6
12798,November 1996,West Virginia,1438748,799504,55.6,740336,51.5,59168,7.4
12799,November 1996,Wisconsin,3970805,2943776,74.1,2840672,71.5,103104,3.5
12800,November 1996,Wyoming,364783,255038,69.9,242228,66.4,12810,5.0
12801,December 1996,Alabama,3298375,2114598,64.1,2003655,60.7,110943,5.2
12802,December 1996,Alaska,422276,311537,73.8,288064,68.2,23473,7.5
12803,December 1996,Arizona,3521838,2299865,65.3,2176018,61.8,123847,5.4
12804,December 1996,Arkansas,1951589,1246242,63.9,1180114,60.5,66128,5.3
12805,December 1996,California,23617688,15594306,66.0,14517785,61.5,1076521,6.9
12806,December 1996,Colorado,3005110,2162858,72.0,2078077,69.2,84781,3.9
12807,December 1996,Connecticut,2563898,1756700,68.5,1655272,64.6,101428,5.8
12808,December 1996,Delaware,569390,389796,68.5,370335,65.0,19461,5.0
12809,December 1996,District of Columbia,451711,284999,63.1,262741,58.2,22258,7.8
12810,December 1996,Florida,11692838,7263935,62.1,6896342,59.0,367593,5.1
12811,December 1996,Georgia,5656913,3894285,68.8,3700965,65.4,193320,5.0
12812,December 1996,Hawaii,883017,600133,68.0,562396,63.7,37737,6.3
12813,December 1996,Idaho,889011,627160,70.5,594316,66.9,32844,5.2
12814,December 1996,Illinois,9132909,6275472,68.7,5955179,65.2,320293,5.1
12815,December 1996,Indiana,4496660,3101376,69.0,2994051,66.6,107325,3.5
12816,December 1996,Iowa,2198560,1610290,73.2,1554477,70.7,55813,3.5
12817,December 1996,Kansas,1948992,1370925,70.3,1313635,67.4,57290,4.2
12818,December 1996,Kentucky,2997182,1905380,63.6,1791235,59.8,114145,6.0
12819,December 1996,Louisiana,3232789,2006414,62.1,1879456,58.1,126958,6.3
12820,December 1996,Maine,967054,660390,68.3,627587,64.9,32803,5.0
12821,December 1996,Maryland,3876272,2759019,71.2,2621207,67.6,137812,5.0
12822,December 1996,Massachusetts,4801166,3271046,68.1,3134469,65.3,136577,4.2
12823,December 1996,Michigan,7386780,4919348,66.6,4686391,63.4,232957,4.7
12824,December 1996,Minnesota,3563545,2662705,74.7,2565208,72.0,97497,3.7
12825,December 1996,Mississippi,2036559,1268810,62.3,1193719,58.6,75091,5.9
12826,December 1996,Missouri,4112851,2926639,71.2,2785811,67.7,140828,4.8
12827,December 1996,Montana,671167,450136,67.1,427274,63.7,22862,5.1
12828,December 1996,Nebraska,1252476,917697,73.3,893423,71.3,24274,2.6
12829,December 1996,Nevada,1317752,917595,69.6,874508,66.4,43087,4.7
12830,December 1996,New Hampshire,901041,641904,71.2,618682,68.7,23222,3.6
12831,December 1996,New Jersey,6274972,4260792,67.9,4007877,63.9,252915,5.9
12832,December 1996,New Mexico,1290828,817161,63.3,760175,58.9,56986,7.0
12833,December 1996,New York,14266794,8891400,62.3,8324338,58.3,567062,6.4
12834,December 1996,North Carolina,5774915,3959028,68.6,3800912,65.8,158116,4.0
12835,December 1996,North Dakota,485047,350475,72.3,340643,70.2,9832,2.8
12836,December 1996,Ohio,8540068,5672683,66.4,5384511,63.0,288172,5.1
12837,December 1996,Oklahoma,2495858,1596210,64.0,1530340,61.3,65870,4.1
12838,December 1996,Oregon,2522722,1732423,68.7,1628959,64.6,103464,6.0
12839,December 1996,Pennsylvania,9421241,6026394,64.0,5711653,60.6,314741,5.2
12840,December 1996,Rhode Island,792014,521104,65.8,493600,62.3,27504,5.3
12841,December 1996,South Carolina,2873149,1911598,66.5,1801480,62.7,110118,5.8
12842,December 1996,South Dakota,547462,391356,71.5,379356,69.3,12000,3.1
12843,December 1996,Tennessee,4184986,2784998,66.5,2628592,62.8,156406,5.6
12844,December 1996,Texas,14204514,9818710,69.1,9265933,65.2,552777,5.6
12845,December 1996,Utah,1472667,1053858,71.6,1018849,69.2,35009,3.3
12846,December 1996,Vermont,456047,324744,71.2,311186,68.2,13558,4.2
12847,December 1996,Virginia,5085722,3434466,67.5,3281278,64.5,153188,4.5
12848,December 1996,Washington,4231429,2921947,69.1,2761230,65.3,160717,5.5
12849,December 1996,West Virginia,1437625,799547,55.6,740333,51.5,59214,7.4
12850,December 1996,Wisconsin,3973261,2944416,74.1,2839383,71.5,105033,3.6
12851,December 1996,Wyoming,364804,254711,69.8,241890,66.3,12821,5.0
12852,January 1997,Alabama,3300177,2118569,64.2,2007242,60.8,111327,5.3
12853,January 1997,Alaska,422267,311835,73.8,288349,68.3,23486,7.5
12854,January 1997,Arizona,3532622,2297190,65.0,2176879,61.6,120311,5.2
12855,January 1997,Arkansas,1954001,1245137,63.7,1179361,60.4,65776,5.3
12856,January 1997,California,23649780,15620867,66.1,14551579,61.5,1069288,6.8
12857,January 1997,Colorado,3011088,2168876,72.0,2086088,69.3,82788,3.8
12858,January 1997,Connecticut,2564361,1757081,68.5,1656204,64.6,100877,5.7
12859,January 1997,Delaware,570466,389084,68.2,370563,65.0,18521,4.8
12860,January 1997,District of Columbia,452076,284153,62.9,262265,58.0,21888,7.7
12861,January 1997,Florida,11713194,7274764,62.1,6906780,59.0,367984,5.1
12862,January 1997,Georgia,5667924,3905986,68.9,3711035,65.5,194951,5.0
12863,January 1997,Hawaii,884149,600564,67.9,562848,63.7,37716,6.3
12864,January 1997,Idaho,891011,628457,70.5,595548,66.8,32909,5.2
12865,January 1997,Illinois,9137158,6278422,68.7,5959410,65.2,319012,5.1
12866,January 1997,Indiana,4499228,3101595,68.9,2995311,66.6,106284,3.4
12867,January 1997,Iowa,2199889,1609575,73.2,1554275,70.7,55300,3.4
12868,January 1997,Kansas,1950004,1371871,70.4,1315258,67.4,56613,4.1
12869,January 1997,Kentucky,2998231,1908443,63.7,1793715,59.8,114728,6.0
12870,January 1997,Louisiana,3234810,2006875,62.0,1880766,58.1,126109,6.3
12871,January 1997,Maine,968031,660208,68.2,626875,64.8,33333,5.0
12872,January 1997,Maryland,3878097,2760501,71.2,2621868,67.6,138633,5.0
12873,January 1997,Massachusetts,4804156,3277409,68.2,3140894,65.4,136515,4.2
12874,January 1997,Michigan,7389480,4922092,66.6,4692375,63.5,229717,4.7
12875,January 1997,Minnesota,3567230,2662883,74.6,2567298,72.0,95585,3.6
12876,January 1997,Mississippi,2037661,1269437,62.3,1194615,58.6,74822,5.9
12877,January 1997,Missouri,4116432,2925048,71.1,2786753,67.7,138295,4.7
12878,January 1997,Montana,671133,450130,67.1,427020,63.6,23110,5.1
12879,January 1997,Nebraska,1253719,918128,73.2,894014,71.3,24114,2.6
12880,January 1997,Nevada,1323677,921772,69.6,879330,66.4,42442,4.6
12881,January 1997,New Hampshire,902136,642684,71.2,619690,68.7,22994,3.6
12882,January 1997,New Jersey,6280150,4263041,67.9,4015019,63.9,248022,5.8
12883,January 1997,New Mexico,1292040,817271,63.3,761082,58.9,56189,6.9
12884,January 1997,New York,14270875,8911659,62.4,8333905,58.4,577754,6.5
12885,January 1997,North Carolina,5783402,3966098,68.6,3809831,65.9,156267,3.9
12886,January 1997,North Dakota,485119,350889,72.3,341042,70.3,9847,2.8
12887,January 1997,Ohio,8541997,5677353,66.5,5387758,63.1,289595,5.1
12888,January 1997,Oklahoma,2498047,1598180,64.0,1531759,61.3,66421,4.2
12889,January 1997,Oregon,2526992,1733936,68.6,1630045,64.5,103891,6.0
12890,January 1997,Pennsylvania,9420851,6033029,64.0,5715438,60.7,317591,5.3
12891,January 1997,Rhode Island,792502,522092,65.9,494580,62.4,27512,5.3
12892,January 1997,South Carolina,2877127,1912187,66.5,1804601,62.7,107586,5.6
12893,January 1997,South Dakota,547551,391270,71.5,379336,69.3,11934,3.1
12894,January 1997,Tennessee,4190581,2783640,66.4,2626470,62.7,157170,5.6
12895,January 1997,Texas,14227115,9836787,69.1,9279891,65.2,556896,5.7
12896,January 1997,Utah,1475116,1056500,71.6,1021888,69.3,34612,3.3
12897,January 1997,Vermont,457071,324873,71.1,311384,68.1,13489,4.2
12898,January 1997,Virginia,5090850,3434357,67.5,3280845,64.4,153512,4.5
12899,January 1997,Washington,4237672,2929495,69.1,2771598,65.4,157897,5.4
12900,January 1997,West Virginia,1437501,799034,55.6,740327,51.5,58707,7.3
12901,January 1997,Wisconsin,3975716,2946071,74.1,2839016,71.4,107055,3.6
12902,January 1997,Wyoming,364826,254349,69.7,241542,66.2,12807,5.0
12903,February 1997,Alabama,3300979,2121552,64.3,2010937,60.9,110615,5.2
12904,February 1997,Alaska,422259,312154,73.9,288732,68.4,23422,7.5
12905,February 1997,Arizona,3541406,2295259,64.8,2178922,61.5,116337,5.1
12906,February 1997,Arkansas,1955412,1244553,63.6,1179196,60.3,65357,5.3
12907,February 1997,California,23675872,15647167,66.1,14590214,61.6,1056953,6.8
12908,February 1997,Colorado,3016065,2175964,72.1,2095308,69.5,80656,3.7
12909,February 1997,Connecticut,2563825,1757022,68.5,1657465,64.6,99557,5.7
12910,February 1997,Delaware,570542,388242,68.0,370666,65.0,17576,4.5
12911,February 1997,District of Columbia,451442,283101,62.7,261492,57.9,21609,7.6
12912,February 1997,Florida,11730549,7288426,62.1,6921305,59.0,367121,5.0
12913,February 1997,Georgia,5677935,3916821,69.0,3722609,65.6,194212,5.0
12914,February 1997,Hawaii,884280,600739,67.9,563099,63.7,37640,6.3
12915,February 1997,Idaho,892011,629671,70.6,596786,66.9,32885,5.2
12916,February 1997,Illinois,9139407,6281418,68.7,5966112,65.3,315306,5.0
12917,February 1997,Indiana,4499795,3104132,69.0,2998120,66.6,106012,3.4
12918,February 1997,Iowa,2200217,1609089,73.1,1554690,70.7,54399,3.4
12919,February 1997,Kansas,1951016,1372735,70.4,1317072,67.5,55663,4.1
12920,February 1997,Kentucky,2998281,1910034,63.7,1796903,59.9,113131,5.9
12921,February 1997,Louisiana,3235831,2008106,62.1,1882548,58.2,125558,6.3
12922,February 1997,Maine,968008,659972,68.2,626066,64.7,33906,5.1
12923,February 1997,Maryland,3878922,2762384,71.2,2623190,67.6,139194,5.0
12924,February 1997,Massachusetts,4806146,3284313,68.3,3148203,65.5,136110,4.1
12925,February 1997,Michigan,7390180,4925057,66.6,4699936,63.6,225121,4.6
12926,February 1997,Minnesota,3569915,2663711,74.6,2569931,72.0,93780,3.5
12927,February 1997,Mississippi,2038763,1269787,62.3,1195876,58.7,73911,5.8
12928,February 1997,Missouri,4118014,2922991,71.0,2788926,67.7,134065,4.6
12929,February 1997,Montana,672099,450239,67.0,426805,63.5,23434,5.2
12930,February 1997,Nebraska,1253963,918584,73.3,894704,71.4,23880,2.6
12931,February 1997,Nevada,1329603,925608,69.6,883736,66.5,41872,4.5
12932,February 1997,New Hampshire,903232,643714,71.3,620873,68.7,22841,3.5
12933,February 1997,New Jersey,6282328,4264045,67.9,4022538,64.0,241507,5.7
12934,February 1997,New Mexico,1293252,817538,63.2,762192,58.9,55346,6.8
12935,February 1997,New York,14270956,8933963,62.6,8348269,58.5,585694,6.6
12936,February 1997,North Carolina,5790889,3973048,68.6,3818857,65.9,154191,3.9
12937,February 1997,North Dakota,485191,351296,72.4,341331,70.3,9965,2.8
12938,February 1997,Ohio,8539927,5680985,66.5,5393991,63.2,286994,5.1
12939,February 1997,Oklahoma,2499236,1600324,64.0,1533753,61.4,66571,4.2
12940,February 1997,Oregon,2529263,1735434,68.6,1632039,64.5,103395,6.0
12941,February 1997,Pennsylvania,9418461,6038826,64.1,5719061,60.7,319765,5.3
12942,February 1997,Rhode Island,791990,523086,66.0,495604,62.6,27482,5.3
12943,February 1997,South Carolina,2880105,1912019,66.4,1807847,62.8,104172,5.4
12944,February 1997,South Dakota,547640,391419,71.5,379588,69.3,11831,3.0
12945,February 1997,Tennessee,4195177,2781821,66.3,2626027,62.6,155794,5.6
12946,February 1997,Texas,14246716,9854163,69.2,9297416,65.3,556747,5.6
12947,February 1997,Utah,1477564,1059147,71.7,1025057,69.4,34090,3.2
12948,February 1997,Vermont,457096,325067,71.1,311648,68.2,13419,4.1
12949,February 1997,Virginia,5093978,3435804,67.4,3283191,64.5,152613,4.4
12950,February 1997,Washington,4242915,2938576,69.3,2783521,65.6,155055,5.3
12951,February 1997,West Virginia,1437378,798191,55.5,740456,51.5,57735,7.2
12952,February 1997,Wisconsin,3976172,2948753,74.2,2840261,71.4,108492,3.7
12953,February 1997,Wyoming,364847,254010,69.6,241255,66.1,12755,5.0
12954,March 1997,Alabama,3302781,2124300,64.3,2014913,61.0,109387,5.1
12955,March 1997,Alaska,423250,312474,73.8,289200,68.3,23274,7.4
12956,March 1997,Arizona,3551190,2294630,64.6,2182466,61.5,112164,4.9
12957,March 1997,Arkansas,1956824,1244493,63.6,1179482,60.3,65011,5.2
12958,March 1997,California,23703963,15675166,66.1,14635058,61.7,1040108,6.6
12959,March 1997,Colorado,3022043,2184274,72.3,2105744,69.7,78530,3.6
12960,March 1997,Connecticut,2564288,1756950,68.5,1659255,64.7,97695,5.6
12961,March 1997,Delaware,570618,387488,67.9,370729,65.0,16759,4.3
12962,March 1997,District of Columbia,450808,282074,62.6,260622,57.8,21452,7.6
12963,March 1997,Florida,11748904,7306706,62.2,6942087,59.1,364619,5.0
12964,March 1997,Georgia,5687946,3926763,69.0,3735508,65.7,191255,4.9
12965,March 1997,Hawaii,885411,600793,67.9,563215,63.6,37578,6.3
12966,March 1997,Idaho,893011,630862,70.6,598077,67.0,32785,5.2
12967,March 1997,Illinois,9142656,6284193,68.7,5975503,65.4,308690,4.9
12968,March 1997,Indiana,4501363,3108972,69.1,3002840,66.7,106132,3.4
12969,March 1997,Iowa,2200545,1608531,73.1,1555415,70.7,53116,3.3
12970,March 1997,Kansas,1952028,1373921,70.4,1319471,67.6,54450,4.0
12971,March 1997,Kentucky,2999331,1911130,63.7,1801001,60.0,110129,5.8
12972,March 1997,Louisiana,3236853,2010501,62.1,1885274,58.2,125227,6.2
12973,March 1997,Maine,967984,659581,68.1,625293,64.6,34288,5.2
12974,March 1997,Maryland,3880746,2764150,71.2,2625090,67.6,139060,5.0
12975,March 1997,Massachusetts,4808136,3291413,68.5,3156131,65.6,135282,4.1
12976,March 1997,Michigan,7391880,4929012,66.7,4709700,63.7,219312,4.4
12977,March 1997,Minnesota,3572600,2665342,74.6,2573419,72.0,91923,3.4
12978,March 1997,Mississippi,2040864,1270100,62.2,1197426,58.7,72674,5.7
12979,March 1997,Missouri,4120595,2921303,70.9,2792583,67.8,128720,4.4
12980,March 1997,Montana,672065,450499,67.0,426740,63.5,23759,5.3
12981,March 1997,Nebraska,1254207,919069,73.3,895502,71.4,23567,2.6
12982,March 1997,Nevada,1334528,929129,69.6,887726,66.5,41403,4.5
12983,March 1997,New Hampshire,904328,644985,71.3,622264,68.8,22721,3.5
12984,March 1997,New Jersey,6285506,4264848,67.9,4030314,64.1,234534,5.5
12985,March 1997,New Mexico,1294464,818163,63.2,763721,59.0,54442,6.7
12986,March 1997,New York,14273037,8958859,62.8,8368885,58.6,589974,6.6
12987,March 1997,North Carolina,5798376,3979937,68.6,3827785,66.0,152152,3.8
12988,March 1997,North Dakota,485263,351628,72.5,341501,70.4,10127,2.9
12989,March 1997,Ohio,8539856,5683049,66.5,5403191,63.3,279858,4.9
12990,March 1997,Oklahoma,2501425,1602724,64.1,1536283,61.4,66441,4.1
12991,March 1997,Oregon,2532533,1737199,68.6,1635118,64.6,102081,5.9
12992,March 1997,Pennsylvania,9417071,6044049,64.2,5723357,60.8,320692,5.3
12993,March 1997,Rhode Island,792479,524164,66.1,496733,62.7,27431,5.2
12994,March 1997,South Carolina,2883083,1911483,66.3,1811277,62.8,100206,5.2
12995,March 1997,South Dakota,547728,391842,71.5,380141,69.4,11701,3.0
12996,March 1997,Tennessee,4199772,2781017,66.2,2627624,62.6,153393,5.5
12997,March 1997,Texas,14267318,9871623,69.2,9319393,65.3,552230,5.6
12998,March 1997,Utah,1481013,1061777,71.7,1028232,69.4,33545,3.2
12999,March 1997,Vermont,457120,325416,71.2,312086,68.3,13330,4.1
13000,March 1997,Virginia,5099105,3439301,67.4,3289122,64.5,150179,4.4
13001,March 1997,Washington,4249159,2949121,69.4,2796856,65.8,152265,5.2
13002,March 1997,West Virginia,1437254,797331,55.5,740836,51.5,56495,7.1
13003,March 1997,Wisconsin,3978627,2952383,74.2,2843528,71.5,108855,3.7
13004,March 1997,Wyoming,364869,253773,69.6,241117,66.1,12656,5.0
13005,April 1997,Alabama,3303583,2127790,64.4,2019197,61.1,108593,5.1
13006,April 1997,Alaska,423241,312777,73.9,289711,68.5,23066,7.4
13007,April 1997,Arizona,3560974,2295727,64.5,2187407,61.4,108320,4.7
13008,April 1997,Arkansas,1958236,1244777,63.6,1179872,60.3,64905,5.2
13009,April 1997,California,23735055,15707982,66.2,14684531,61.9,1023451,6.5
13010,April 1997,Colorado,3028020,2193734,72.4,2117069,69.9,76665,3.5
13011,April 1997,Connecticut,2564751,1757076,68.5,1661529,64.8,95547,5.4
13012,April 1997,Delaware,571694,386978,67.7,370844,64.9,16134,4.2
13013,April 1997,District of Columbia,451173,281340,62.4,259880,57.6,21460,7.6
13014,April 1997,Florida,11768259,7329934,62.3,6968355,59.2,361579,4.9
13015,April 1997,Georgia,5698957,3936876,69.1,3749483,65.8,187393,4.8
13016,April 1997,Hawaii,886542,600925,67.8,563314,63.5,37611,6.3
13017,April 1997,Idaho,895011,632040,70.6,599366,67.0,32674,5.2
13018,April 1997,Illinois,9145905,6287855,68.8,5986729,65.5,301126,4.8
13019,April 1997,Indiana,4502930,3115443,69.2,3008569,66.8,106874,3.4
13020,April 1997,Iowa,2200873,1607673,73.0,1555942,70.7,51731,3.2
13021,April 1997,Kansas,1953040,1375694,70.4,1322523,67.7,53171,3.9
13022,April 1997,Kentucky,3000381,1912940,63.8,1805827,60.2,107113,5.6
13023,April 1997,Louisiana,3238874,2013976,62.2,1888919,58.3,125057,6.2
13024,April 1997,Maine,968961,659035,68.0,624696,64.5,34339,5.2
13025,April 1997,Maryland,3882571,2765679,71.2,2627195,67.7,138484,5.0
13026,April 1997,Massachusetts,4811126,3298297,68.6,3164031,65.8,134266,4.1
13027,April 1997,Michigan,7393579,4934959,66.7,4721344,63.9,213615,4.3
13028,April 1997,Minnesota,3575285,2668227,74.6,2577907,72.1,90320,3.4
13029,April 1997,Mississippi,2041966,1270737,62.2,1198932,58.7,71805,5.7
13030,April 1997,Missouri,4124177,2921364,70.8,2797333,67.8,124031,4.2
13031,April 1997,Montana,672032,450895,67.1,426879,63.5,24016,5.3
13032,April 1997,Nebraska,1255451,919624,73.3,896342,71.4,23282,2.5
13033,April 1997,Nevada,1340454,932467,69.6,891405,66.5,41062,4.4
13034,April 1997,New Hampshire,905424,646439,71.4,623855,68.9,22584,3.5
13035,April 1997,New Jersey,6289685,4266430,67.8,4037673,64.2,228757,5.4
13036,April 1997,New Mexico,1295677,819252,63.2,765723,59.1,53529,6.5
13037,April 1997,New York,14275118,8986277,63.0,8394265,58.8,592012,6.6
13038,April 1997,North Carolina,5806863,3986585,68.7,3835700,66.1,150885,3.8
13039,April 1997,North Dakota,485335,351828,72.5,341570,70.4,10258,2.9
13040,April 1997,Ohio,8540785,5684780,66.6,5414520,63.4,270260,4.8
13041,April 1997,Oklahoma,2503614,1605364,64.1,1539051,61.5,66313,4.1
13042,April 1997,Oregon,2535804,1739713,68.6,1639208,64.6,100505,5.8
13043,April 1997,Pennsylvania,9415681,6049559,64.2,5728804,60.8,320755,5.3
13044,April 1997,Rhode Island,792967,525376,66.3,497993,62.8,27383,5.2
13045,April 1997,South Carolina,2887061,1911093,66.2,1814802,62.9,96291,5.0
13046,April 1997,South Dakota,547817,392498,71.6,380915,69.5,11583,3.0
13047,April 1997,Tennessee,4205367,2782739,66.2,2630973,62.6,151766,5.5
13048,April 1997,Texas,14288919,9890605,69.2,9345189,65.4,545416,5.5
13049,April 1997,Utah,1483461,1064392,71.8,1031264,69.5,33128,3.1
13050,April 1997,Vermont,457145,325933,71.3,312721,68.4,13212,4.1
13051,April 1997,Virginia,5103233,3444586,67.5,3297920,64.6,146666,4.3
13052,April 1997,Washington,4255402,2960879,69.6,2811015,66.1,149864,5.1
13053,April 1997,West Virginia,1436131,796690,55.5,741420,51.6,55270,6.9
13054,April 1997,Wisconsin,3980083,2957095,74.3,2848652,71.6,108443,3.7
13055,April 1997,Wyoming,364890,253654,69.5,241142,66.1,12512,4.9
13056,May 1997,Alabama,3305385,2132016,64.5,2023465,61.2,108551,5.1
13057,May 1997,Alaska,423233,313056,74.0,290215,68.6,22841,7.3
13058,May 1997,Arizona,3570757,2298135,64.4,2192966,61.4,105169,4.6
13059,May 1997,Arkansas,1960648,1244981,63.5,1179951,60.2,65030,5.2
13060,May 1997,California,23767146,15743525,66.2,14733392,62.0,1010133,6.4
13061,May 1997,Colorado,3033998,2203618,72.6,2128448,70.2,75170,3.4
13062,May 1997,Connecticut,2565214,1757058,68.5,1663866,64.9,93192,5.3
13063,May 1997,Delaware,572770,386735,67.5,371047,64.8,15688,4.1
13064,May 1997,District of Columbia,450539,281052,62.4,259399,57.6,21653,7.7
13065,May 1997,Florida,11788614,7353959,62.4,6995619,59.3,358340,4.9
13066,May 1997,Georgia,5709968,3946794,69.1,3763232,65.9,183562,4.7
13067,May 1997,Hawaii,887673,601226,67.7,563470,63.5,37756,6.3
13068,May 1997,Idaho,897011,633184,70.6,600568,67.0,32616,5.2
13069,May 1997,Illinois,9150154,6291638,68.8,5997048,65.5,294590,4.7
13070,May 1997,Indiana,4505497,3121884,69.3,3013603,66.9,108281,3.5
13071,May 1997,Iowa,2202201,1606213,72.9,1555740,70.6,50473,3.1
13072,May 1997,Kansas,1954052,1377933,70.5,1325860,67.9,52073,3.8
13073,May 1997,Kentucky,3001431,1915531,63.8,1810720,60.3,104811,5.5
13074,May 1997,Louisiana,3240895,2017640,62.3,1892896,58.4,124744,6.2
13075,May 1997,Maine,969938,658285,67.9,624254,64.4,34031,5.2
13076,May 1997,Maryland,3884396,2766699,71.2,2628923,67.7,137776,5.0
13077,May 1997,Massachusetts,4814116,3303928,68.6,3170810,65.9,133118,4.0
13078,May 1997,Michigan,7396279,4942295,66.8,4733004,64.0,209291,4.2
13079,May 1997,Minnesota,3578970,2672438,74.7,2583236,72.2,89202,3.3
13080,May 1997,Mississippi,2044068,1271678,62.2,1199944,58.7,71734,5.6
13081,May 1997,Missouri,4126758,2923165,70.8,2801579,67.9,121586,4.2
13082,May 1997,Montana,672998,451386,67.1,427212,63.5,24174,5.4
13083,May 1997,Nebraska,1256694,920256,73.2,897159,71.4,23097,2.5
13084,May 1997,Nevada,1346380,935714,69.5,894851,66.5,40863,4.4
13085,May 1997,New Hampshire,906519,647959,71.5,625591,69.0,22368,3.5
13086,May 1997,New Jersey,6293863,4268310,67.8,4043269,64.2,225041,5.3
13087,May 1997,New Mexico,1296889,820687,63.3,768053,59.2,52634,6.4
13088,May 1997,New York,14279199,9012356,63.1,8419436,59.0,592920,6.6
13089,May 1997,North Carolina,5815350,3991196,68.6,3840948,66.0,150248,3.8
13090,May 1997,North Dakota,485407,351869,72.5,341578,70.4,10291,2.9
13091,May 1997,Ohio,8541715,5686861,66.6,5425890,63.5,260971,4.6
13092,May 1997,Oklahoma,2505802,1607928,64.2,1541575,61.5,66353,4.1
13093,May 1997,Oregon,2539074,1743065,68.6,1643904,64.7,99161,5.7
13094,May 1997,Pennsylvania,9416291,6054931,64.3,5734924,60.9,320007,5.3
13095,May 1997,Rhode Island,793455,526711,66.4,499361,62.9,27350,5.2
13096,May 1997,South Carolina,2891039,1911059,66.1,1818371,62.9,92688,4.9
13097,May 1997,South Dakota,548906,393245,71.6,381737,69.5,11508,2.9
13098,May 1997,Tennessee,4210962,2786108,66.2,2634707,62.6,151401,5.4
13099,May 1997,Texas,14311520,9909452,69.2,9371279,65.5,538173,5.4
13100,May 1997,Utah,1486909,1066964,71.8,1034003,69.5,32961,3.1
13101,May 1997,Vermont,458169,326601,71.3,313538,68.4,13063,4.0
13102,May 1997,Virginia,5108361,3449329,67.5,3307182,64.7,142147,4.1
13103,May 1997,Washington,4262645,2972586,69.7,2824594,66.3,147992,5.0
13104,May 1997,West Virginia,1436007,796247,55.4,741989,51.7,54258,6.8
13105,May 1997,Wisconsin,3982538,2962434,74.4,2854757,71.7,107677,3.6
13106,May 1997,Wyoming,364912,253620,69.5,241284,66.1,12336,4.9
13107,June 1997,Alabama,3307188,2136263,64.6,2027419,61.3,108844,5.1
13108,June 1997,Alaska,423224,313294,74.0,290679,68.7,22615,7.2
13109,June 1997,Arizona,3581541,2301551,64.3,2198669,61.4,102882,4.5
13110,June 1997,Arkansas,1962060,1244657,63.4,1179429,60.1,65228,5.2
13111,June 1997,California,23800238,15778082,66.3,14778297,62.1,999785,6.3
13112,June 1997,Colorado,3039975,2213431,72.8,2139347,70.4,74084,3.3
13113,June 1997,Connecticut,2565677,1756399,68.5,1665824,64.9,90575,5.2
13114,June 1997,Delaware,572846,386686,67.5,371352,64.8,15334,4.0
13115,June 1997,District of Columbia,449904,281170,62.5,259168,57.6,22002,7.8
13116,June 1997,Florida,11808970,7374788,62.5,7020262,59.4,354526,4.8
13117,June 1997,Georgia,5720979,3955998,69.1,3776003,66.0,179995,4.5
13118,June 1997,Hawaii,888804,601580,67.7,563703,63.4,37877,6.3
13119,June 1997,Idaho,898011,634171,70.6,601584,67.0,32587,5.1
13120,June 1997,Illinois,9154402,6295146,68.8,6004697,65.6,290449,4.6
13121,June 1997,Indiana,4508065,3126957,69.4,3016917,66.9,110040,3.5
13122,June 1997,Iowa,2202529,1604068,72.8,1554651,70.6,49417,3.1
13123,June 1997,Kansas,1955063,1380300,70.6,1329096,68.0,51204,3.7
13124,June 1997,Kentucky,3002480,1918248,63.9,1815100,60.5,103148,5.4
13125,June 1997,Louisiana,3242916,2020819,62.3,1896882,58.5,123937,6.1
13126,June 1997,Maine,969915,657302,67.8,623857,64.3,33445,5.1
13127,June 1997,Maryland,3886221,2767100,71.2,2630057,67.7,137043,5.0
13128,June 1997,Massachusetts,4817106,3307949,68.7,3176212,65.9,131737,4.0
13129,June 1997,Michigan,7398979,4950023,66.9,4743300,64.1,206723,4.2
13130,June 1997,Minnesota,3582655,2677436,74.7,2589074,72.3,88362,3.3
13131,June 1997,Mississippi,2045170,1272747,62.2,1200423,58.7,72324,5.7
13132,June 1997,Missouri,4130340,2926115,70.8,2804521,67.9,121594,4.2
13133,June 1997,Montana,672964,451918,67.2,427673,63.6,24245,5.4
13134,June 1997,Nebraska,1256938,920904,73.3,897914,71.4,22990,2.5
13135,June 1997,Nevada,1351305,938889,69.5,898102,66.5,40787,4.3
13136,June 1997,New Hampshire,907615,649407,71.6,627363,69.1,22044,3.4
13137,June 1997,New Jersey,6298041,4269377,67.8,4046560,64.3,222817,5.2
13138,June 1997,New Mexico,1298101,822204,63.3,770466,59.4,51738,6.3
13139,June 1997,New York,14283279,9033067,63.2,8440764,59.1,592303,6.6
13140,June 1997,North Carolina,5824838,3992555,68.5,3843024,66.0,149531,3.7
13141,June 1997,North Dakota,485478,351750,72.5,341582,70.4,10168,2.9
13142,June 1997,Ohio,8543644,5689745,66.6,5435731,63.6,254014,4.5
13143,June 1997,Oklahoma,2507991,1610165,64.2,1543721,61.6,66444,4.1
13144,June 1997,Oregon,2542345,1747119,68.7,1648876,64.9,98243,5.6
13145,June 1997,Pennsylvania,9415902,6059396,64.4,5741451,61.0,317945,5.2
13146,June 1997,Rhode Island,793943,528058,66.5,500737,63.1,27321,5.2
13147,June 1997,South Carolina,2895017,1911124,66.0,1821943,62.9,89181,4.7
13148,June 1997,South Dakota,548995,393892,71.7,382411,69.7,11481,2.9
13149,June 1997,Tennessee,4216557,2789245,66.1,2637983,62.6,151262,5.4
13150,June 1997,Texas,14335122,9925891,69.2,9395133,65.5,530758,5.3
13151,June 1997,Utah,1489358,1069413,71.8,1036363,69.6,33050,3.1
13152,June 1997,Vermont,458193,327374,71.4,314492,68.6,12882,3.9
13153,June 1997,Virginia,5113488,3451876,67.5,3315314,64.8,136562,4.0
13154,June 1997,Washington,4268888,2983172,69.9,2836754,66.5,146418,4.9
13155,June 1997,West Virginia,1435884,795949,55.4,742415,51.7,53534,6.7
13156,June 1997,Wisconsin,3984994,2968036,74.5,2861245,71.8,106791,3.6
13157,June 1997,Wyoming,365933,253605,69.3,241465,66.0,12140,4.8
13158,July 1997,Alabama,3308990,2139910,64.7,2031063,61.4,108847,5.1
13159,July 1997,Alaska,423215,313475,74.1,291091,68.8,22384,7.1
13160,July 1997,Arizona,3591325,2305960,64.2,2204528,61.4,101432,4.4
13161,July 1997,Arkansas,1964471,1243704,63.3,1178391,60.0,65313,5.3
13162,July 1997,California,23834329,15810801,66.3,14819455,62.2,991346,6.3
13163,July 1997,Colorado,3045953,2223076,73.0,2149562,70.6,73514,3.3
13164,July 1997,Connecticut,2566140,1754926,68.4,1667311,65.0,87615,5.0
13165,July 1997,Delaware,573922,386764,67.4,371772,64.8,14992,3.9
13166,July 1997,District of Columbia,450270,281567,62.5,259129,57.5,22438,8.0
13167,July 1997,Florida,11830325,7391349,62.5,7041164,59.5,350185,4.7
13168,July 1997,Georgia,5732990,3964918,69.2,3788057,66.1,176861,4.5
13169,July 1997,Hawaii,888936,601792,67.7,563952,63.4,37840,6.3
13170,July 1997,Idaho,900011,634849,70.5,602329,66.9,32520,5.1
13171,July 1997,Illinois,9159651,6299557,68.8,6010198,65.6,289359,4.6
13172,July 1997,Indiana,4510632,3130112,69.4,3018450,66.9,111662,3.6
13173,July 1997,Iowa,2203857,1601675,72.7,1553012,70.5,48663,3.0
13174,July 1997,Kansas,1957075,1382574,70.6,1332004,68.1,50570,3.7
13175,July 1997,Kentucky,3003530,1920531,63.9,1818831,60.6,101700,5.3
13176,July 1997,Louisiana,3244938,2023601,62.4,1901115,58.6,122486,6.1
13177,July 1997,Maine,970892,656193,67.6,623436,64.2,32757,5.0
13178,July 1997,Maryland,3889045,2767296,71.2,2630857,67.6,136439,4.9
13179,July 1997,Massachusetts,4820096,3310952,68.7,3180910,66.0,130042,3.9
13180,July 1997,Michigan,7402679,4957807,67.0,4752198,64.2,205609,4.1
13181,July 1997,Minnesota,3586340,2682412,74.8,2595033,72.4,87379,3.3
13182,July 1997,Mississippi,2047272,1273822,62.2,1200698,58.6,73124,5.7
13183,July 1997,Missouri,4133921,2929603,70.9,2806503,67.9,123100,4.2
13184,July 1997,Montana,673930,452504,67.1,428248,63.5,24256,5.4
13185,July 1997,Nebraska,1258182,921559,73.2,898653,71.4,22906,2.5
13186,July 1997,Nevada,1357231,942001,69.4,901220,66.4,40781,4.3
13187,July 1997,New Hampshire,908711,650661,71.6,629021,69.2,21640,3.3
13188,July 1997,New Jersey,6302219,4268991,67.7,4048062,64.2,220929,5.2
13189,July 1997,New Mexico,1299313,823669,63.4,772766,59.5,50903,6.2
13190,July 1997,New York,14288360,9046902,63.3,8457735,59.2,589167,6.5
13191,July 1997,North Carolina,5833325,3991494,68.4,3843069,65.9,148425,3.7
13192,July 1997,North Dakota,485550,351530,72.4,341657,70.4,9873,2.8
13193,July 1997,Ohio,8545573,5694278,66.6,5443764,63.7,250514,4.4
13194,July 1997,Oklahoma,2510180,1612098,64.2,1545693,61.6,66405,4.1
13195,July 1997,Oregon,2545615,1751600,68.8,1653969,65.0,97631,5.6
13196,July 1997,Pennsylvania,9416512,6062910,64.4,5748703,61.0,314207,5.2
13197,July 1997,Rhode Island,793432,529274,66.7,501995,63.3,27279,5.2
13198,July 1997,South Carolina,2898995,1911037,65.9,1825560,63.0,85477,4.5
13199,July 1997,South Dakota,549084,394354,71.8,382885,69.7,11469,2.9
13200,July 1997,Tennessee,4222152,2791317,66.1,2640948,62.5,150369,5.4
13201,July 1997,Texas,14358723,9939510,69.2,9416480,65.6,523030,5.3
13202,July 1997,Utah,1492806,1071713,71.8,1038390,69.6,33323,3.1
13203,July 1997,Vermont,459218,328195,71.5,315507,68.7,12688,3.9
13204,July 1997,Virginia,5118616,3452464,67.4,3322216,64.9,130248,3.8
13205,July 1997,Washington,4276131,2992356,70.0,2847664,66.6,144692,4.8
13206,July 1997,West Virginia,1435760,795869,55.4,742706,51.7,53163,6.7
13207,July 1997,Wisconsin,3987449,2974002,74.6,2868093,71.9,105909,3.6
13208,July 1997,Wyoming,365955,253588,69.3,241640,66.0,11948,4.7
13209,August 1997,Alabama,3312792,2142358,64.7,2034281,61.4,108077,5.0
13210,August 1997,Alaska,424207,313610,73.9,291474,68.7,22136,7.1
13211,August 1997,Arizona,3600109,2311287,64.2,2210559,61.4,100728,4.4
13212,August 1997,Arkansas,1965883,1242413,63.2,1177158,59.9,65255,5.3
13213,August 1997,California,23876421,15842518,66.4,14858017,62.2,984501,6.2
13214,August 1997,Colorado,3051930,2232379,73.1,2158855,70.7,73524,3.3
13215,August 1997,Connecticut,2567603,1752684,68.3,1668386,65.0,84298,4.8
13216,August 1997,Delaware,573998,386952,67.4,372316,64.9,14636,3.8
13217,August 1997,District of Columbia,450636,282131,62.6,259223,57.5,22908,8.1
13218,August 1997,Florida,11851680,7404058,62.5,7058020,59.6,346038,4.7
13219,August 1997,Georgia,5744000,3974237,69.2,3799734,66.2,174503,4.4
13220,August 1997,Hawaii,890067,601745,67.6,564099,63.4,37646,6.3
13221,August 1997,Idaho,901012,635214,70.5,602773,66.9,32441,5.1
13222,August 1997,Illinois,9166900,6305490,68.8,6014181,65.6,291309,4.6
13223,August 1997,Indiana,4513200,3131417,69.4,3018608,66.9,112809,3.6
13224,August 1997,Iowa,2205185,1599568,72.5,1551366,70.4,48202,3.0
13225,August 1997,Kansas,1958087,1384738,70.7,1334562,68.2,50176,3.6
13226,August 1997,Kentucky,3007580,1921979,63.9,1821984,60.6,99995,5.2
13227,August 1997,Louisiana,3246959,2026302,62.4,1905702,58.7,120600,6.0
13228,August 1997,Maine,970869,655166,67.5,622906,64.2,32260,4.9
13229,August 1997,Maryland,3891870,2767856,71.1,2631669,67.6,136187,4.9
13230,August 1997,Massachusetts,4824086,3313558,68.7,3185527,66.0,128031,3.9
13231,August 1997,Michigan,7406378,4965717,67.0,4760203,64.3,205514,4.1
13232,August 1997,Minnesota,3590025,2686805,74.8,2600764,72.4,86041,3.2
13233,August 1997,Mississippi,2049374,1274809,62.2,1201128,58.6,73681,5.8
13234,August 1997,Missouri,4137503,2932760,70.9,2807624,67.9,125136,4.3
13235,August 1997,Montana,673897,453216,67.3,428954,63.7,24262,5.4
13236,August 1997,Nebraska,1259426,922210,73.2,899417,71.4,22793,2.5
13237,August 1997,Nevada,1363156,944991,69.3,904168,66.3,40823,4.3
13238,August 1997,New Hampshire,909806,651650,71.6,630463,69.3,21187,3.3
13239,August 1997,New Jersey,6308398,4267202,67.6,4048492,64.2,218710,5.1
13240,August 1997,New Mexico,1301526,825085,63.4,774826,59.5,50259,6.1
13241,August 1997,New York,14298441,9054149,63.3,8470816,59.2,583333,6.4
13242,August 1997,North Carolina,5843812,3989338,68.3,3842101,65.7,147237,3.7
13243,August 1997,North Dakota,485622,351301,72.3,341842,70.4,9459,2.7
13244,August 1997,Ohio,8549503,5700403,66.7,5449751,63.7,250652,4.4
13245,August 1997,Oklahoma,2512369,1613684,64.2,1547658,61.6,66026,4.1
13246,August 1997,Oregon,2549886,1756214,68.9,1658898,65.1,97316,5.5
13247,August 1997,Pennsylvania,9420122,6065444,64.4,5756498,61.1,308946,5.1
13248,August 1997,Rhode Island,794920,530252,66.7,503052,63.3,27200,5.1
13249,August 1997,South Carolina,2902973,1911076,65.8,1829413,63.0,81663,4.3
13250,August 1997,South Dakota,549173,394661,71.9,383211,69.8,11450,2.9
13251,August 1997,Tennessee,4227747,2791968,66.0,2643732,62.5,148236,5.3
13252,August 1997,Texas,14384324,9951222,69.2,9435322,65.6,515900,5.2
13253,August 1997,Utah,1496255,1073984,71.8,1040240,69.5,33744,3.1
13254,August 1997,Vermont,459242,329008,71.6,316487,68.9,12521,3.8
13255,August 1997,Virginia,5123744,3451739,67.4,3327926,65.0,123813,3.6
13256,August 1997,Washington,4283375,3000201,70.0,2857166,66.7,143035,4.8
13257,August 1997,West Virginia,1435637,795929,55.4,742862,51.7,53067,6.7
13258,August 1997,Wisconsin,3990905,2979907,74.7,2874850,72.0,105057,3.5
13259,August 1997,Wyoming,365976,253586,69.3,241807,66.1,11779,4.6
13260,September 1997,Alabama,3316594,2142854,64.6,2036969,61.4,105885,4.9
13261,September 1997,Alaska,424198,313749,74.0,291892,68.8,21857,7.0
13262,September 1997,Arizona,3607892,2317375,64.2,2216894,61.4,100481,4.3
13263,September 1997,Arkansas,1968295,1241126,63.1,1176057,59.8,65069,5.2
13264,September 1997,California,23918512,15873595,66.4,14895810,62.3,977785,6.2
13265,September 1997,Colorado,3057908,2241375,73.3,2167279,70.9,74096,3.3
13266,September 1997,Connecticut,2568066,1750008,68.1,1669258,65.0,80750,4.6
13267,September 1997,Delaware,575074,387294,67.3,372980,64.9,14314,3.7
13268,September 1997,District of Columbia,451001,282841,62.7,259439,57.5,23402,8.3
13269,September 1997,Florida,11874035,7414542,62.4,7072055,59.6,342487,4.6
13270,September 1997,Georgia,5756011,3984361,69.2,3811416,66.2,172945,4.3
13271,September 1997,Hawaii,891198,601364,67.5,564075,63.3,37289,6.2
13272,September 1997,Idaho,903012,635488,70.4,603105,66.8,32383,5.1
13273,September 1997,Illinois,9175149,6312571,68.8,6017720,65.6,294851,4.7
13274,September 1997,Indiana,4516767,3131239,69.3,3018252,66.8,112987,3.6
13275,September 1997,Iowa,2206513,1598100,72.4,1550350,70.3,47750,3.0
13276,September 1997,Kansas,1960099,1386841,70.8,1337022,68.2,49819,3.6
13277,September 1997,Kentucky,3010630,1922301,63.9,1824738,60.6,97563,5.1
13278,September 1997,Louisiana,3248980,2029048,62.5,1910612,58.8,118436,5.8
13279,September 1997,Maine,971845,654350,67.3,622265,64.0,32085,4.9
13280,September 1997,Maryland,3895695,2768996,71.1,2632812,67.6,136184,4.9
13281,September 1997,Massachusetts,4828076,3316163,68.7,3190502,66.1,125661,3.8
13282,September 1997,Michigan,7410078,4974171,67.1,4768260,64.3,205911,4.1
13283,September 1997,Minnesota,3593710,2690360,74.9,2605980,72.5,84380,3.1
13284,September 1997,Mississippi,2051476,1275551,62.2,1202015,58.6,73536,5.8
13285,September 1997,Missouri,4140085,2934800,70.9,2807969,67.8,126831,4.3
13286,September 1997,Montana,674863,454100,67.3,429783,63.7,24317,5.4
13287,September 1997,Nebraska,1259669,922819,73.3,900257,71.5,22562,2.4
13288,September 1997,Nevada,1368082,947759,69.3,906793,66.3,40966,4.3
13289,September 1997,New Hampshire,910902,652407,71.6,631701,69.3,20706,3.2
13290,September 1997,New Jersey,6313576,4264517,67.5,4048555,64.1,215962,5.1
13291,September 1997,New Mexico,1303738,826472,63.4,776612,59.6,49860,6.0
13292,September 1997,New York,14309522,9056630,63.3,8481537,59.3,575093,6.3
13293,September 1997,North Carolina,5854299,3987150,68.1,3841023,65.6,146127,3.7
13294,September 1997,North Dakota,486694,351146,72.1,342105,70.3,9041,2.6
13295,September 1997,Ohio,8553432,5706454,66.7,5453785,63.8,252669,4.4
13296,September 1997,Oklahoma,2514557,1614998,64.2,1549786,61.6,65212,4.0
13297,September 1997,Oregon,2553156,1760545,69.0,1663401,65.2,97144,5.5
13298,September 1997,Pennsylvania,9423732,6067003,64.4,5764399,61.2,302604,5.0
13299,September 1997,Rhode Island,795408,530952,66.8,503907,63.4,27045,5.1
13300,September 1997,South Carolina,2907951,1911498,65.7,1833544,63.1,77954,4.1
13301,September 1997,South Dakota,549261,394906,71.9,383486,69.8,11420,2.9
13302,September 1997,Tennessee,4232342,2790881,65.9,2646758,62.5,144123,5.2
13303,September 1997,Texas,14411926,9961428,69.1,9452472,65.6,508956,5.1
13304,September 1997,Utah,1498703,1076377,71.8,1042111,69.5,34266,3.2
13305,September 1997,Vermont,460266,329744,71.6,317345,68.9,12399,3.8
13306,September 1997,Virginia,5129871,3450558,67.3,3332788,65.0,117770,3.4
13307,September 1997,Washington,4290618,3006928,70.1,2865173,66.8,141755,4.7
13308,September 1997,West Virginia,1436513,795915,55.4,742899,51.7,53016,6.7
13309,September 1997,Wisconsin,3993360,2984858,74.7,2880892,72.1,103966,3.5
13310,September 1997,Wyoming,365998,253626,69.3,241985,66.1,11641,4.6
13311,October 1997,Alabama,3320396,2141370,64.5,2038966,61.4,102404,4.8
13312,October 1997,Alaska,424190,313952,74.0,292425,68.9,21527,6.9
13313,October 1997,Arizona,3616676,2323905,64.3,2223437,61.5,100468,4.3
13314,October 1997,Arkansas,1969707,1240054,63.0,1175154,59.7,64900,5.2
13315,October 1997,California,23960604,15904891,66.4,14932740,62.3,972151,6.1
13316,October 1997,Colorado,3063885,2250178,73.4,2174943,71.0,75235,3.3
13317,October 1997,Connecticut,2569529,1747359,68.0,1670072,65.0,77287,4.4
13318,October 1997,Delaware,576150,387850,67.3,373745,64.9,14105,3.6
13319,October 1997,District of Columbia,450367,283730,63.0,259808,57.7,23922,8.4
13320,October 1997,Florida,11895391,7424421,62.4,7084149,59.6,340272,4.6
13321,October 1997,Georgia,5767022,3995535,69.3,3822894,66.3,172641,4.3
13322,October 1997,Hawaii,891329,600735,67.4,563871,63.3,36864,6.1
13323,October 1997,Idaho,905012,636069,70.3,603633,66.7,32436,5.1
13324,October 1997,Illinois,9182398,6319902,68.8,6021190,65.6,298712,4.7
13325,October 1997,Indiana,4520334,3130012,69.2,3017898,66.8,112114,3.6
13326,October 1997,Iowa,2206841,1597412,72.4,1550276,70.2,47136,3.0
13327,October 1997,Kansas,1962111,1389106,70.8,1339589,68.3,49517,3.6
13328,October 1997,Kentucky,3013679,1921677,63.8,1827202,60.6,94475,4.9
13329,October 1997,Louisiana,3251002,2031545,62.5,1915362,58.9,116183,5.7
13330,October 1997,Maine,972822,653754,67.2,621575,63.9,32179,4.9
13331,October 1997,Maryland,3898519,2770602,71.1,2634314,67.6,136288,4.9
13332,October 1997,Massachusetts,4832066,3318965,68.7,3195717,66.1,123248,3.7
13333,October 1997,Michigan,7413778,4983040,67.2,4776380,64.4,206660,4.1
13334,October 1997,Minnesota,3598396,2693139,74.8,2610466,72.5,82673,3.1
13335,October 1997,Mississippi,2053578,1275907,62.1,1203280,58.6,72627,5.7
13336,October 1997,Missouri,4143666,2935411,70.8,2807386,67.8,128025,4.4
13337,October 1997,Montana,674829,455119,67.4,430645,63.8,24474,5.4
13338,October 1997,Nebraska,1260913,923408,73.2,901125,71.5,22283,2.4
13339,October 1997,Nevada,1373008,950290,69.2,909008,66.2,41282,4.3
13340,October 1997,New Hampshire,911998,653112,71.6,632876,69.4,20236,3.1
13341,October 1997,New Jersey,6318754,4261785,67.4,4048305,64.1,213480,5.0
13342,October 1997,New Mexico,1304950,827871,63.4,778134,59.6,49737,6.0
13343,October 1997,New York,14320603,9056832,63.2,8490506,59.3,566326,6.3
13344,October 1997,North Carolina,5864786,3985444,68.0,3839836,65.5,145608,3.7
13345,October 1997,North Dakota,486766,351143,72.1,342373,70.3,8770,2.5
13346,October 1997,Ohio,8557362,5710932,66.7,5455965,63.8,254967,4.5
13347,October 1997,Oklahoma,2517746,1616323,64.2,1552033,61.6,64290,4.0
13348,October 1997,Oregon,2556427,1764205,69.0,1667291,65.2,96914,5.5
13349,October 1997,Pennsylvania,9427342,6068139,64.4,5771520,61.2,296619,4.9
13350,October 1997,Rhode Island,795896,531378,66.8,504579,63.4,26799,5.0
13351,October 1997,South Carolina,2912929,1912514,65.7,1837843,63.1,74671,3.9
13352,October 1997,South Dakota,550350,395188,71.8,383785,69.7,11403,2.9
13353,October 1997,Tennessee,4237937,2788643,65.8,2650243,62.5,138400,5.0
13354,October 1997,Texas,14438527,9970657,69.1,9468493,65.6,502164,5.0
13355,October 1997,Utah,1502151,1078948,71.8,1044044,69.5,34904,3.2
13356,October 1997,Vermont,460291,330348,71.8,318032,69.1,12316,3.7
13357,October 1997,Virginia,5134999,3449647,67.2,3336814,65.0,112833,3.3
13358,October 1997,Washington,4296861,3012656,70.1,2871641,66.8,141015,4.7
13359,October 1997,West Virginia,1436390,795788,55.4,742804,51.7,52984,6.7
13360,October 1997,Wisconsin,3996816,2988193,74.8,2885476,72.2,102717,3.4
13361,October 1997,Wyoming,366019,253753,69.3,242191,66.2,11562,4.6
13362,November 1997,Alabama,3323198,2138483,64.4,2040209,61.4,98274,4.6
13363,November 1997,Alaska,425181,314216,73.9,293089,68.9,21127,6.7
13364,November 1997,Arizona,3624460,2330434,64.3,2229811,61.5,100623,4.3
13365,November 1997,Arkansas,1971118,1239166,62.9,1174301,59.6,64865,5.2
13366,November 1997,California,23998695,15935207,66.4,14967009,62.4,968198,6.1
13367,November 1997,Colorado,3069863,2258788,73.6,2181944,71.1,76844,3.4
13368,November 1997,Connecticut,2569992,1744969,67.9,1670810,65.0,74159,4.2
13369,November 1997,Delaware,576226,388646,67.4,374577,65.0,14069,3.6
13370,November 1997,District of Columbia,450732,284856,63.2,260398,57.8,24458,8.6
13371,November 1997,Florida,11914746,7433797,62.4,7094462,59.5,339335,4.6
13372,November 1997,Georgia,5777033,4007053,69.4,3833521,66.4,173532,4.3
13373,November 1997,Hawaii,892460,600001,67.2,563560,63.1,36441,6.1
13374,November 1997,Idaho,906012,637155,70.3,604543,66.7,32612,5.1
13375,November 1997,Illinois,9188647,6325104,68.8,6023994,65.6,301110,4.8
13376,November 1997,Indiana,4522902,3127725,69.2,3017600,66.7,110125,3.5
13377,November 1997,Iowa,2208170,1597376,72.3,1550996,70.2,46380,2.9
13378,November 1997,Kansas,1964122,1391634,70.9,1342316,68.3,49318,3.5
13379,November 1997,Kentucky,3016729,1920600,63.7,1829343,60.6,91257,4.8
13380,November 1997,Louisiana,3252023,2033508,62.5,1919269,59.0,114239,5.6
13381,November 1997,Maine,972799,653234,67.1,620911,63.8,32323,4.9
13382,November 1997,Maryland,3901344,2771925,71.1,2635774,67.6,136151,4.9
13383,November 1997,Massachusetts,4835056,3321652,68.7,3200702,66.2,120950,3.6
13384,November 1997,Michigan,7416478,4990629,67.3,4783910,64.5,206719,4.1
13385,November 1997,Minnesota,3601081,2695115,74.8,2614270,72.6,80845,3.0
13386,November 1997,Mississippi,2055680,1275773,62.1,1204560,58.6,71213,5.6
13387,November 1997,Missouri,4146248,2934213,70.8,2805361,67.7,128852,4.4
13388,November 1997,Montana,674796,456113,67.6,431427,63.9,24686,5.4
13389,November 1997,Nebraska,1261157,924020,73.3,901949,71.5,22071,2.4
13390,November 1997,Nevada,1377933,952674,69.1,910913,66.1,41761,4.4
13391,November 1997,New Hampshire,913094,653903,71.6,634116,69.4,19787,3.0
13392,November 1997,New Jersey,6322932,4259393,67.4,4047401,64.0,211992,5.0
13393,November 1997,New Mexico,1306162,829298,63.5,779442,59.7,49856,6.0
13394,November 1997,New York,14328684,9055815,63.2,8497555,59.3,558260,6.2
13395,November 1997,North Carolina,5874273,3984071,67.8,3838038,65.3,146033,3.7
13396,November 1997,North Dakota,486838,351271,72.2,342567,70.4,8704,2.5
13397,November 1997,Ohio,8560291,5711966,66.7,5456103,63.7,255863,4.5
13398,November 1997,Oklahoma,2519935,1617795,64.2,1554185,61.7,63610,3.9
13399,November 1997,Oregon,2559697,1766904,69.0,1670359,65.3,96545,5.5
13400,November 1997,Pennsylvania,9428952,6068567,64.4,5776721,61.3,291846,4.8
13401,November 1997,Rhode Island,796385,531562,66.7,505051,63.4,26511,5.0
13402,November 1997,South Carolina,2916907,1914019,65.6,1842000,63.1,72019,3.8
13403,November 1997,South Dakota,550439,395546,71.9,384148,69.8,11398,2.9
13404,November 1997,Tennessee,4242532,2785986,65.7,2653808,62.6,132178,4.7
13405,November 1997,Texas,14463129,9979329,69.0,9483181,65.6,496148,5.0
13406,November 1997,Utah,1504600,1081612,71.9,1045911,69.5,35701,3.3
13407,November 1997,Vermont,460315,330814,71.9,318573,69.2,12241,3.7
13408,November 1997,Virginia,5139126,3449112,67.1,3339881,65.0,109231,3.2
13409,November 1997,Washington,4304104,3017283,70.1,2876527,66.8,140756,4.7
13410,November 1997,West Virginia,1436266,795570,55.4,742533,51.7,53037,6.7
13411,November 1997,Wisconsin,3999271,2989082,74.7,2887950,72.2,101132,3.4
13412,November 1997,Wyoming,366041,253975,69.4,242431,66.2,11544,4.5
13413,December 1997,Alabama,3326000,2135370,64.2,2041098,61.4,94272,4.4
13414,December 1997,Alaska,425172,314508,74.0,293833,69.1,20675,6.6
13415,December 1997,Arizona,3632244,2336897,64.3,2236098,61.6,100799,4.3
13416,December 1997,Arkansas,1972530,1238516,62.8,1173497,59.5,65019,5.2
13417,December 1997,California,24034787,15964672,66.4,14999299,62.4,965373,6.0
13418,December 1997,Colorado,3074840,2267531,73.7,2188727,71.2,78804,3.5
13419,December 1997,Connecticut,2570455,1742967,67.8,1671564,65.0,71403,4.1
13420,December 1997,Delaware,577302,389657,67.5,375452,65.0,14205,3.6
13421,December 1997,District of Columbia,451098,286298,63.5,261336,57.9,24962,8.7
13422,December 1997,Florida,11934101,7443445,62.4,7104623,59.5,338822,4.6
13423,December 1997,Georgia,5787044,4018149,69.4,3843367,66.4,174782,4.3
13424,December 1997,Hawaii,892591,599374,67.1,563297,63.1,36077,6.0
13425,December 1997,Idaho,908012,638733,70.3,605906,66.7,32827,5.1
13426,December 1997,Illinois,9193896,6326650,68.8,6026305,65.5,300345,4.7
13427,December 1997,Indiana,4524469,3124719,69.1,3017732,66.7,106987,3.4
13428,December 1997,Iowa,2208498,1597743,72.3,1552184,70.3,45559,2.9
13429,December 1997,Kansas,1965134,1394473,71.0,1345329,68.5,49144,3.5
13430,December 1997,Kentucky,3018779,1919844,63.6,1831325,60.7,88519,4.6
13431,December 1997,Louisiana,3254044,2035309,62.5,1922385,59.1,112924,5.5
13432,December 1997,Maine,972776,652690,67.1,620451,63.8,32239,4.9
13433,December 1997,Maryland,3903169,2772177,71.0,2636839,67.6,135338,4.9
13434,December 1997,Massachusetts,4837046,3324248,68.7,3205447,66.3,118801,3.6
13435,December 1997,Michigan,7418177,4995855,67.3,4791150,64.6,204705,4.1
13436,December 1997,Minnesota,3604766,2696571,74.8,2617785,72.6,78786,2.9
13437,December 1997,Mississippi,2056782,1275338,62.0,1205652,58.6,69686,5.5
13438,December 1997,Missouri,4148829,2931695,70.7,2802288,67.5,129407,4.4
13439,December 1997,Montana,674762,456939,67.7,432034,64.0,24905,5.5
13440,December 1997,Nebraska,1262401,924696,73.2,902741,71.5,21955,2.4
13441,December 1997,Nevada,1382859,955125,69.1,912815,66.0,42310,4.4
13442,December 1997,New Hampshire,914189,654833,71.6,635463,69.5,19370,3.0
13443,December 1997,New Jersey,6327111,4257580,67.3,4046148,63.9,211432,5.0
13444,December 1997,New Mexico,1308375,830732,63.5,780594,59.7,50138,6.0
13445,December 1997,New York,14335765,9054800,63.2,8503839,59.3,550961,6.1
13446,December 1997,North Carolina,5883760,3983048,67.7,3836199,65.2,146849,3.7
13447,December 1997,North Dakota,485910,351403,72.3,342643,70.5,8760,2.5
13448,December 1997,Ohio,8561220,5709358,66.7,5455242,63.7,254116,4.5
13449,December 1997,Oklahoma,2522124,1619684,64.2,1556256,61.7,63428,3.9
13450,December 1997,Oregon,2562968,1768862,69.0,1672600,65.3,96262,5.4
13451,December 1997,Pennsylvania,9430562,6068441,64.3,5780239,61.3,288202,4.7
13452,December 1997,Rhode Island,796873,531599,66.7,505349,63.4,26250,4.9
13453,December 1997,South Carolina,2920885,1915820,65.6,1845796,63.2,70024,3.7
13454,December 1997,South Dakota,550528,395953,71.9,384564,69.9,11389,2.9
13455,December 1997,Tennessee,4246127,2784267,65.6,2657511,62.6,126756,4.6
13456,December 1997,Texas,14485730,9988808,69.0,9497559,65.6,491249,4.9
13457,December 1997,Utah,1508048,1084270,71.9,1047658,69.5,36612,3.4
13458,December 1997,Vermont,461339,331170,71.8,319032,69.2,12138,3.7
13459,December 1997,Virginia,5143254,3449675,67.1,3343058,65.0,106617,3.1
13460,December 1997,Washington,4310347,3021050,70.1,2880338,66.8,140712,4.7
13461,December 1997,West Virginia,1436143,795378,55.4,742235,51.7,53143,6.7
13462,December 1997,Wisconsin,4000727,2987383,74.7,2888341,72.2,99042,3.3
13463,December 1997,Wyoming,366062,254313,69.5,242745,66.3,11568,4.5
13464,January 1998,Alabama,3328802,2133420,64.1,2042148,61.3,91272,4.3
13465,January 1998,Alaska,425164,314832,74.0,294566,69.3,20266,6.4
13466,January 1998,Arizona,3639028,2343427,64.4,2242565,61.6,100862,4.3
13467,January 1998,Arkansas,1973942,1238166,62.7,1172904,59.4,65262,5.3
13468,January 1998,California,24070878,15993559,66.4,15030487,62.4,963072,6.0
13469,January 1998,Colorado,3079818,2276334,73.9,2195479,71.3,80855,3.6
13470,January 1998,Connecticut,2570918,1741417,67.7,1672492,65.1,68925,4.0
13471,January 1998,Delaware,578379,390796,67.6,376341,65.1,14455,3.7
13472,January 1998,District of Columbia,451464,288111,63.8,262730,58.2,25381,8.8
13473,January 1998,Florida,11953456,7453805,62.4,7115959,59.5,337846,4.5
13474,January 1998,Georgia,5797055,4028131,69.5,3852603,66.5,175528,4.4
13475,January 1998,Hawaii,892722,599041,67.1,563177,63.1,35864,6.0
13476,January 1998,Idaho,909012,640657,70.5,607638,66.8,33019,5.2
13477,January 1998,Illinois,9200145,6324384,68.7,6027860,65.5,296524,4.7
13478,January 1998,Indiana,4527036,3121548,69.0,3018585,66.7,102963,3.3
13479,January 1998,Iowa,2209826,1598175,72.3,1553371,70.3,44804,2.8
13480,January 1998,Kansas,1967146,1397628,71.0,1348641,68.6,48987,3.5
13481,January 1998,Kentucky,3021829,1919946,63.5,1833157,60.7,86789,4.5
13482,January 1998,Louisiana,3255066,2037370,62.6,1925001,59.1,112369,5.5
13483,January 1998,Maine,973753,652124,67.0,620348,63.7,31776,4.9
13484,January 1998,Maryland,3905993,2770846,70.9,2637223,67.5,133623,4.8
13485,January 1998,Massachusetts,4840037,3326736,68.7,3209892,66.3,116844,3.5
13486,January 1998,Michigan,7420877,4998715,67.4,4798405,64.7,200310,4.0
13487,January 1998,Minnesota,3607451,2698132,74.8,2621429,72.7,76703,2.8
13488,January 1998,Mississippi,2058883,1274741,61.9,1206359,58.6,68382,5.4
13489,January 1998,Missouri,4151411,2928517,70.5,2798877,67.4,129640,4.4
13490,January 1998,Montana,675728,457533,67.7,432407,64.0,25126,5.5
13491,January 1998,Nebraska,1262644,925372,73.3,903447,71.6,21925,2.4
13492,January 1998,Nevada,1387785,957873,69.0,915045,65.9,42828,4.5
13493,January 1998,New Hampshire,915285,655861,71.7,636846,69.6,19015,2.9
13494,January 1998,New Jersey,6331289,4256090,67.2,4045063,63.9,211027,5.0
13495,January 1998,New Mexico,1309587,832143,63.5,781624,59.7,50519,6.1
13496,January 1998,New York,14343846,9054056,63.1,8510512,59.3,543544,6.0
13497,January 1998,North Carolina,5892247,3982017,67.6,3834866,65.1,147151,3.7
13498,January 1998,North Dakota,485982,351408,72.3,342550,70.5,8858,2.5
13499,January 1998,Ohio,8563150,5704397,66.6,5454489,63.7,249908,4.4
13500,January 1998,Oklahoma,2524313,1621908,64.3,1558130,61.7,63778,3.9
13501,January 1998,Oregon,2565238,1770527,69.0,1674112,65.3,96415,5.4
13502,January 1998,Pennsylvania,9431172,6067917,64.3,5782400,61.3,285517,4.7
13503,January 1998,Rhode Island,797361,531592,66.7,505551,63.4,26041,4.9
13504,January 1998,South Carolina,2924863,1917833,65.6,1849249,63.2,68584,3.6
13505,January 1998,South Dakota,550617,396368,72.0,384993,69.9,11375,2.9
13506,January 1998,Tennessee,4250722,2784309,65.5,2661385,62.6,122924,4.4
13507,January 1998,Texas,14509331,10000067,68.9,9512374,65.6,487693,4.9
13508,January 1998,Utah,1510497,1086799,71.9,1049289,69.5,37510,3.5
13509,January 1998,Vermont,461364,331474,71.8,319467,69.2,12007,3.6
13510,January 1998,Virginia,5147382,3451827,67.1,3347208,65.0,104619,3.0
13511,January 1998,Washington,4315591,3024248,70.1,2883526,66.8,140722,4.7
13512,January 1998,West Virginia,1436019,795334,55.4,742037,51.7,53297,6.7
13513,January 1998,Wisconsin,4003182,2983657,74.5,2886959,72.1,96698,3.2
13514,January 1998,Wyoming,366083,254789,69.6,243159,66.4,11630,4.6
13515,February 1998,Alabama,3330604,2133335,64.1,2043526,61.4,89809,4.2
13516,February 1998,Alaska,425155,315150,74.1,295177,69.4,19973,6.3
13517,February 1998,Arizona,3646811,2350129,64.4,2249336,61.7,100793,4.3
13518,February 1998,Arkansas,1974354,1238102,62.7,1172757,59.4,65345,5.3
13519,February 1998,California,24102970,16022258,66.5,15061018,62.5,961240,6.0
13520,February 1998,Colorado,3084795,2284933,74.1,2202173,71.4,82760,3.6
13521,February 1998,Connecticut,2570381,1740438,67.7,1673783,65.1,66655,3.8
13522,February 1998,Delaware,578455,391968,67.8,377209,65.2,14759,3.8
13523,February 1998,District of Columbia,451829,290063,64.2,264397,58.5,25666,8.8
13524,February 1998,Florida,11969811,7464967,62.4,7128926,59.6,336041,4.5
13525,February 1998,Georgia,5807066,4037060,69.5,3861292,66.5,175768,4.4
13526,February 1998,Hawaii,893854,599083,67.0,563230,63.0,35853,6.0
13527,February 1998,Idaho,910012,642690,70.6,609515,67.0,33175,5.2
13528,February 1998,Illinois,9204394,6319684,68.7,6029714,65.5,289970,4.6
13529,February 1998,Indiana,4528604,3118659,68.9,3020017,66.7,98642,3.2
13530,February 1998,Iowa,2210154,1598338,72.3,1554118,70.3,44220,2.8
13531,February 1998,Kansas,1968158,1401100,71.2,1352123,68.7,48977,3.5
13532,February 1998,Kentucky,3022879,1921119,63.6,1834817,60.7,86302,4.5
13533,February 1998,Louisiana,3256087,2040189,62.7,1927330,59.2,112859,5.5
13534,February 1998,Maine,973730,651575,66.9,620604,63.7,30971,4.8
13535,February 1998,Maryland,3907818,2768351,70.8,2637044,67.5,131307,4.7
13536,February 1998,Massachusetts,4841027,3329048,68.8,3213970,66.4,115078,3.5
13537,February 1998,Michigan,7421577,4999680,67.4,4804750,64.7,194930,3.9
13538,February 1998,Minnesota,3610136,2700064,74.8,2625295,72.7,74769,2.8
13539,February 1998,Mississippi,2059985,1274253,61.9,1206698,58.6,67555,5.3
13540,February 1998,Missouri,4152992,2925576,70.4,2795852,67.3,129724,4.4
13541,February 1998,Montana,675694,457927,67.8,432620,64.0,25307,5.5
13542,February 1998,Nebraska,1262888,926098,73.3,904100,71.6,21998,2.4
13543,February 1998,Nevada,1392710,961074,69.0,917876,65.9,43198,4.5
13544,February 1998,New Hampshire,915381,656920,71.8,638190,69.7,18730,2.9
13545,February 1998,New Jersey,6333467,4254301,67.2,4044416,63.9,209885,4.9
13546,February 1998,New Mexico,1310799,833436,63.6,782548,59.7,50888,6.1
13547,February 1998,New York,14347926,9053560,63.1,8518256,59.4,535304,5.9
13548,February 1998,North Carolina,5900734,3980723,67.5,3834457,65.0,146266,3.7
13549,February 1998,North Dakota,486054,351261,72.3,342275,70.4,8986,2.6
13550,February 1998,Ohio,8564079,5699395,66.6,5454311,63.7,245084,4.3
13551,February 1998,Oklahoma,2525501,1624518,64.3,1559689,61.8,64829,4.0
13552,February 1998,Oregon,2568509,1772139,69.0,1675041,65.2,97098,5.5
13553,February 1998,Pennsylvania,9430782,6066676,64.3,5783276,61.3,283400,4.7
13554,February 1998,Rhode Island,797850,531613,66.6,505761,63.4,25852,4.9
13555,February 1998,South Carolina,2927841,1920275,65.6,1852615,63.3,67660,3.5
13556,February 1998,South Dakota,550706,396801,72.1,385439,70.0,11362,2.9
13557,February 1998,Tennessee,4254317,2786228,65.5,2665530,62.7,120698,4.3
13558,February 1998,Texas,14529933,10013713,68.9,9527942,65.6,485771,4.9
13559,February 1998,Utah,1512945,1089262,72.0,1050914,69.5,38348,3.5
13560,February 1998,Vermont,461388,331772,71.9,319915,69.3,11857,3.6
13561,February 1998,Virginia,5150509,3455443,67.1,3352495,65.1,102948,3.0
13562,February 1998,Washington,4321834,3027176,70.0,2886458,66.8,140718,4.6
13563,February 1998,West Virginia,1434896,795402,55.4,741940,51.7,53462,6.7
13564,February 1998,Wisconsin,4003638,2979228,74.4,2884591,72.0,94637,3.2
13565,February 1998,Wyoming,366105,255363,69.8,243649,66.6,11714,4.6
13566,March 1998,Alabama,3333406,2134624,64.0,2044769,61.3,89855,4.2
13567,March 1998,Alaska,425146,315390,74.2,295575,69.5,19815,6.3
13568,March 1998,Arizona,3653595,2356916,64.5,2256223,61.8,100693,4.3
13569,March 1998,Arkansas,1975766,1238108,62.7,1172996,59.4,65112,5.3
13570,March 1998,California,24137061,16049676,66.5,15089666,62.5,960010,6.0
13571,March 1998,Colorado,3089773,2292832,74.2,2208549,71.5,84283,3.7
13572,March 1998,Connecticut,2570844,1739960,67.7,1675422,65.2,64538,3.7
13573,March 1998,Delaware,579531,393076,67.8,378026,65.2,15050,3.8
13574,March 1998,District of Columbia,452195,291717,64.5,265940,58.8,25777,8.8
13575,March 1998,Florida,11987167,7475480,62.4,7142068,59.6,333412,4.5
13576,March 1998,Georgia,5816077,4044791,69.5,3869145,66.5,175646,4.3
13577,March 1998,Hawaii,893985,599444,67.1,563436,63.0,36008,6.0
13578,March 1998,Idaho,912012,644547,70.7,611307,67.0,33240,5.2
13579,March 1998,Illinois,9208643,6314406,68.6,6032651,65.5,281755,4.5
13580,March 1998,Indiana,4530171,3116016,68.8,3021345,66.7,94671,3.0
13581,March 1998,Iowa,2210482,1597935,72.3,1554060,70.3,43875,2.7
13582,March 1998,Kansas,1969170,1404751,71.3,1355500,68.8,49251,3.5
13583,March 1998,Kentucky,3025928,1923155,63.6,1836324,60.7,86831,4.5
13584,March 1998,Louisiana,3257108,2043840,62.8,1929307,59.2,114533,5.6
13585,March 1998,Maine,973706,651080,66.9,621028,63.8,30052,4.6
13586,March 1998,Maryland,3909643,2765884,70.7,2636812,67.4,129072,4.7
13587,March 1998,Massachusetts,4843017,3330859,68.8,3217489,66.4,113370,3.4
13588,March 1998,Michigan,7422277,4998862,67.3,4808496,64.8,190366,3.8
13589,March 1998,Minnesota,3612821,2702105,74.8,2629140,72.8,72965,2.7
13590,March 1998,Mississippi,2062087,1273870,61.8,1206652,58.5,67218,5.3
13591,March 1998,Missouri,4154574,2923262,70.4,2793371,67.2,129891,4.4
13592,March 1998,Montana,675661,458196,67.8,432794,64.1,25402,5.5
13593,March 1998,Nebraska,1264132,926942,73.3,904738,71.6,22204,2.4
13594,March 1998,Nevada,1396636,964734,69.1,921385,66.0,43349,4.5
13595,March 1998,New Hampshire,916477,657915,71.8,639413,69.8,18502,2.8
13596,March 1998,New Jersey,6336645,4251326,67.1,4043937,63.8,207389,4.9
13597,March 1998,New Mexico,1312011,834468,63.6,783313,59.7,51155,6.1
13598,March 1998,New York,14354007,9052610,63.1,8526423,59.4,526187,5.8
13599,March 1998,North Carolina,5909221,3979155,67.3,3834910,64.9,144245,3.6
13600,March 1998,North Dakota,486126,351005,72.2,341853,70.3,9152,2.6
13601,March 1998,Ohio,8565008,5696009,66.5,5454260,63.7,241749,4.2
13602,March 1998,Oklahoma,2526690,1627399,64.4,1560806,61.8,66593,4.1
13603,March 1998,Oregon,2570779,1773623,69.0,1675421,65.2,98202,5.5
13604,March 1998,Pennsylvania,9431392,6064118,64.3,5782620,61.3,281498,4.6
13605,March 1998,Rhode Island,798338,531707,66.6,506069,63.4,25638,4.8
13606,March 1998,South Carolina,2931819,1923399,65.6,1855921,63.3,67478,3.5
13607,March 1998,South Dakota,550794,397245,72.1,385904,70.1,11341,2.9
13608,March 1998,Tennessee,4257912,2789503,65.5,2669714,62.7,119789,4.3
13609,March 1998,Texas,14551534,10029251,68.9,9543375,65.6,485876,4.8
13610,March 1998,Utah,1515394,1091772,72.0,1052633,69.5,39139,3.6
13611,March 1998,Vermont,462413,332103,71.8,320394,69.3,11709,3.5
13612,March 1998,Virginia,5153637,3459764,67.1,3358255,65.2,101509,2.9
13613,March 1998,Washington,4327077,3029870,70.0,2889145,66.8,140725,4.6
13614,March 1998,West Virginia,1434772,795472,55.4,741854,51.7,53618,6.7
13615,March 1998,Wisconsin,4006093,2975173,74.3,2881771,71.9,93402,3.1
13616,March 1998,Wyoming,366126,255959,69.9,244147,66.7,11812,4.6
13617,April 1998,Alabama,3336208,2136407,64.0,2045590,61.3,90817,4.3
13618,April 1998,Alaska,426138,315529,74.0,295750,69.4,19779,6.3
13619,April 1998,Arizona,3661379,2364134,64.6,2263505,61.8,100629,4.3
13620,April 1998,Arkansas,1977177,1238176,62.6,1173572,59.4,64604,5.2
13621,April 1998,California,24175153,16076286,66.5,15117428,62.5,958858,6.0
13622,April 1998,Colorado,3095750,2299943,74.3,2214643,71.5,85300,3.7
13623,April 1998,Connecticut,2571308,1739941,67.7,1677328,65.2,62613,3.6
13624,April 1998,Delaware,579607,394050,68.0,378801,65.4,15249,3.9
13625,April 1998,District of Columbia,452561,292764,64.7,267059,59.0,25705,8.8
13626,April 1998,Florida,12007522,7485300,62.3,7155404,59.6,329896,4.4
13627,April 1998,Georgia,5826087,4051443,69.5,3876626,66.5,174817,4.3
13628,April 1998,Hawaii,894116,600078,67.1,563778,63.1,36300,6.0
13629,April 1998,Idaho,913013,646067,70.8,612887,67.1,33180,5.1
13630,April 1998,Illinois,9214892,6311880,68.5,6037913,65.5,273967,4.3
13631,April 1998,Indiana,4532739,3114166,68.7,3022521,66.7,91645,2.9
13632,April 1998,Iowa,2210810,1596988,72.2,1553308,70.3,43680,2.7
13633,April 1998,Kansas,1971182,1408411,71.5,1358721,68.9,49690,3.5
13634,April 1998,Kentucky,3027978,1925845,63.6,1837990,60.7,87855,4.6
13635,April 1998,Louisiana,3258129,2048324,62.9,1931197,59.3,117127,5.7
13636,April 1998,Maine,974683,650749,66.8,621485,63.8,29264,4.5
13637,April 1998,Maryland,3911467,2764170,70.7,2637120,67.4,127050,4.6
13638,April 1998,Massachusetts,4846007,3332478,68.8,3220882,66.5,111596,3.3
13639,April 1998,Michigan,7424976,4997646,67.3,4810082,64.8,187564,3.8
13640,April 1998,Minnesota,3616506,2704062,74.8,2632660,72.8,71402,2.6
13641,April 1998,Mississippi,2063189,1273553,61.7,1206430,58.5,67123,5.3
13642,April 1998,Missouri,4157155,2921529,70.3,2792073,67.2,129456,4.4
13643,April 1998,Montana,675627,458456,67.9,433051,64.1,25405,5.5
13644,April 1998,Nebraska,1264376,927871,73.4,905378,71.6,22493,2.4
13645,April 1998,Nevada,1402561,968721,69.1,925480,66.0,43241,4.5
13646,April 1998,New Hampshire,917572,658790,71.8,640474,69.8,18316,2.8
13647,April 1998,New Jersey,6341824,4247181,67.0,4044011,63.8,203170,4.8
13648,April 1998,New Mexico,1313224,835218,63.6,783914,59.7,51304,6.1
13649,April 1998,New York,14363088,9052004,63.0,8535778,59.4,516226,5.7
13650,April 1998,North Carolina,5918708,3978138,67.2,3836778,64.8,141360,3.6
13651,April 1998,North Dakota,486198,350675,72.1,341314,70.2,9361,2.7
13652,April 1998,Ohio,8567938,5695066,66.5,5454588,63.7,240478,4.2
13653,April 1998,Oklahoma,2529879,1630433,64.4,1561721,61.7,68712,4.2
13654,April 1998,Oregon,2574050,1775068,69.0,1675535,65.1,99533,5.6
13655,April 1998,Pennsylvania,9433002,6060649,64.2,5781116,61.3,279533,4.6
13656,April 1998,Rhode Island,798826,531854,66.6,506493,63.4,25361,4.8
13657,April 1998,South Carolina,2935797,1927404,65.7,1859403,63.3,68001,3.5
13658,April 1998,South Dakota,550883,397706,72.2,386424,70.1,11282,2.8
13659,April 1998,Tennessee,4261508,2793804,65.6,2674219,62.8,119585,4.3
13660,April 1998,Texas,14576135,10047147,68.9,9559069,65.6,488078,4.9
13661,April 1998,Utah,1517842,1094367,72.1,1054557,69.5,39810,3.6
13662,April 1998,Vermont,462437,332526,71.9,320945,69.4,11581,3.5
13663,April 1998,Virginia,5157765,3465028,67.2,3364833,65.2,100195,2.9
13664,April 1998,Washington,4333320,3032847,70.0,2891963,66.7,140884,4.6
13665,April 1998,West Virginia,1434649,795486,55.4,741785,51.7,53701,6.8
13666,April 1998,Wisconsin,4007549,2972138,74.2,2878874,71.8,93264,3.1
13667,April 1998,Wyoming,366148,256537,70.1,244620,66.8,11917,4.6
13668,May 1998,Alabama,3339010,2138049,64.0,2045822,61.3,92227,4.3
13669,May 1998,Alaska,426129,315585,74.1,295751,69.4,19834,6.3
13670,May 1998,Arizona,3669163,2372247,64.7,2271482,61.9,100765,4.2
13671,May 1998,Arkansas,1978589,1238535,62.6,1174462,59.4,64073,5.2
13672,May 1998,California,24211244,16104713,66.5,15145627,62.6,959086,6.0
13673,May 1998,Colorado,3100728,2306599,74.4,2220655,71.6,85944,3.7
13674,May 1998,Connecticut,2571771,1740377,67.7,1679398,65.3,60979,3.5
13675,May 1998,Delaware,580683,394880,68.0,379558,65.4,15322,3.9
13676,May 1998,District of Columbia,451926,293109,64.9,267620,59.2,25489,8.7
13677,May 1998,Florida,12026877,7496435,62.3,7169854,59.6,326581,4.4
13678,May 1998,Georgia,5836098,4058379,69.5,3884508,66.6,173871,4.3
13679,May 1998,Hawaii,895247,600950,67.1,564254,63.0,36696,6.1
13680,May 1998,Idaho,914013,647288,70.8,614232,67.2,33056,5.1
13681,May 1998,Illinois,9220141,6315685,68.5,6046421,65.6,269264,4.3
13682,May 1998,Indiana,4534306,3113918,68.7,3023643,66.7,90275,2.9
13683,May 1998,Iowa,2212138,1595809,72.1,1552209,70.2,43600,2.7
13684,May 1998,Kansas,1972193,1412062,71.6,1361892,69.1,50170,3.6
13685,May 1998,Kentucky,3031028,1929011,63.6,1840023,60.7,88988,4.6
13686,May 1998,Louisiana,3260151,2053124,63.0,1933103,59.3,120021,5.8
13687,May 1998,Maine,974660,650779,66.8,621967,63.8,28812,4.4
13688,May 1998,Maryland,3914292,2763486,70.6,2638239,67.4,125247,4.5
13689,May 1998,Massachusetts,4848997,3334709,68.8,3224713,66.5,109996,3.3
13690,May 1998,Michigan,7427676,4998427,67.3,4811148,64.8,187279,3.7
13691,May 1998,Minnesota,3619191,2706060,74.8,2635609,72.8,70451,2.6
13692,May 1998,Mississippi,2065291,1273513,61.7,1206364,58.4,67149,5.3
13693,May 1998,Missouri,4159737,2920425,70.2,2792463,67.1,127962,4.4
13694,May 1998,Montana,675593,458835,67.9,433481,64.2,25354,5.5
13695,May 1998,Nebraska,1264619,928885,73.5,906040,71.6,22845,2.5
13696,May 1998,Nevada,1406487,972876,69.2,930030,66.1,42846,4.4
13697,May 1998,New Hampshire,918668,659573,71.8,641380,69.8,18193,2.8
13698,May 1998,New Jersey,6345002,4242959,66.9,4045144,63.8,197815,4.7
13699,May 1998,New Mexico,1314436,835671,63.6,784327,59.7,51344,6.1
13700,May 1998,New York,14370169,9053944,63.0,8547055,59.5,506889,5.6
13701,May 1998,North Carolina,5927195,3979052,67.1,3840430,64.8,138622,3.5
13702,May 1998,North Dakota,486270,350308,72.0,340697,70.1,9611,2.7
13703,May 1998,Ohio,8569867,5697243,66.5,5455821,63.7,241422,4.2
13704,May 1998,Oklahoma,2531068,1633617,64.5,1562814,61.7,70803,4.3
13705,May 1998,Oregon,2577320,1776723,68.9,1675764,65.0,100959,5.7
13706,May 1998,Pennsylvania,9434612,6057635,64.2,5779680,61.3,277955,4.6
13707,May 1998,Rhode Island,799314,532017,66.6,506999,63.4,25018,4.7
13708,May 1998,South Carolina,2939775,1932403,65.7,1863193,63.4,69210,3.6
13709,May 1998,South Dakota,550972,398202,72.3,387024,70.2,11178,2.8
13710,May 1998,Tennessee,4266103,2799446,65.6,2679568,62.8,119878,4.3
13711,May 1998,Texas,14599737,10068283,69.0,9575908,65.6,492375,4.9
13712,May 1998,Utah,1521290,1097069,72.1,1056757,69.5,40312,3.7
13713,May 1998,Vermont,462461,333044,72.0,321561,69.5,11483,3.4
13714,May 1998,Virginia,5161892,3471967,67.3,3372549,65.3,99418,2.9
13715,May 1998,Washington,4339563,3037097,70.0,2895427,66.7,141670,4.7
13716,May 1998,West Virginia,1434525,795461,55.5,741779,51.7,53682,6.7
13717,May 1998,Wisconsin,4010004,2970528,74.1,2876003,71.7,94525,3.2
13718,May 1998,Wyoming,366169,257077,70.2,245053,66.9,12024,4.7
13719,June 1998,Alabama,3341813,2139047,64.0,2045220,61.2,93827,4.4
13720,June 1998,Alaska,426121,315612,74.1,295675,69.4,19937,6.3
13721,June 1998,Arizona,3676947,2381080,64.8,2279870,62.0,101210,4.3
13722,June 1998,Arkansas,1980001,1239296,62.6,1175531,59.4,63765,5.1
13723,June 1998,California,24249336,16135374,66.5,15173399,62.6,961975,6.0
13724,June 1998,Colorado,3106705,2312795,74.4,2226493,71.7,86302,3.7
13725,June 1998,Connecticut,2572234,1741130,67.7,1681456,65.4,59674,3.4
13726,June 1998,Delaware,580759,395565,68.1,380281,65.5,15284,3.9
13727,June 1998,District of Columbia,452292,292887,64.8,267689,59.2,25198,8.6
13728,June 1998,Florida,12046232,7509764,62.3,7185090,59.6,324674,4.3
13729,June 1998,Georgia,5847109,4066684,69.6,3892929,66.6,173755,4.3
13730,June 1998,Hawaii,895378,601925,67.2,564818,63.1,37107,6.2
13731,June 1998,Idaho,916013,648438,70.8,615487,67.2,32951,5.1
13732,June 1998,Illinois,9226389,6326235,68.6,6056815,65.6,269420,4.3
13733,June 1998,Indiana,4536873,3115581,68.7,3024611,66.7,90970,2.9
13734,June 1998,Iowa,2212466,1594704,72.1,1551076,70.1,43628,2.7
13735,June 1998,Kansas,1974205,1415762,71.7,1365106,69.1,50656,3.6
13736,June 1998,Kentucky,3033078,1932242,63.7,1842321,60.7,89921,4.7
13737,June 1998,Louisiana,3261172,2056825,63.1,1934565,59.3,122260,5.9
13738,June 1998,Maine,974637,651302,66.8,622500,63.9,28802,4.4
13739,June 1998,Maryland,3917117,2763743,70.6,2639967,67.4,123776,4.5
13740,June 1998,Massachusetts,4851987,3337650,68.8,3228830,66.5,108820,3.3
13741,June 1998,Michigan,7429376,5002806,67.3,4813258,64.8,189548,3.8
13742,June 1998,Minnesota,3622876,2708375,74.8,2637989,72.8,70386,2.6
13743,June 1998,Mississippi,2067393,1273819,61.6,1206561,58.4,67258,5.3
13744,June 1998,Missouri,4162319,2919389,70.1,2793661,67.1,125728,4.3
13745,June 1998,Montana,675559,459424,68.0,434102,64.3,25322,5.5
13746,June 1998,Nebraska,1265863,930035,73.5,906754,71.6,23281,2.5
13747,June 1998,Nevada,1411413,977090,69.2,934865,66.2,42225,4.3
13748,June 1998,New Hampshire,919764,660384,71.8,642219,69.8,18165,2.8
13749,June 1998,New Jersey,6349180,4239628,66.8,4046992,63.7,192636,4.5
13750,June 1998,New Mexico,1316648,835796,63.5,784486,59.6,51310,6.1
13751,June 1998,New York,14378250,9059204,63.0,8558956,59.5,500248,5.5
13752,June 1998,North Carolina,5936683,3982314,67.1,3845213,64.8,137101,3.4
13753,June 1998,North Dakota,486342,349955,72.0,340057,69.9,9898,2.8
13754,June 1998,Ohio,8571797,5702012,66.5,5457692,63.7,244320,4.3
13755,June 1998,Oklahoma,2533257,1636767,64.6,1564276,61.7,72491,4.4
13756,June 1998,Oregon,2579591,1778638,69.0,1676250,65.0,102388,5.8
13757,June 1998,Pennsylvania,9436222,6056147,64.2,5778663,61.2,277484,4.6
13758,June 1998,Rhode Island,800803,532231,66.5,507603,63.4,24628,4.6
13759,June 1998,South Carolina,2943753,1938322,65.8,1867093,63.4,71229,3.7
13760,June 1998,South Dakota,551061,398781,72.4,387716,70.4,11065,2.8
13761,June 1998,Tennessee,4270698,2806315,65.7,2685718,62.9,120597,4.3
13762,June 1998,Texas,14623338,10091366,69.0,9593557,65.6,497809,4.9
13763,June 1998,Utah,1523739,1099864,72.2,1059209,69.5,40655,3.7
13764,June 1998,Vermont,463486,333590,72.0,322179,69.5,11411,3.4
13765,June 1998,Virginia,5166020,3480122,67.4,3380511,65.4,99611,2.9
13766,June 1998,Washington,4345807,3042995,70.0,2899494,66.7,143501,4.7
13767,June 1998,West Virginia,1434402,795330,55.4,741808,51.7,53522,6.7
13768,June 1998,Wisconsin,4012460,2969928,74.0,2872737,71.6,97191,3.3
13769,June 1998,Wyoming,367191,257571,70.1,245442,66.8,12129,4.7
13770,July 1998,Alabama,3344615,2139048,64.0,2043734,61.1,95314,4.5
13771,July 1998,Alaska,426112,315691,74.1,295647,69.4,20044,6.3
13772,July 1998,Arizona,3684730,2390128,64.9,2288207,62.1,101921,4.3
13773,July 1998,Arkansas,1981413,1240423,62.6,1176658,59.4,63765,5.1
13774,July 1998,California,24286428,16166318,66.6,15199929,62.6,966389,6.0
13775,July 1998,Colorado,3111683,2318246,74.5,2231971,71.7,86275,3.7
13776,July 1998,Connecticut,2572697,1741969,67.7,1683334,65.4,58635,3.4
13777,July 1998,Delaware,581835,396074,68.1,380937,65.5,15137,3.8
13778,July 1998,District of Columbia,452657,292303,64.6,267439,59.1,24864,8.5
13779,July 1998,Florida,12065588,7524598,62.4,7200771,59.7,323827,4.3
13780,July 1998,Georgia,5857120,4076202,69.6,3901829,66.6,174373,4.3
13781,July 1998,Hawaii,896509,602789,67.2,565391,63.1,37398,6.2
13782,July 1998,Idaho,917013,649858,70.9,616903,67.3,32955,5.1
13783,July 1998,Illinois,9232638,6341067,68.7,6067299,65.7,273768,4.3
13784,July 1998,Indiana,4539441,3119336,68.7,3025787,66.7,93549,3.0
13785,July 1998,Iowa,2213794,1593868,72.0,1550206,70.0,43662,2.7
13786,July 1998,Kansas,1975217,1419461,71.9,1368376,69.3,51085,3.6
13787,July 1998,Kentucky,3036127,1935087,63.7,1844721,60.8,90366,4.7
13788,July 1998,Louisiana,3263193,2058204,63.1,1935143,59.3,123061,6.0
13789,July 1998,Maine,975614,652238,66.9,623152,63.9,29086,4.5
13790,July 1998,Maryland,3918941,2764229,70.5,2641933,67.4,122296,4.4
13791,July 1998,Massachusetts,4854977,3341029,68.8,3232903,66.6,108126,3.2
13792,July 1998,Michigan,7432076,4978001,67.0,4743018,63.8,234983,4.7
13793,July 1998,Minnesota,3625561,2711325,74.8,2640015,72.8,71310,2.6
13794,July 1998,Mississippi,2068495,1274412,61.6,1207037,58.4,67375,5.3
13795,July 1998,Missouri,4164900,2917924,70.1,2794642,67.1,123282,4.2
13796,July 1998,Montana,676526,460267,68.0,434896,64.3,25371,5.5
13797,July 1998,Nebraska,1266107,931363,73.6,907552,71.7,23811,2.6
13798,July 1998,Nevada,1416338,981231,69.3,939739,66.3,41492,4.2
13799,July 1998,New Hampshire,920859,661383,71.8,643140,69.8,18243,2.8
13800,July 1998,New Jersey,6354358,4237798,66.7,4049153,63.7,188645,4.5
13801,July 1998,New Mexico,1317860,835603,63.4,784418,59.5,51185,6.1
13802,July 1998,New York,14386331,9067021,63.0,8569737,59.6,497284,5.5
13803,July 1998,North Carolina,5946170,3986999,67.1,3850293,64.8,136706,3.4
13804,July 1998,North Dakota,486414,349602,71.9,339393,69.8,10209,2.9
13805,July 1998,Ohio,8573726,5707855,66.6,5459807,63.7,248048,4.3
13806,July 1998,Oklahoma,2535445,1639679,64.7,1566260,61.8,73419,4.5
13807,July 1998,Oregon,2582861,1780684,68.9,1676948,64.9,103736,5.8
13808,July 1998,Pennsylvania,9437832,6056768,64.2,5778567,61.2,278201,4.6
13809,July 1998,Rhode Island,801291,532496,66.5,508280,63.4,24216,4.5
13810,July 1998,South Carolina,2947731,1944583,66.0,1870815,63.5,73768,3.8
13811,July 1998,South Dakota,551150,399460,72.5,388478,70.5,10982,2.7
13812,July 1998,Tennessee,4274293,2813705,65.8,2692366,63.0,121339,4.3
13813,July 1998,Texas,14647939,10113762,69.0,9611232,65.6,502530,5.0
13814,July 1998,Utah,1526187,1102725,72.3,1061830,69.6,40895,3.7
13815,July 1998,Vermont,463510,334082,72.1,322749,69.6,11333,3.4
13816,July 1998,Virginia,5170148,3488540,67.5,3387916,65.5,100624,2.9
13817,July 1998,Washington,4353050,3050180,70.1,2903871,66.7,146309,4.8
13818,July 1998,West Virginia,1434278,795011,55.4,741884,51.7,53127,6.7
13819,July 1998,Wisconsin,4013915,2969383,74.0,2868756,71.5,100627,3.4
13820,July 1998,Wyoming,367212,258004,70.3,245792,66.9,12212,4.7
13821,August 1998,Alabama,3346417,2138197,63.9,2041930,61.0,96267,4.5
13822,August 1998,Alaska,427103,315863,74.0,295759,69.2,20104,6.4
13823,August 1998,Arizona,3691514,2399495,65.0,2296662,62.2,102833,4.3
13824,August 1998,Arkansas,1983824,1241919,62.6,1177944,59.4,63975,5.2
13825,August 1998,California,24326519,16196070,66.6,15227062,62.6,969008,6.0
13826,August 1998,Colorado,3119660,2323028,74.5,2237294,71.7,85734,3.7
13827,August 1998,Connecticut,2573160,1742871,67.7,1685191,65.5,57680,3.3
13828,August 1998,Delaware,582911,396389,68.0,381521,65.5,14868,3.8
13829,August 1998,District of Columbia,453023,291671,64.4,267209,59.0,24462,8.4
13830,August 1998,Florida,12085943,7540917,62.4,7218280,59.7,322637,4.3
13831,August 1998,Georgia,5868131,4086240,69.6,3911586,66.7,174654,4.3
13832,August 1998,Hawaii,896641,603386,67.3,565899,63.1,37487,6.2
13833,August 1998,Idaho,919013,651596,70.9,618568,67.3,33028,5.1
13834,August 1998,Illinois,9238887,6357874,68.8,6078419,65.8,279455,4.4
13835,August 1998,Indiana,4542008,3124549,68.8,3027659,66.7,96890,3.1
13836,August 1998,Iowa,2214122,1593727,72.0,1549938,70.0,43789,2.7
13837,August 1998,Kansas,1977229,1422951,72.0,1371709,69.4,51242,3.6
13838,August 1998,Kentucky,3038177,1937596,63.8,1847256,60.8,90340,4.7
13839,August 1998,Louisiana,3265215,2057231,63.0,1935187,59.3,122044,5.9
13840,August 1998,Maine,976591,653367,66.9,624078,63.9,29289,4.5
13841,August 1998,Maryland,3922766,2764244,70.5,2644055,67.4,120189,4.3
13842,August 1998,Massachusetts,4857967,3344935,68.9,3237092,66.6,107843,3.2
13843,August 1998,Michigan,7435776,5022223,67.5,4824852,64.9,197371,3.9
13844,August 1998,Minnesota,3631246,2714928,74.8,2642208,72.8,72720,2.7
13845,August 1998,Mississippi,2070597,1275225,61.6,1207891,58.3,67334,5.3
13846,August 1998,Missouri,4168482,2915958,70.0,2795666,67.1,120292,4.1
13847,August 1998,Montana,676492,461255,68.2,435771,64.4,25484,5.5
13848,August 1998,Nebraska,1267351,932803,73.6,908401,71.7,24402,2.6
13849,August 1998,Nevada,1421264,985209,69.3,944521,66.5,40688,4.1
13850,August 1998,New Hampshire,921955,662670,71.9,644254,69.9,18416,2.8
13851,August 1998,New Jersey,6358536,4238049,66.7,4052116,63.7,185933,4.4
13852,August 1998,New Mexico,1319072,835210,63.3,784287,59.5,50923,6.1
13853,August 1998,New York,14395412,9077075,63.1,8580366,59.6,496709,5.5
13854,August 1998,North Carolina,5954657,3992689,67.1,3856300,64.8,136389,3.4
13855,August 1998,North Dakota,486486,349204,71.8,338685,69.6,10519,3.0
13856,August 1998,Ohio,8576655,5713426,66.6,5462546,63.7,250880,4.4
13857,August 1998,Oklahoma,2538634,1642503,64.7,1569033,61.8,73470,4.5
13858,August 1998,Oregon,2586132,1782869,68.9,1678055,64.9,104814,5.9
13859,August 1998,Pennsylvania,9441442,6059572,64.2,5780166,61.2,279406,4.6
13860,August 1998,Rhode Island,801779,532814,66.5,508945,63.5,23869,4.5
13861,August 1998,South Carolina,2951709,1950324,66.1,1874173,63.5,76151,3.9
13862,August 1998,South Dakota,552239,400225,72.5,389282,70.5,10943,2.7
13863,August 1998,Tennessee,4278888,2821595,65.9,2699861,63.1,121734,4.3
13864,August 1998,Texas,14673541,10133933,69.1,9629835,65.6,504098,5.0
13865,August 1998,Utah,1528636,1105518,72.3,1064462,69.6,41056,3.7
13866,August 1998,Vermont,464534,334508,72.0,323283,69.6,11225,3.4
13867,August 1998,Virginia,5177275,3497129,67.5,3395462,65.6,101667,2.9
13868,August 1998,Washington,4358293,3058279,70.2,2909091,66.7,149188,4.9
13869,August 1998,West Virginia,1434155,794740,55.4,742171,51.7,52569,6.6
13870,August 1998,Wisconsin,4017371,2968698,73.9,2864824,71.3,103874,3.5
13871,August 1998,Wyoming,367234,258380,70.4,246117,67.0,12263,4.7
13872,September 1998,Alabama,3348219,2137201,63.8,2040513,60.9,96688,4.5
13873,September 1998,Alaska,427095,316132,74.0,295996,69.3,20136,6.4
13874,September 1998,Arizona,3699298,2409457,65.1,2305432,62.3,104025,4.3
13875,September 1998,Arkansas,1986236,1243794,62.6,1179603,59.4,64191,5.2
13876,September 1998,California,24366611,16224342,66.6,15256009,62.6,968333,6.0
13877,September 1998,Colorado,3126638,2327226,74.4,2242633,71.7,84593,3.6
13878,September 1998,Connecticut,2574623,1743899,67.7,1687220,65.5,56679,3.3
13879,September 1998,Delaware,582987,396516,68.0,382032,65.5,14484,3.7
13880,September 1998,District of Columbia,453389,291394,64.3,267426,59.0,23968,8.2
13881,September 1998,Florida,12105298,7558590,62.4,7237843,59.8,320747,4.2
13882,September 1998,Georgia,5879142,4096365,69.7,3922036,66.7,174329,4.3
13883,September 1998,Hawaii,896772,603594,67.3,566242,63.1,37352,6.2
13884,September 1998,Idaho,920013,653326,71.0,620238,67.4,33088,5.1
13885,September 1998,Illinois,9246136,6374831,68.9,6090854,65.9,283977,4.5
13886,September 1998,Indiana,4545576,3130006,68.9,3030144,66.7,99862,3.2
13887,September 1998,Iowa,2215451,1594478,72.0,1550381,70.0,44097,2.8
13888,September 1998,Kansas,1978241,1426014,72.1,1374985,69.5,51029,3.6
13889,September 1998,Kentucky,3041227,1940101,63.8,1849938,60.8,90163,4.6
13890,September 1998,Louisiana,3267236,2054913,62.9,1935279,59.2,119634,5.8
13891,September 1998,Maine,977567,654534,67.0,625363,64.0,29171,4.5
13892,September 1998,Maryland,3926591,2763673,70.4,2646329,67.4,117344,4.2
13893,September 1998,Massachusetts,4862957,3349283,68.9,3241375,66.7,107908,3.2
13894,September 1998,Michigan,7440475,5035456,67.7,4835378,65.0,200078,4.0
13895,September 1998,Minnesota,3635931,2718945,74.8,2644991,72.7,73954,2.7
13896,September 1998,Mississippi,2071699,1276066,61.6,1208993,58.4,67073,5.3
13897,September 1998,Missouri,4172063,2913501,69.8,2797070,67.0,116431,4.0
13898,September 1998,Montana,677458,462222,68.2,436586,64.4,25636,5.5
13899,September 1998,Nebraska,1268594,934191,73.6,909215,71.7,24976,2.7
13900,September 1998,Nevada,1426189,989018,69.3,949163,66.6,39855,4.0
13901,September 1998,New Hampshire,923051,664214,72.0,645560,69.9,18654,2.8
13902,September 1998,New Jersey,6362715,4240673,66.6,4056337,63.8,184336,4.3
13903,September 1998,New Mexico,1320285,834827,63.2,784275,59.4,50552,6.1
13904,September 1998,New York,14404493,9088861,63.1,8591786,59.6,497075,5.5
13905,September 1998,North Carolina,5964144,3999526,67.1,3863956,64.8,135570,3.4
13906,September 1998,North Dakota,486558,348746,71.7,337926,69.5,10820,3.1
13907,September 1998,Ohio,8579585,5718304,66.7,5466324,63.7,251980,4.4
13908,September 1998,Oklahoma,2540823,1645383,64.8,1572562,61.9,72821,4.4
13909,September 1998,Oregon,2589402,1785222,68.9,1679691,64.9,105531,5.9
13910,September 1998,Pennsylvania,9445052,6063941,64.2,5783676,61.2,280265,4.6
13911,September 1998,Rhode Island,802267,533185,66.5,509516,63.5,23669,4.4
13912,September 1998,South Carolina,2955686,1955149,66.1,1877131,63.5,78018,4.0
13913,September 1998,South Dakota,552327,401038,72.6,390085,70.6,10953,2.7
13914,September 1998,Tennessee,4283483,2830179,66.1,2708100,63.2,122079,4.3
13915,September 1998,Texas,14699142,10151338,69.1,9649373,65.6,501965,4.9
13916,September 1998,Utah,1531084,1108001,72.4,1066856,69.7,41145,3.7
13917,September 1998,Vermont,464559,334929,72.1,323840,69.7,11089,3.3
13918,September 1998,Virginia,5183403,3505791,67.6,3403714,65.7,102077,2.9
13919,September 1998,Washington,4363536,3066915,70.3,2915506,66.8,151409,4.9
13920,September 1998,West Virginia,1434031,794787,55.4,742797,51.8,51990,6.5
13921,September 1998,Wisconsin,4020826,2968024,73.8,2861776,71.2,106248,3.6
13922,September 1998,Wyoming,367255,258740,70.5,246436,67.1,12304,4.8
13923,October 1998,Alabama,3350021,2136509,63.8,2039983,60.9,96526,4.5
13924,October 1998,Alaska,428086,316474,73.9,296281,69.2,20193,6.4
13925,October 1998,Arizona,3707082,2419713,65.3,2314353,62.4,105360,4.4
13926,October 1998,Arkansas,1987648,1245761,62.7,1181714,59.5,64047,5.1
13927,October 1998,California,24405702,16248252,66.6,15286737,62.6,961515,5.9
13928,October 1998,Colorado,3133615,2330751,74.4,2248034,71.7,82717,3.5
13929,October 1998,Connecticut,2576086,1744925,67.7,1689502,65.6,55423,3.2
13930,October 1998,Delaware,584063,396493,67.9,382467,65.5,14026,3.5
13931,October 1998,District of Columbia,453754,291726,64.3,268360,59.1,23366,8.0
13932,October 1998,Florida,12125653,7576163,62.5,7258464,59.9,317699,4.2
13933,October 1998,Georgia,5890153,4105159,69.7,3932225,66.8,172934,4.2
13934,October 1998,Hawaii,896903,603353,67.3,566365,63.1,36988,6.1
13935,October 1998,Idaho,922013,654671,71.0,621569,67.4,33102,5.1
13936,October 1998,Illinois,9252385,6389050,69.1,6104642,66.0,284408,4.5
13937,October 1998,Indiana,4548143,3133971,68.9,3033002,66.7,100969,3.2
13938,October 1998,Iowa,2216779,1595730,72.0,1551397,70.0,44333,2.8
13939,October 1998,Kansas,1980252,1428408,72.1,1378069,69.6,50339,3.5
13940,October 1998,Kentucky,3044277,1942517,63.8,1852655,60.9,89862,4.6
13941,October 1998,Louisiana,3269257,2052164,62.8,1935821,59.2,116343,5.7
13942,October 1998,Maine,977544,655696,67.1,626955,64.1,28741,4.4
13943,October 1998,Maryland,3929415,2762617,70.3,2648726,67.4,113891,4.1
13944,October 1998,Massachusetts,4866947,3353406,68.9,3245505,66.7,107901,3.2
13945,October 1998,Michigan,7444175,5048641,67.8,4847797,65.1,200844,4.0
13946,October 1998,Minnesota,3640616,2722685,74.8,2648442,72.7,74243,2.7
13947,October 1998,Mississippi,2073800,1276585,61.6,1210107,58.4,66478,5.2
13948,October 1998,Missouri,4175645,2910289,69.7,2798989,67.0,111300,3.8
13949,October 1998,Montana,677425,463015,68.3,437232,64.5,25783,5.6
13950,October 1998,Nebraska,1268838,935270,73.7,909871,71.7,25399,2.7
13951,October 1998,Nevada,1431115,992644,69.4,953614,66.6,39030,3.9
13952,October 1998,New Hampshire,925147,665859,72.0,646971,69.9,18888,2.8
13953,October 1998,New Jersey,6367893,4245209,66.7,4061927,63.8,183282,4.3
13954,October 1998,New Mexico,1321497,834563,63.2,784433,59.4,50130,6.0
13955,October 1998,New York,14413574,9099746,63.1,8603458,59.7,496288,5.5
13956,October 1998,North Carolina,5972631,4006804,67.1,3873336,64.9,133468,3.3
13957,October 1998,North Dakota,486630,348179,71.5,337081,69.3,11098,3.2
13958,October 1998,Ohio,8582514,5721387,66.7,5471060,63.7,250327,4.4
13959,October 1998,Oklahoma,2544012,1648123,64.8,1576566,62.0,71557,4.3
13960,October 1998,Oregon,2591673,1787608,69.0,1681759,64.9,105849,5.9
13961,October 1998,Pennsylvania,9448662,6068294,64.2,5788836,61.3,279458,4.6
13962,October 1998,Rhode Island,802756,533575,66.5,509983,63.5,23592,4.4
13963,October 1998,South Carolina,2959664,1958901,66.2,1879775,63.5,79126,4.0
13964,October 1998,South Dakota,553416,401819,72.6,390812,70.6,11007,2.7
13965,October 1998,Tennessee,4287078,2838627,66.2,2716497,63.4,122130,4.3
13966,October 1998,Texas,14724743,10164504,69.0,9668810,65.7,495694,4.9
13967,October 1998,Utah,1534533,1110045,72.3,1068900,69.7,41145,3.7
13968,October 1998,Vermont,464583,335405,72.2,324452,69.8,10953,3.3
13969,October 1998,Virginia,5190531,3513688,67.7,3412471,65.7,101217,2.9
13970,October 1998,Washington,4368779,3075211,70.4,2922770,66.9,152441,5.0
13971,October 1998,West Virginia,1433908,795200,55.5,743760,51.9,51440,6.5
13972,October 1998,Wisconsin,4024282,2966731,73.7,2859847,71.1,106884,3.6
13973,October 1998,Wyoming,367277,259127,70.6,246781,67.2,12346,4.8
13974,November 1998,Alabama,3351823,2136348,63.7,2040209,60.9,96139,4.5
13975,November 1998,Alaska,429077,316832,73.8,296525,69.1,20307,6.4
13976,November 1998,Arizona,3714866,2429472,65.4,2322617,62.5,106855,4.4
13977,November 1998,Arkansas,1990060,1247461,62.7,1184174,59.5,63287,5.1
13978,November 1998,California,24445794,16265706,66.5,15316966,62.7,948740,5.8
13979,November 1998,Colorado,3141593,2333507,74.3,2253252,71.7,80255,3.4
13980,November 1998,Connecticut,2576549,1745930,67.8,1691909,65.7,54021,3.1
13981,November 1998,Delaware,584139,396397,67.9,382811,65.5,13586,3.4
13982,November 1998,District of Columbia,454120,292781,64.5,270083,59.5,22698,7.8
13983,November 1998,Florida,12145008,7591256,62.5,7277353,59.9,313903,4.1
13984,November 1998,Georgia,5900164,4111806,69.7,3940926,66.8,170880,4.2
13985,November 1998,Hawaii,898034,602765,67.1,566276,63.1,36489,6.1
13986,November 1998,Idaho,923013,655303,71.0,622241,67.4,33062,5.0
13987,November 1998,Illinois,9259634,6398996,69.1,6118827,66.1,280169,4.4
13988,November 1998,Indiana,4551710,3135192,68.9,3035440,66.7,99752,3.2
13989,November 1998,Iowa,2218107,1596862,72.0,1552634,70.0,44228,2.8
13990,November 1998,Kansas,1981264,1429875,72.2,1380626,69.7,49249,3.4
13991,November 1998,Kentucky,3046327,1944673,63.8,1855134,60.9,89539,4.6
13992,November 1998,Louisiana,3270278,2049397,62.7,1936629,59.2,112768,5.5
13993,November 1998,Maine,978521,656753,67.1,628704,64.3,28049,4.3
13994,November 1998,Maryland,3933240,2761537,70.2,2651114,67.4,110423,4.0
13995,November 1998,Massachusetts,4870937,3356420,68.9,3248728,66.7,107692,3.2
13996,November 1998,Michigan,7448875,5059927,67.9,4859669,65.2,200258,4.0
13997,November 1998,Minnesota,3645301,2725659,74.8,2652357,72.8,73302,2.7
13998,November 1998,Mississippi,2074902,1276558,61.5,1210973,58.4,65585,5.1
13999,November 1998,Missouri,4179226,2906231,69.5,2800838,67.0,105393,3.6
14000,November 1998,Montana,678391,463563,68.3,437726,64.5,25837,5.6
14001,November 1998,Nebraska,1270082,935863,73.7,910254,71.7,25609,2.7
14002,November 1998,Nevada,1435041,996125,69.4,957812,66.7,38313,3.8
14003,November 1998,New Hampshire,926242,667458,72.1,648411,70.0,19047,2.9
14004,November 1998,New Jersey,6372071,4250974,66.7,4068087,63.8,182887,4.3
14005,November 1998,New Mexico,1322709,834460,63.1,784738,59.3,49722,6.0
14006,November 1998,New York,14422654,9107113,63.1,8613449,59.7,493664,5.4
14007,November 1998,North Carolina,5982118,4013323,67.1,3883204,64.9,130119,3.2
14008,November 1998,North Dakota,486702,347477,71.4,336143,69.1,11334,3.3
14009,November 1998,Ohio,8585443,5722670,66.7,5475878,63.8,246792,4.3
14010,November 1998,Oklahoma,2546201,1650374,64.8,1580470,62.1,69904,4.2
14011,November 1998,Oregon,2594943,1789582,69.0,1683942,64.9,105640,5.9
14012,November 1998,Pennsylvania,9451272,6071235,64.2,5794267,61.3,276968,4.6
14013,November 1998,Rhode Island,803244,533962,66.5,510437,63.5,23525,4.4
14014,November 1998,South Carolina,2963642,1961970,66.2,1882203,63.5,79767,4.1
14015,November 1998,South Dakota,553505,402515,72.7,391440,70.7,11075,2.8
14016,November 1998,Tennessee,4291673,2845662,66.3,2723994,63.5,121668,4.3
14017,November 1998,Texas,14750345,10172690,69.0,9686070,65.7,486620,4.8
14018,November 1998,Utah,1536981,1111688,72.3,1070642,69.7,41046,3.7
14019,November 1998,Vermont,465608,335963,72.2,325140,69.8,10823,3.2
14020,November 1998,Virginia,5196658,3519703,67.7,3420318,65.8,99385,2.8
14021,November 1998,Washington,4374023,3081804,70.5,2929771,67.0,152033,4.9
14022,November 1998,West Virginia,1433784,795988,55.5,744888,52.0,51100,6.4
14023,November 1998,Wisconsin,4026737,2964087,73.6,2858625,71.0,105462,3.6
14024,November 1998,Wyoming,368298,259564,70.5,247176,67.1,12388,4.8
14025,December 1998,Alabama,3353625,2136742,63.7,2040515,60.8,96227,4.5
14026,December 1998,Alaska,429069,317156,73.9,296660,69.1,20496,6.5
14027,December 1998,Arizona,3721649,2438165,65.5,2329535,62.6,108630,4.5
14028,December 1998,Arkansas,1991471,1248666,62.7,1186660,59.6,62006,5.0
14029,December 1998,California,24481885,16277468,66.5,15344431,62.7,933037,5.7
14030,December 1998,Colorado,3148570,2335601,74.2,2258017,71.7,77584,3.3
14031,December 1998,Connecticut,2578012,1746976,67.8,1694155,65.7,52821,3.0
14032,December 1998,Delaware,585215,396312,67.7,383051,65.5,13261,3.3
14033,December 1998,District of Columbia,454485,294537,64.8,272486,60.0,22051,7.5
14034,December 1998,Florida,12163364,7602301,62.5,7291586,59.9,310715,4.1
14035,December 1998,Georgia,5910174,4116708,69.7,3947503,66.8,169205,4.1
14036,December 1998,Hawaii,898165,602016,67.0,566068,63.0,35948,6.0
14037,December 1998,Idaho,925014,655035,70.8,622025,67.2,33010,5.0
14038,December 1998,Illinois,9264883,6405913,69.1,6132028,66.2,273885,4.3
14039,December 1998,Indiana,4554278,3133730,68.8,3036603,66.7,97127,3.1
14040,December 1998,Iowa,2219435,1597477,72.0,1553714,70.0,43763,2.7
14041,December 1998,Kansas,1982276,1430277,72.2,1382248,69.7,48029,3.4
14042,December 1998,Kentucky,3048376,1946735,63.9,1857263,60.9,89472,4.6
14043,December 1998,Louisiana,3272300,2046469,62.5,1936927,59.2,109542,5.4
14044,December 1998,Maine,979498,657658,67.1,630365,64.4,27293,4.2
14045,December 1998,Maryland,3936065,2761071,70.1,2653391,67.4,107680,3.9
14046,December 1998,Massachusetts,4873927,3357853,68.9,3250390,66.7,107463,3.2
14047,December 1998,Michigan,7451575,5068642,68.0,4868811,65.3,199831,3.9
14048,December 1998,Minnesota,3649986,2727890,74.7,2656366,72.8,71524,2.6
14049,December 1998,Mississippi,2076004,1276015,61.5,1211292,58.3,64723,5.1
14050,December 1998,Missouri,4181808,2901627,69.4,2801801,67.0,99826,3.4
14051,December 1998,Montana,678357,463849,68.4,438082,64.6,25767,5.6
14052,December 1998,Nebraska,1270326,935947,73.7,910276,71.7,25671,2.7
14053,December 1998,Nevada,1439966,999515,69.4,961653,66.8,37862,3.8
14054,December 1998,New Hampshire,927338,668903,72.1,649817,70.1,19086,2.9
14055,December 1998,New Jersey,6376249,4257388,66.8,4073565,63.9,183823,4.3
14056,December 1998,New Mexico,1323921,834479,63.0,785112,59.3,49367,5.9
14057,December 1998,New York,14429735,9109717,63.1,8620015,59.7,489702,5.4
14058,December 1998,North Carolina,5989605,4018325,67.1,3891686,65.0,126639,3.2
14059,December 1998,North Dakota,486774,346686,71.2,335163,68.9,11523,3.3
14060,December 1998,Ohio,8587373,5723215,66.6,5479695,63.8,243520,4.3
14061,December 1998,Oklahoma,2548389,1651897,64.8,1583700,62.1,68197,4.1
14062,December 1998,Oregon,2597214,1790604,68.9,1685719,64.9,104885,5.9
14063,December 1998,Pennsylvania,9453882,6071853,64.2,5798097,61.3,273756,4.5
14064,December 1998,Rhode Island,803732,534350,66.5,510978,63.6,23372,4.4
14065,December 1998,South Carolina,2967620,1965042,66.2,1884535,63.5,80507,4.1
14066,December 1998,South Dakota,553594,403113,72.8,391975,70.8,11138,2.8
14067,December 1998,Tennessee,4295268,2850723,66.4,2729702,63.6,121021,4.2
14068,December 1998,Texas,14773946,10177601,68.9,9699479,65.7,478122,4.7
14069,December 1998,Utah,1539429,1113053,72.3,1072145,69.6,40908,3.7
14070,December 1998,Vermont,465632,336586,72.3,325904,70.0,10682,3.2
14071,December 1998,Virginia,5202786,3523026,67.7,3425530,65.8,97496,2.8
14072,December 1998,Washington,4379266,3085728,70.5,2934989,67.0,150739,4.9
14073,December 1998,West Virginia,1433661,797092,55.6,745887,52.0,51205,6.4
14074,December 1998,Wisconsin,4030193,2960051,73.4,2857405,70.9,102646,3.5
14075,December 1998,Wyoming,368320,260027,70.6,247589,67.2,12438,4.8
14076,January 1999,Alabama,3354427,2137222,63.7,2040382,60.8,96840,4.5
14077,January 1999,Alaska,430060,317381,73.8,296673,69.0,20708,6.5
14078,January 1999,Arizona,3729433,2445634,65.6,2335229,62.6,110405,4.5
14079,January 1999,Arkansas,1993883,1249336,62.7,1188869,59.6,60467,4.8
14080,January 1999,California,24517977,16285394,66.4,15369917,62.7,915477,5.6
14081,January 1999,Colorado,3155548,2337419,74.1,2262255,71.7,75164,3.2
14082,January 1999,Connecticut,2578475,1748031,67.8,1696005,65.8,52026,3.0
14083,January 1999,Delaware,586291,396289,67.6,383190,65.4,13099,3.3
14084,January 1999,District of Columbia,454851,296822,65.3,275340,60.5,21482,7.2
14085,January 1999,Florida,12181719,7609546,62.5,7301446,59.9,308100,4.0
14086,January 1999,Georgia,5920185,4120267,69.6,3952625,66.8,167642,4.1
14087,January 1999,Hawaii,898296,601291,66.9,565918,63.0,35373,5.9
14088,January 1999,Idaho,926014,653911,70.6,620961,67.1,32950,5.0
14089,January 1999,Illinois,9270132,6411849,69.2,6144070,66.3,267779,4.2
14090,January 1999,Indiana,4555845,3130519,68.7,3036430,66.6,94089,3.0
14091,January 1999,Iowa,2219763,1597640,72.0,1554636,70.0,43004,2.7
14092,January 1999,Kansas,1983288,1429747,72.1,1382871,69.7,46876,3.3
14093,January 1999,Kentucky,3050426,1948949,63.9,1859271,61.0,89678,4.6
14094,January 1999,Louisiana,3273321,2043136,62.4,1936384,59.2,106752,5.2
14095,January 1999,Maine,980475,658526,67.2,631805,64.4,26721,4.1
14096,January 1999,Maryland,3938889,2761219,70.1,2655522,67.4,105697,3.8
14097,January 1999,Massachusetts,4876917,3357905,68.9,3250746,66.7,107159,3.2
14098,January 1999,Michigan,7455274,5075015,68.1,4875165,65.4,199850,3.9
14099,January 1999,Minnesota,3654671,2729728,74.7,2660142,72.8,69586,2.5
14100,January 1999,Mississippi,2078106,1275130,61.4,1211127,58.3,64003,5.0
14101,January 1999,Missouri,4185389,2897463,69.2,2801777,66.9,95686,3.3
14102,January 1999,Montana,678323,463880,68.4,438325,64.6,25555,5.5
14103,January 1999,Nebraska,1271569,935662,73.6,910005,71.6,25657,2.7
14104,January 1999,Nevada,1444892,1002864,69.4,965084,66.8,37780,3.8
14105,January 1999,New Hampshire,928434,670114,72.2,651133,70.1,18981,2.8
14106,January 1999,New Jersey,6379428,4264030,66.8,4077700,63.9,186330,4.4
14107,January 1999,New Mexico,1325134,834569,63.0,785510,59.3,49059,5.9
14108,January 1999,New York,14436816,9108381,63.1,8623485,59.7,484896,5.3
14109,January 1999,North Carolina,5998092,4021548,67.0,3897888,65.0,123660,3.1
14110,January 1999,North Dakota,485846,345864,71.2,334239,68.8,11625,3.4
14111,January 1999,Ohio,8589302,5723638,66.6,5482110,63.8,241528,4.2
14112,January 1999,Oklahoma,2550578,1652711,64.8,1586152,62.2,66559,4.0
14113,January 1999,Oregon,2600484,1790387,68.8,1686743,64.9,103644,5.8
14114,January 1999,Pennsylvania,9455492,6070193,64.2,5800038,61.3,270155,4.5
14115,January 1999,Rhode Island,804220,534747,66.5,511646,63.6,23101,4.3
14116,January 1999,South Carolina,2970598,1968088,66.3,1886723,63.5,81365,4.1
14117,January 1999,South Dakota,553683,403600,72.9,392436,70.9,11164,2.8
14118,January 1999,Tennessee,4298863,2853591,66.4,2733658,63.6,119933,4.2
14119,January 1999,Texas,14797547,10181755,68.8,9709708,65.6,472047,4.6
14120,January 1999,Utah,1540878,1114321,72.3,1073508,69.7,40813,3.7
14121,January 1999,Vermont,466656,337224,72.3,326706,70.0,10518,3.1
14122,January 1999,Virginia,5208914,3523793,67.6,3427886,65.8,95907,2.7
14123,January 1999,Washington,4383509,3087105,70.4,2937784,67.0,149321,4.8
14124,January 1999,West Virginia,1433537,798310,55.7,746628,52.1,51682,6.5
14125,January 1999,Wisconsin,4032648,2955018,73.3,2855989,70.8,99029,3.4
14126,January 1999,Wyoming,368341,260488,70.7,247994,67.3,12494,4.8
14127,February 1999,Alabama,3355229,2137729,63.7,2039818,60.8,97911,4.6
14128,February 1999,Alaska,430052,317480,73.8,296594,69.0,20886,6.6
14129,February 1999,Arizona,3735217,2452267,65.7,2340308,62.7,111959,4.6
14130,February 1999,Arkansas,1995295,1249778,62.6,1190692,59.7,59086,4.7
14131,February 1999,California,24549068,16294579,66.4,15395845,62.7,898734,5.5
14132,February 1999,Colorado,3161525,2339261,74.0,2265817,71.7,73444,3.1
14133,February 1999,Connecticut,2578938,1749049,67.8,1697367,65.8,51682,3.0
14134,February 1999,Delaware,586367,396353,67.6,383261,65.4,13092,3.3
14135,February 1999,District of Columbia,455217,299439,65.8,278422,61.2,21017,7.0
14136,February 1999,Florida,12197074,7615200,62.4,7309229,59.9,305971,4.0
14137,February 1999,Georgia,5929196,4123549,69.5,3957583,66.7,165966,4.0
14138,February 1999,Hawaii,898428,600788,66.9,565973,63.0,34815,5.8
14139,February 1999,Idaho,927014,652302,70.4,619441,66.8,32861,5.0
14140,February 1999,Illinois,9273381,6419760,69.2,6154461,66.4,265299,4.1
14141,February 1999,Indiana,4557413,3127016,68.6,3035336,66.6,91680,2.9
14142,February 1999,Iowa,2220091,1597734,72.0,1555524,70.1,42210,2.6
14143,February 1999,Kansas,1984300,1428762,72.0,1382729,69.7,46033,3.2
14144,February 1999,Kentucky,3052476,1951444,63.9,1861358,61.0,90086,4.6
14145,February 1999,Louisiana,3274342,2039616,62.3,1935212,59.1,104404,5.1
14146,February 1999,Maine,980452,659538,67.3,633100,64.6,26438,4.0
14147,February 1999,Maryland,3940714,2761708,70.1,2657437,67.4,104271,3.8
14148,February 1999,Massachusetts,4879907,3357459,68.8,3250445,66.6,107014,3.2
14149,February 1999,Michigan,7455974,5080403,68.1,4880765,65.5,199638,3.9
14150,February 1999,Minnesota,3658356,2732461,74.7,2663708,72.8,68753,2.5
14151,February 1999,Mississippi,2078208,1274266,61.3,1210795,58.3,63471,5.0
14152,February 1999,Missouri,4186971,2895010,69.1,2801049,66.9,93961,3.2
14153,February 1999,Montana,679290,463778,68.3,438537,64.6,25241,5.4
14154,February 1999,Nebraska,1271813,935282,73.5,909648,71.5,25634,2.7
14155,February 1999,Nevada,1448817,1006217,69.5,968080,66.8,38137,3.8
14156,February 1999,New Hampshire,929529,671109,72.2,652339,70.2,18770,2.8
14157,February 1999,New Jersey,6381606,4271320,66.9,4080615,63.9,190705,4.5
14158,February 1999,New Mexico,1325346,834672,63.0,785886,59.3,48786,5.8
14159,February 1999,New York,14440897,9106298,63.1,8625245,59.7,481053,5.3
14160,February 1999,North Carolina,6004579,4023933,67.0,3902056,65.0,121877,3.0
14161,February 1999,North Dakota,485918,345095,71.0,333458,68.6,11637,3.4
14162,February 1999,Ohio,8588232,5725548,66.7,5484020,63.9,241528,4.2
14163,February 1999,Oklahoma,2551767,1652997,64.8,1588148,62.2,64849,3.9
14164,February 1999,Oregon,2601755,1789311,68.8,1687075,64.8,102236,5.7
14165,February 1999,Pennsylvania,9456102,6068357,64.2,5801158,61.3,267199,4.4
14166,February 1999,Rhode Island,803709,535165,66.6,512415,63.8,22750,4.3
14167,February 1999,South Carolina,2973576,1970906,66.3,1888696,63.5,82210,4.2
14168,February 1999,South Dakota,554772,403979,72.8,392839,70.8,11140,2.8
14169,February 1999,Tennessee,4301458,2854694,66.4,2736333,63.6,118361,4.1
14170,February 1999,Texas,14818149,10188154,68.8,9718427,65.6,469727,4.6
14171,February 1999,Utah,1543326,1115621,72.3,1074825,69.6,40796,3.7
14172,February 1999,Vermont,466681,337846,72.4,327490,70.2,10356,3.1
14173,February 1999,Virginia,5213041,3523192,67.6,3428289,65.8,94903,2.7
14174,February 1999,Washington,4387752,3086985,70.4,2938403,67.0,148582,4.8
14175,February 1999,West Virginia,1433414,799515,55.8,747220,52.1,52295,6.5
14176,February 1999,Wisconsin,4034104,2949687,73.1,2854345,70.8,95342,3.2
14177,February 1999,Wyoming,368363,260948,70.8,248407,67.4,12541,4.8
14178,March 1999,Alabama,3356031,2138574,63.7,2039216,60.8,99358,4.6
14179,March 1999,Alaska,431043,317489,73.7,296484,68.8,21005,6.6
14180,March 1999,Arizona,3742001,2458502,65.7,2345447,62.7,113055,4.6
14181,March 1999,Arkansas,1996707,1250392,62.6,1192224,59.7,58168,4.7
14182,March 1999,California,24580160,16309455,66.4,15424886,62.8,884569,5.4
14183,March 1999,Colorado,3167503,2341129,73.9,2268568,71.6,72561,3.1
14184,March 1999,Connecticut,2579401,1749949,67.8,1698432,65.8,51517,2.9
14185,March 1999,Delaware,587443,396520,67.5,383330,65.3,13190,3.3
14186,March 1999,District of Columbia,455582,302147,66.3,281492,61.8,20655,6.8
14187,March 1999,Florida,12213429,7621791,62.4,7317572,59.9,304219,4.0
14188,March 1999,Georgia,5938207,4128016,69.5,3963619,66.7,164397,4.0
14189,March 1999,Hawaii,898559,600667,66.8,566335,63.0,34332,5.7
14190,March 1999,Idaho,929014,650790,70.1,618003,66.5,32787,5.0
14191,March 1999,Illinois,9277630,6431613,69.3,6162949,66.4,268664,4.2
14192,March 1999,Indiana,4558980,3124303,68.5,3033873,66.5,90430,2.9
14193,March 1999,Iowa,2220419,1598187,72.0,1556463,70.1,41724,2.6
14194,March 1999,Kansas,1985311,1427826,71.9,1382196,69.6,45630,3.2
14195,March 1999,Kentucky,3053526,1954109,64.0,1863576,61.0,90533,4.6
14196,March 1999,Louisiana,3275364,2036509,62.2,1933955,59.0,102554,5.0
14197,March 1999,Maine,981428,660831,67.3,634428,64.6,26403,4.0
14198,March 1999,Maryland,3942539,2762133,70.1,2659057,67.4,103076,3.7
14199,March 1999,Massachusetts,4881897,3357348,68.8,3250088,66.6,107260,3.2
14200,March 1999,Michigan,7457674,5086495,68.2,4888187,65.5,198308,3.9
14201,March 1999,Minnesota,3662042,2737219,74.7,2667336,72.8,69883,2.6
14202,March 1999,Mississippi,2079310,1273928,61.3,1210752,58.2,63176,5.0
14203,March 1999,Missouri,4189553,2894984,69.1,2800159,66.8,94825,3.3
14204,March 1999,Montana,679256,463706,68.3,438793,64.6,24913,5.4
14205,March 1999,Nebraska,1272057,935117,73.5,909463,71.5,25654,2.7
14206,March 1999,Nevada,1452743,1009590,69.5,970678,66.8,38912,3.9
14207,March 1999,New Hampshire,930625,671975,72.2,653457,70.2,18518,2.8
14208,March 1999,New Jersey,6384784,4279532,67.0,4083063,63.9,196469,4.6
14209,March 1999,New Mexico,1326558,834779,62.9,786278,59.3,48501,5.8
14210,March 1999,New York,14444978,9106566,63.0,8627336,59.7,479230,5.3
14211,March 1999,North Carolina,6012066,4027204,67.0,3905549,65.0,121655,3.0
14212,March 1999,North Dakota,485990,344425,70.9,332842,68.5,11583,3.4
14213,March 1999,Ohio,8589161,5730158,66.7,5486836,63.9,243322,4.2
14214,March 1999,Oklahoma,2553956,1653107,64.7,1590176,62.3,62931,3.8
14215,March 1999,Oregon,2604025,1788109,68.7,1687062,64.8,101047,5.7
14216,March 1999,Pennsylvania,9456712,6068578,64.2,5802754,61.4,265824,4.4
14217,March 1999,Rhode Island,804197,535624,66.6,513236,63.8,22388,4.2
14218,March 1999,South Carolina,2976554,1973367,66.3,1890504,63.5,82863,4.2
14219,March 1999,South Dakota,554860,404311,72.9,393210,70.9,11101,2.7
14220,March 1999,Tennessee,4304053,2854856,66.3,2738385,63.6,116471,4.1
14221,March 1999,Texas,14838750,10198320,68.7,9727525,65.6,470795,4.6
14222,March 1999,Utah,1545775,1116995,72.3,1076168,69.6,40827,3.7
14223,March 1999,Vermont,466705,338421,72.5,328196,70.3,10225,3.0
14224,March 1999,Virginia,5218169,3522878,67.5,3428219,65.7,94659,2.7
14225,March 1999,Washington,4390995,3086671,70.3,2937790,66.9,148881,4.8
14226,March 1999,West Virginia,1432290,800711,55.9,747889,52.2,52822,6.6
14227,March 1999,Wisconsin,4036559,2945010,73.0,2852785,70.7,92225,3.1
14228,March 1999,Wyoming,369384,261398,70.8,248831,67.4,12567,4.8
14229,April 1999,Alabama,3357833,2139720,63.7,2038674,60.7,101046,4.7
14230,April 1999,Alaska,431034,317464,73.7,296441,68.8,21023,6.6
14231,April 1999,Arizona,3748784,2464161,65.7,2350763,62.7,113398,4.6
14232,April 1999,Arkansas,1999119,1251322,62.6,1193567,59.7,57755,4.6
14233,April 1999,California,24617251,16330728,66.3,15457598,62.8,873130,5.3
14234,April 1999,Colorado,3174480,2342760,73.8,2270396,71.5,72364,3.1
14235,April 1999,Connecticut,2579864,1750624,67.9,1699510,65.9,51114,2.9
14236,April 1999,Delaware,587520,396793,67.5,383458,65.3,13335,3.4
14237,April 1999,District of Columbia,455948,304580,66.8,284225,62.3,20355,6.7
14238,April 1999,Florida,12231784,7630018,62.4,7327514,59.9,302504,4.0
14239,April 1999,Georgia,5948218,4134483,69.5,3971086,66.8,163397,4.0
14240,April 1999,Hawaii,898690,600922,66.9,567014,63.1,33908,5.6
14241,April 1999,Idaho,930014,649840,69.9,617110,66.4,32730,5.0
14242,April 1999,Illinois,9283879,6446056,69.4,6169877,66.5,276179,4.3
14243,April 1999,Indiana,4561547,3122505,68.5,3032170,66.5,90335,2.9
14244,April 1999,Iowa,2221747,1599000,72.0,1557286,70.1,41714,2.6
14245,April 1999,Kansas,1986323,1427278,71.9,1381527,69.6,45751,3.2
14246,April 1999,Kentucky,3055576,1956644,64.0,1865840,61.1,90804,4.6
14247,April 1999,Louisiana,3277385,2034336,62.1,1932998,59.0,101338,5.0
14248,April 1999,Maine,982405,662472,67.4,635914,64.7,26558,4.0
14249,April 1999,Maryland,3946363,2762312,70.0,2660414,67.4,101898,3.7
14250,April 1999,Massachusetts,4885888,3357595,68.7,3249807,66.5,107788,3.2
14251,April 1999,Michigan,7461374,5093895,68.3,4898154,65.6,195741,3.8
14252,April 1999,Minnesota,3666727,2743773,74.8,2671074,72.8,72699,2.6
14253,April 1999,Mississippi,2081412,1274691,61.2,1211484,58.2,63207,5.0
14254,April 1999,Missouri,4192134,2897369,69.1,2799582,66.8,97787,3.4
14255,April 1999,Montana,679222,463762,68.3,439123,64.7,24639,5.3
14256,April 1999,Nebraska,1273301,935429,73.5,909652,71.4,25777,2.8
14257,April 1999,Nevada,1457669,1012891,69.5,972880,66.7,40011,4.0
14258,April 1999,New Hampshire,931721,672798,72.2,654528,70.2,18270,2.7
14259,April 1999,New Jersey,6388962,4287782,67.1,4085454,63.9,202328,4.7
14260,April 1999,New Mexico,1327770,834942,62.9,786798,59.3,48144,5.8
14261,April 1999,New York,14453059,9110450,63.0,8630814,59.7,479636,5.3
14262,April 1999,North Carolina,6019553,4032289,67.0,3909420,64.9,122869,3.0
14263,April 1999,North Dakota,486062,343892,70.8,332414,68.4,11478,3.3
14264,April 1999,Ohio,8591090,5737448,66.8,5491046,63.9,246402,4.3
14265,April 1999,Oklahoma,2556144,1653412,64.7,1592521,62.3,60891,3.7
14266,April 1999,Oregon,2607296,1787253,68.5,1686947,64.7,100306,5.6
14267,April 1999,Pennsylvania,9458322,6071610,64.2,5805311,61.4,266299,4.4
14268,April 1999,Rhode Island,804685,536137,66.6,514043,63.9,22094,4.1
14269,April 1999,South Carolina,2980532,1975378,66.3,1892052,63.5,83326,4.2
14270,April 1999,South Dakota,554949,404678,72.9,393581,70.9,11097,2.7
14271,April 1999,Tennessee,4307648,2854588,66.3,2740045,63.6,114543,4.0
14272,April 1999,Texas,14863352,10211072,68.7,9737626,65.5,473446,4.6
14273,April 1999,Utah,1548223,1118500,72.2,1077585,69.6,40915,3.7
14274,April 1999,Vermont,466729,338891,72.6,328758,70.4,10133,3.0
14275,April 1999,Virginia,5224296,3523869,67.5,3428728,65.6,95141,2.7
14276,April 1999,Washington,4396239,3086952,70.2,2936902,66.8,150050,4.9
14277,April 1999,West Virginia,1432167,801928,56.0,748801,52.3,53127,6.6
14278,April 1999,Wisconsin,4039015,2941832,72.8,2851801,70.6,90031,3.1
14279,April 1999,Wyoming,369406,261827,70.9,249271,67.5,12556,4.8
14280,May 1999,Alabama,3359635,2140743,63.7,2038176,60.7,102567,4.8
14281,May 1999,Alaska,432026,317454,73.5,296533,68.6,20921,6.6
14282,May 1999,Arizona,3756568,2468947,65.7,2356069,62.7,112878,4.6
14283,May 1999,Arkansas,2000530,1252453,62.6,1194723,59.7,57730,4.6
14284,May 1999,California,24653343,16356903,66.3,15492946,62.8,863957,5.3
14285,May 1999,Colorado,3181458,2343805,73.7,2271258,71.4,72547,3.1
14286,May 1999,Connecticut,2580328,1751080,67.9,1700745,65.9,50335,2.9
14287,May 1999,Delaware,588596,397161,67.5,383699,65.2,13462,3.4
14288,May 1999,District of Columbia,456313,306496,67.2,286444,62.8,20052,6.5
14289,May 1999,Florida,12250140,7638792,62.4,7338371,59.9,300421,3.9
14290,May 1999,Georgia,5958229,4142373,69.5,3979495,66.8,162878,3.9
14291,May 1999,Hawaii,898821,601442,66.9,567958,63.2,33484,5.6
14292,May 1999,Idaho,931014,649611,69.8,616961,66.3,32650,5.0
14293,May 1999,Illinois,9289128,6460608,69.6,6175611,66.5,284997,4.4
14294,May 1999,Indiana,4564115,3121414,68.4,3030219,66.4,91195,2.9
14295,May 1999,Iowa,2223075,1599775,72.0,1557671,70.1,42104,2.6
14296,May 1999,Kansas,1987335,1427018,71.8,1380804,69.5,46214,3.2
14297,May 1999,Kentucky,3058625,1958910,64.0,1868052,61.1,90858,4.6
14298,May 1999,Louisiana,3278406,2033657,62.0,1932583,58.9,101074,5.0
14299,May 1999,Maine,982382,664504,67.6,637730,64.9,26774,4.0
14300,May 1999,Maryland,3949188,2762419,69.9,2661822,67.4,100597,3.6
14301,May 1999,Massachusetts,4888878,3357631,68.7,3249324,66.5,108307,3.2
14302,May 1999,Michigan,7464073,5102267,68.4,4910037,65.8,192230,3.8
14303,May 1999,Minnesota,3670412,2750956,74.9,2674865,72.9,76091,2.8
14304,May 1999,Mississippi,2082514,1276757,61.3,1213144,58.3,63613,5.0
14305,May 1999,Missouri,4195716,2900852,69.1,2799785,66.7,101067,3.5
14306,May 1999,Montana,680188,463953,68.2,439501,64.6,24452,5.3
14307,May 1999,Nebraska,1273544,936194,73.5,910198,71.5,25996,2.8
14308,May 1999,Nevada,1461594,1016006,69.5,974770,66.7,41236,4.1
14309,May 1999,New Hampshire,932817,673646,72.2,655598,70.3,18048,2.7
14310,May 1999,New Jersey,6392141,4294565,67.2,4087937,64.0,206628,4.8
14311,May 1999,New Mexico,1328983,835223,62.8,787548,59.3,47675,5.7
14312,May 1999,New York,14460140,9117406,63.1,8636073,59.7,481333,5.3
14313,May 1999,North Carolina,6028040,4039362,67.0,3914186,64.9,125176,3.1
14314,May 1999,North Dakota,486134,343511,70.7,332138,68.3,11373,3.3
14315,May 1999,Ohio,8592020,5746094,66.9,5496365,64.0,249729,4.3
14316,May 1999,Oklahoma,2558333,1654003,64.7,1595149,62.4,58854,3.6
14317,May 1999,Oregon,2609566,1787032,68.5,1687003,64.6,100029,5.6
14318,May 1999,Pennsylvania,9460932,6076521,64.2,5808374,61.4,268147,4.4
14319,May 1999,Rhode Island,805173,536737,66.7,514796,63.9,21941,4.1
14320,May 1999,South Carolina,2984510,1977104,66.2,1893293,63.4,83811,4.2
14321,May 1999,South Dakota,555038,405138,73.0,393987,71.0,11151,2.8
14322,May 1999,Tennessee,4311244,2854033,66.2,2741119,63.6,112914,4.0
14323,May 1999,Texas,14886953,10224664,68.7,9748276,65.5,476388,4.7
14324,May 1999,Utah,1549671,1120052,72.3,1079012,69.6,41040,3.7
14325,May 1999,Vermont,467754,339257,72.5,329169,70.4,10088,3.0
14326,May 1999,Virginia,5230424,3526539,67.4,3430464,65.6,96075,2.7
14327,May 1999,Washington,4401482,3087727,70.2,2936169,66.7,151558,4.9
14328,May 1999,West Virginia,1432043,803169,56.1,749994,52.4,53175,6.6
14329,May 1999,Wisconsin,4041470,2940417,72.8,2851602,70.6,88815,3.0
14330,May 1999,Wyoming,369427,262246,71.0,249743,67.6,12503,4.8
14331,June 1999,Alabama,3360438,2141354,63.7,2037886,60.6,103468,4.8
14332,June 1999,Alaska,433017,317523,73.3,296790,68.5,20733,6.5
14333,June 1999,Arizona,3763352,2473164,65.7,2361415,62.7,111749,4.5
14334,June 1999,Arkansas,2002942,1253715,62.6,1195840,59.7,57875,4.6
14335,June 1999,California,24691434,16387076,66.4,15530536,62.9,856540,5.2
14336,June 1999,Colorado,3188435,2344372,73.5,2271580,71.2,72792,3.1
14337,June 1999,Connecticut,2581791,1751695,67.8,1702236,65.9,49459,2.8
14338,June 1999,Delaware,588672,397659,67.6,384113,65.3,13546,3.4
14339,June 1999,District of Columbia,456679,307851,67.4,288152,63.1,19699,6.4
14340,June 1999,Florida,12269495,7648071,62.3,7349873,59.9,298198,3.9
14341,June 1999,Georgia,5969240,4150778,69.5,3988228,66.8,162550,3.9
14342,June 1999,Hawaii,898952,602167,67.0,569117,63.3,33050,5.5
14343,June 1999,Idaho,933014,649976,69.7,617449,66.2,32527,5.0
14344,June 1999,Illinois,9295376,6474018,69.6,6181741,66.5,292277,4.5
14345,June 1999,Indiana,4566682,3121096,68.3,3028285,66.3,92811,3.0
14346,June 1999,Iowa,2223403,1600013,72.0,1557470,70.0,42543,2.7
14347,June 1999,Kansas,1989347,1426720,71.7,1380046,69.4,46674,3.3
14348,June 1999,Kentucky,3060675,1960870,64.1,1870242,61.1,90628,4.6
14349,June 1999,Louisiana,3280428,2034977,62.0,1933106,58.9,101871,5.0
14350,June 1999,Maine,983359,666847,67.8,639984,65.1,26863,4.0
14351,June 1999,Maryland,3952013,2762786,69.9,2663703,67.4,99083,3.6
14352,June 1999,Massachusetts,4892868,3357233,68.6,3248597,66.4,108636,3.2
14353,June 1999,Michigan,7467773,5111670,68.4,4922821,65.9,188849,3.7
14354,June 1999,Minnesota,3675097,2757618,75.0,2678615,72.9,79003,2.9
14355,June 1999,Mississippi,2083616,1280095,61.4,1215751,58.3,64344,5.0
14356,June 1999,Missouri,4199297,2904259,69.2,2801598,66.7,102661,3.5
14357,June 1999,Montana,680155,464190,68.2,439863,64.7,24327,5.2
14358,June 1999,Nebraska,1274788,937175,73.5,910935,71.5,26240,2.8
14359,June 1999,Nevada,1466520,1018871,69.5,976613,66.6,42258,4.1
14360,June 1999,New Hampshire,933912,674535,72.2,656652,70.3,17883,2.7
14361,June 1999,New Jersey,6396319,4298955,67.2,4090997,64.0,207958,4.8
14362,June 1999,New Mexico,1329195,835667,62.9,788592,59.3,47075,5.6
14363,June 1999,New York,14468221,9126613,63.1,8643942,59.7,482671,5.3
14364,June 1999,North Carolina,6036528,4048487,67.1,3920378,64.9,128109,3.2
14365,June 1999,North Dakota,485206,343240,70.7,331938,68.4,11302,3.3
14366,June 1999,Ohio,8594949,5754901,67.0,5502637,64.0,252264,4.4
14367,June 1999,Oklahoma,2560522,1654959,64.6,1597931,62.4,57028,3.4
14368,June 1999,Oregon,2612837,1787814,68.4,1687821,64.6,99993,5.6
14369,June 1999,Pennsylvania,9463542,6081633,64.3,5811222,61.4,270411,4.4
14370,June 1999,Rhode Island,805662,537441,66.7,515492,64.0,21949,4.1
14371,June 1999,South Carolina,2987488,1979045,66.2,1894572,63.4,84473,4.3
14372,June 1999,South Dakota,556127,405695,73.0,394460,70.9,11235,2.8
14373,June 1999,Tennessee,4314839,2853615,66.1,2741719,63.5,111896,3.9
14374,June 1999,Texas,14910554,10238515,68.7,9759528,65.5,478987,4.7
14375,June 1999,Utah,1552120,1121467,72.3,1080396,69.6,41071,3.7
14376,June 1999,Vermont,467778,339595,72.6,329526,70.4,10069,3.0
14377,June 1999,Virginia,5236552,3531351,67.4,3434196,65.6,97155,2.8
14378,June 1999,Washington,4405725,3088707,70.1,2935895,66.6,152812,4.9
14379,June 1999,West Virginia,1431920,804467,56.2,751438,52.5,53029,6.6
14380,June 1999,Wisconsin,4043926,2940958,72.7,2852346,70.5,88612,3.0
14381,June 1999,Wyoming,369449,262653,71.1,250247,67.7,12406,4.7
14382,July 1999,Alabama,3362240,2141505,63.7,2037829,60.6,103676,4.8
14383,July 1999,Alaska,433008,317703,73.4,297177,68.6,20526,6.5
14384,July 1999,Arizona,3771136,2476961,65.7,2366522,62.8,110439,4.5
14385,July 1999,Arkansas,2004354,1255126,62.6,1197129,59.7,57997,4.6
14386,July 1999,California,24728526,16419117,66.4,15568249,63.0,850868,5.2
14387,July 1999,Colorado,3195413,2344704,73.4,2271816,71.1,72888,3.1
14388,July 1999,Connecticut,2582254,1752845,67.9,1703957,66.0,48888,2.8
14389,July 1999,Delaware,589748,398319,67.5,384703,65.2,13616,3.4
14390,July 1999,District of Columbia,457045,308717,67.5,289409,63.3,19308,6.3
14391,July 1999,Florida,12287850,7657318,62.3,7360995,59.9,296323,3.9
14392,July 1999,Georgia,5979251,4158941,69.6,3996286,66.8,162655,3.9
14393,July 1999,Hawaii,899083,602987,67.1,570430,63.4,32557,5.4
14394,July 1999,Idaho,934014,650568,69.7,618269,66.2,32299,5.0
14395,July 1999,Illinois,9300625,6484806,69.7,6188637,66.5,296169,4.6
14396,July 1999,Indiana,4569249,3121333,68.3,3026442,66.2,94891,3.0
14397,July 1999,Iowa,2224732,1599301,71.9,1556645,70.0,42656,2.7
14398,July 1999,Kansas,1990359,1426202,71.7,1379176,69.3,47026,3.3
14399,July 1999,Kentucky,3062725,1962334,64.1,1872295,61.1,90039,4.6
14400,July 1999,Louisiana,3281449,2037591,62.1,1934328,58.9,103263,5.1
14401,July 1999,Maine,984336,669339,68.0,642545,65.3,26794,4.0
14402,July 1999,Maryland,3954837,2763767,69.9,2666228,67.4,97539,3.5
14403,July 1999,Massachusetts,4895858,3356141,68.6,3247464,66.3,108677,3.2
14404,July 1999,Michigan,7471473,5121492,68.5,4934718,66.0,186774,3.6
14405,July 1999,Minnesota,3679782,2762803,75.1,2682199,72.9,80604,2.9
14406,July 1999,Mississippi,2084717,1284431,61.6,1219142,58.5,65289,5.1
14407,July 1999,Missouri,4201879,2906797,69.2,2804967,66.8,101830,3.5
14408,July 1999,Montana,681121,464400,68.2,440181,64.6,24219,5.2
14409,July 1999,Nebraska,1276032,938093,73.5,911648,71.4,26445,2.8
14410,July 1999,Nevada,1471446,1021579,69.4,978812,66.5,42767,4.2
14411,July 1999,New Hampshire,935008,675478,72.2,657664,70.3,17814,2.6
14412,July 1999,New Jersey,6400497,4300254,67.2,4094457,64.0,205797,4.8
14413,July 1999,New Mexico,1330407,836233,62.9,789817,59.4,46416,5.6
14414,July 1999,New York,14475301,9135573,63.1,8653680,59.8,481893,5.3
14415,July 1999,North Carolina,6045015,4059247,67.2,3927887,65.0,131360,3.2
14416,July 1999,North Dakota,485278,343042,70.7,331782,68.4,11260,3.3
14417,July 1999,Ohio,8596878,5762972,67.0,5509529,64.1,253443,4.4
14418,July 1999,Oklahoma,2563711,1656214,64.6,1600525,62.4,55689,3.4
14419,July 1999,Oregon,2615107,1789877,68.4,1690024,64.6,99853,5.6
14420,July 1999,Pennsylvania,9466152,6085026,64.3,5812979,61.4,272047,4.5
14421,July 1999,Rhode Island,806150,538238,66.8,516156,64.0,22082,4.1
14422,July 1999,South Carolina,2991466,1981630,66.2,1896168,63.4,85462,4.3
14423,July 1999,South Dakota,556216,406307,73.0,395008,71.0,11299,2.8
14424,July 1999,Tennessee,4318434,2853219,66.1,2741587,63.5,111632,3.9
14425,July 1999,Texas,14935156,10251764,68.6,9770682,65.4,481082,4.7
14426,July 1999,Utah,1554568,1122586,72.2,1081752,69.6,40834,3.6
14427,July 1999,Vermont,468803,339980,72.5,329928,70.4,10052,3.0
14428,July 1999,Virginia,5242679,3537636,67.5,3439396,65.6,98240,2.8
14429,July 1999,Washington,4410968,3089258,70.0,2935953,66.6,153305,5.0
14430,July 1999,West Virginia,1431796,805746,56.3,752959,52.6,52787,6.6
14431,July 1999,Wisconsin,4047381,2943046,72.7,2853722,70.5,89324,3.0
14432,July 1999,Wyoming,369470,263042,71.2,250771,67.9,12271,4.7
14433,August 1999,Alabama,3364042,2141363,63.7,2037974,60.6,103389,4.8
14434,August 1999,Alaska,434000,317984,73.3,297626,68.6,20358,6.4
14435,August 1999,Arizona,3777920,2480341,65.7,2371200,62.8,109141,4.4
14436,August 1999,Arkansas,2006766,1256628,62.6,1198749,59.7,57879,4.6
14437,August 1999,California,24764617,16451416,66.4,15605549,63.0,845867,5.1
14438,August 1999,Colorado,3202390,2344996,73.2,2272380,71.0,72616,3.1
14439,August 1999,Connecticut,2583717,1754677,67.9,1705826,66.0,48851,2.8
14440,August 1999,Delaware,590824,399140,67.6,385431,65.2,13709,3.4
14441,August 1999,District of Columbia,457410,309173,67.6,290258,63.5,18915,6.1
14442,August 1999,Florida,12308205,7666794,62.3,7372093,59.9,294701,3.8
14443,August 1999,Georgia,5989261,4166277,69.6,4003236,66.8,163041,3.9
14444,August 1999,Hawaii,900215,603786,67.1,571823,63.5,31963,5.3
14445,August 1999,Idaho,936015,651148,69.6,619201,66.2,31947,4.9
14446,August 1999,Illinois,9306874,6491757,69.8,6195986,66.6,295771,4.6
14447,August 1999,Indiana,4572817,3122239,68.3,3025310,66.2,96929,3.1
14448,August 1999,Iowa,2226060,1597473,71.8,1555325,69.9,42148,2.6
14449,August 1999,Kansas,1991371,1425432,71.6,1378184,69.2,47248,3.3
14450,August 1999,Kentucky,3065775,1963082,64.0,1874204,61.1,88878,4.5
14451,August 1999,Louisiana,3282470,2040239,62.2,1935763,59.0,104476,5.1
14452,August 1999,Maine,985313,671857,68.2,645240,65.5,26617,4.0
14453,August 1999,Maryland,3958662,2765460,69.9,2669362,67.4,96098,3.5
14454,August 1999,Massachusetts,4898848,3354216,68.5,3245961,66.3,108255,3.2
14455,August 1999,Michigan,7475173,5130644,68.6,4944811,66.1,185833,3.6
14456,August 1999,Minnesota,3685467,2766410,75.1,2685554,72.9,80856,2.9
14457,August 1999,Mississippi,2086819,1289402,61.8,1223109,58.6,66293,5.1
14458,August 1999,Missouri,4205460,2908366,69.2,2809518,66.8,98848,3.4
14459,August 1999,Montana,681087,464596,68.2,440485,64.7,24111,5.2
14460,August 1999,Nebraska,1276276,938822,73.6,912258,71.5,26564,2.8
14461,August 1999,Nevada,1476371,1024377,69.4,981699,66.5,42678,4.2
14462,August 1999,New Hampshire,937104,676476,72.2,658629,70.3,17847,2.6
14463,August 1999,New Jersey,6404675,4298440,67.1,4098167,64.0,200273,4.7
14464,August 1999,New Mexico,1331619,836810,62.8,791059,59.4,45751,5.5
14465,August 1999,New York,14483382,9141542,63.1,8663902,59.8,477640,5.2
14466,August 1999,North Carolina,6052502,4070237,67.2,3935949,65.0,134288,3.3
14467,August 1999,North Dakota,485350,342893,70.6,331665,68.3,11228,3.3
14468,August 1999,Ohio,8598808,5769590,67.1,5516772,64.2,252818,4.4
14469,August 1999,Oklahoma,2564900,1657542,64.6,1602660,62.5,54882,3.3
14470,August 1999,Oregon,2617378,1792996,68.5,1693801,64.7,99195,5.5
14471,August 1999,Pennsylvania,9469762,6085828,64.3,5813923,61.4,271905,4.5
14472,August 1999,Rhode Island,806638,539090,66.8,516861,64.1,22229,4.1
14473,August 1999,South Carolina,2995444,1984816,66.3,1898257,63.4,86559,4.4
14474,August 1999,South Dakota,557305,406924,73.0,395629,71.0,11295,2.8
14475,August 1999,Tennessee,4323029,2852392,66.0,2740747,63.4,111645,3.9
14476,August 1999,Texas,14959757,10263929,68.6,9781805,65.4,482124,4.7
14477,August 1999,Utah,1558017,1123388,72.1,1083175,69.5,40213,3.6
14478,August 1999,Vermont,468827,340412,72.6,330417,70.5,9995,2.9
14479,August 1999,Virginia,5248807,3544581,67.5,3445453,65.6,99128,2.8
14480,August 1999,Washington,4416211,3088565,69.9,2935789,66.5,152776,4.9
14481,August 1999,West Virginia,1431673,806774,56.4,754391,52.7,52383,6.5
14482,August 1999,Wisconsin,4050837,2945714,72.7,2855200,70.5,90514,3.1
14483,August 1999,Wyoming,370492,263411,71.1,251311,67.8,12100,4.6
14484,September 1999,Alabama,3365844,2141338,63.6,2038338,60.6,103000,4.8
14485,September 1999,Alaska,433991,318316,73.3,298070,68.7,20246,6.4
14486,September 1999,Arizona,3785703,2483572,65.6,2375715,62.8,107857,4.3
14487,September 1999,Arkansas,2009177,1258157,62.6,1200682,59.8,57475,4.6
14488,September 1999,California,24802709,16485582,66.5,15644789,63.1,840793,5.1
14489,September 1999,Colorado,3208368,2345577,73.1,2273693,70.9,71884,3.1
14490,September 1999,Connecticut,2585180,1757188,68.0,1707878,66.1,49310,2.8
14491,September 1999,Delaware,590900,400102,67.7,386265,65.4,13837,3.5
14492,September 1999,District of Columbia,457776,309306,67.6,290772,63.5,18534,6.0
14493,September 1999,Florida,12329561,7678355,62.3,7385485,59.9,292870,3.8
14494,September 1999,Georgia,6000272,4172447,69.5,4009700,66.8,162747,3.9
14495,September 1999,Hawaii,900346,604516,67.1,573226,63.7,31290,5.2
14496,September 1999,Idaho,938015,651712,69.5,620178,66.1,31534,4.8
14497,September 1999,Illinois,9313123,6495719,69.7,6204065,66.6,291654,4.5
14498,September 1999,Indiana,4576384,3124297,68.3,3025740,66.1,98557,3.2
14499,September 1999,Iowa,2226388,1595009,71.6,1553855,69.8,41154,2.6
14500,September 1999,Kansas,1992382,1424403,71.5,1377077,69.1,47326,3.3
14501,September 1999,Kentucky,3067824,1963426,64.0,1876142,61.2,87284,4.4
14502,September 1999,Louisiana,3284491,2042166,62.2,1937148,59.0,105018,5.1
14503,September 1999,Maine,986289,674263,68.4,647919,65.7,26344,3.9
14504,September 1999,Maryland,3962487,2767775,69.8,2672927,67.5,94848,3.4
14505,September 1999,Massachusetts,4902838,3351931,68.4,3244601,66.2,107330,3.2
14506,September 1999,Michigan,7479872,5138623,68.7,4953782,66.2,184841,3.6
14507,September 1999,Minnesota,3690152,2769202,75.0,2688868,72.9,80334,2.9
14508,September 1999,Mississippi,2087921,1294866,62.0,1227516,58.8,67350,5.2
14509,September 1999,Missouri,4210042,2909979,69.1,2815134,66.9,94845,3.3
14510,September 1999,Montana,682053,464846,68.2,440841,64.6,24005,5.2
14511,September 1999,Nebraska,1277519,939413,73.5,912825,71.5,26588,2.8
14512,September 1999,Nevada,1481297,1027516,69.4,985386,66.5,42130,4.1
14513,September 1999,New Hampshire,938200,677516,72.2,659558,70.3,17958,2.7
14514,September 1999,New Jersey,6408854,4294910,67.0,4102406,64.0,192504,4.5
14515,September 1999,New Mexico,1333832,837325,62.8,792233,59.4,45092,5.4
14516,September 1999,New York,14492463,9143518,63.1,8674050,59.9,469468,5.1
14517,September 1999,North Carolina,6059989,4079854,67.3,3943584,65.1,136270,3.3
14518,September 1999,North Dakota,485422,342728,70.6,331567,68.3,11161,3.3
14519,September 1999,Ohio,8601737,5774763,67.1,5524231,64.2,250532,4.3
14520,September 1999,Oklahoma,2567088,1658747,64.6,1604292,62.5,54455,3.3
14521,September 1999,Oregon,2620648,1796727,68.6,1698887,64.8,97840,5.4
14522,September 1999,Pennsylvania,9473372,6084708,64.2,5815215,61.4,269493,4.4
14523,September 1999,Rhode Island,808126,539952,66.8,517634,64.1,22318,4.1
14524,September 1999,South Carolina,2998422,1988126,66.3,1900914,63.4,87212,4.4
14525,September 1999,South Dakota,557393,407505,73.1,396310,71.1,11195,2.7
14526,September 1999,Tennessee,4326624,2851374,65.9,2739950,63.3,111424,3.9
14527,September 1999,Texas,14986358,10276684,68.6,9794376,65.4,482308,4.7
14528,September 1999,Utah,1560465,1124028,72.0,1084773,69.5,39255,3.5
14529,September 1999,Vermont,469851,340844,72.5,330979,70.4,9865,2.9
14530,September 1999,Virginia,5255935,3552136,67.6,3452506,65.7,99630,2.8
14531,September 1999,Washington,4421455,3086271,69.8,2934733,66.4,151538,4.9
14532,September 1999,West Virginia,1432549,807508,56.4,755706,52.8,51802,6.4
14533,September 1999,Wisconsin,4055292,2948281,72.7,2856618,70.4,91663,3.1
14534,September 1999,Wyoming,370513,263755,71.2,251866,68.0,11889,4.5
14535,October 1999,Alabama,3366646,2141656,63.6,2038891,60.6,102765,4.8
14536,October 1999,Alaska,433983,318617,73.4,298444,68.8,20173,6.3
14537,October 1999,Arizona,3793487,2487121,65.6,2380469,62.8,106652,4.3
14538,October 1999,Arkansas,2011589,1259816,62.6,1202884,59.8,56932,4.5
14539,October 1999,California,24839800,16524747,66.5,15687986,63.2,836761,5.1
14540,October 1999,Colorado,3215345,2346824,73.0,2276027,70.8,70797,3.0
14541,October 1999,Connecticut,2586643,1760263,68.1,1710205,66.1,50058,2.8
14542,October 1999,Delaware,591976,401177,67.8,387193,65.4,13984,3.5
14543,October 1999,District of Columbia,458141,309264,67.5,291086,63.5,18178,5.9
14544,October 1999,Florida,12349916,7693788,62.3,7402899,59.9,290889,3.8
14545,October 1999,Georgia,6011283,4178054,69.5,4016614,66.8,161440,3.9
14546,October 1999,Hawaii,901477,605132,67.1,574567,63.7,30565,5.1
14547,October 1999,Idaho,939015,652187,69.5,621095,66.1,31092,4.8
14548,October 1999,Illinois,9318372,6499013,69.7,6212799,66.7,286214,4.4
14549,October 1999,Indiana,4578952,3127714,68.3,3027828,66.1,99886,3.2
14550,October 1999,Iowa,2227716,1592746,71.5,1552688,69.7,40058,2.5
14551,October 1999,Kansas,1994394,1423122,71.4,1375796,69.0,47326,3.3
14552,October 1999,Kentucky,3070874,1964013,64.0,1878302,61.2,85711,4.4
14553,October 1999,Louisiana,3285513,2043307,62.2,1938332,59.0,104975,5.1
14554,October 1999,Maine,987266,676417,68.5,650437,65.9,25980,3.8
14555,October 1999,Maryland,3966311,2770614,69.9,2676720,67.5,93894,3.4
14556,October 1999,Massachusetts,4906828,3349733,68.3,3243752,66.1,105981,3.2
14557,October 1999,Michigan,7484572,5145540,68.7,4962729,66.3,182811,3.6
14558,October 1999,Minnesota,3695837,2772433,75.0,2692424,72.9,80009,2.9
14559,October 1999,Mississippi,2090023,1300595,62.2,1232088,59.0,68507,5.3
14560,October 1999,Missouri,4213623,2912857,69.1,2821421,67.0,91436,3.1
14561,October 1999,Montana,683020,465224,68.1,441325,64.6,23899,5.1
14562,October 1999,Nebraska,1278763,939993,73.5,913468,71.4,26525,2.8
14563,October 1999,Nevada,1485222,1031088,69.4,989662,66.6,41426,4.0
14564,October 1999,New Hampshire,939295,678564,72.2,660468,70.3,18096,2.7
14565,October 1999,New Jersey,6413032,4291566,66.9,4107519,64.0,184047,4.3
14566,October 1999,New Mexico,1335044,837772,62.8,793344,59.4,44428,5.3
14567,October 1999,New York,14500544,9142895,63.1,8684233,59.9,458662,5.0
14568,October 1999,North Carolina,6067476,4087549,67.4,3950254,65.1,137295,3.4
14569,October 1999,North Dakota,485494,342539,70.6,331505,68.3,11034,3.2
14570,October 1999,Ohio,8604667,5779198,67.2,5531641,64.3,247557,4.3
14571,October 1999,Oklahoma,2569277,1659703,64.6,1605457,62.5,54246,3.3
14572,October 1999,Oregon,2622919,1800666,68.7,1704716,65.0,95950,5.3
14573,October 1999,Pennsylvania,9476982,6082848,64.2,5817765,61.4,265083,4.4
14574,October 1999,Rhode Island,808615,540765,66.9,518429,64.1,22336,4.1
14575,October 1999,South Carolina,3002400,1991125,66.3,1904151,63.4,86974,4.4
14576,October 1999,South Dakota,558482,408053,73.1,397061,71.1,10992,2.7
14577,October 1999,Tennessee,4331219,2850629,65.8,2739856,63.3,110773,3.9
14578,October 1999,Texas,15011960,10292450,68.6,9809527,65.3,482923,4.7
14579,October 1999,Utah,1562914,1124662,72.0,1086557,69.5,38105,3.4
14580,October 1999,Vermont,469876,331879,70.6,322244,68.6,9635,2.9
14581,October 1999,Virginia,5263062,3560300,67.6,3460792,65.8,99508,2.8
14582,October 1999,Washington,4426698,3082979,69.6,2932669,66.2,150310,4.9
14583,October 1999,West Virginia,1432426,807955,56.4,756960,52.8,50995,6.3
14584,October 1999,Wisconsin,4059748,2950823,72.7,2858129,70.4,92694,3.1
14585,October 1999,Wyoming,371535,264081,71.1,252439,67.9,11642,4.4
14586,November 1999,Alabama,3368448,2142224,63.6,2039773,60.6,102451,4.8
14587,November 1999,Alaska,434974,318846,73.3,298702,68.7,20144,6.3
14588,November 1999,Arizona,3800271,2491425,65.6,2386015,62.8,105410,4.2
14589,November 1999,Arkansas,2014001,1261632,62.6,1205264,59.8,56368,4.5
14590,November 1999,California,24875892,16571553,66.6,15737714,63.3,833839,5.0
14591,November 1999,Colorado,3221323,2349080,72.9,2279617,70.8,69463,3.0
14592,November 1999,Connecticut,2588106,1763576,68.1,1712961,66.2,50615,2.9
14593,November 1999,Delaware,593052,402354,67.8,388233,65.5,14121,3.5
14594,November 1999,District of Columbia,458507,309155,67.4,291302,63.5,17853,5.8
14595,November 1999,Florida,12370271,7715006,62.4,7426287,60.0,288719,3.7
14596,November 1999,Georgia,6022294,4184110,69.5,4025021,66.8,159089,3.8
14597,November 1999,Hawaii,901608,605607,67.2,575804,63.9,29803,4.9
14598,November 1999,Idaho,941015,652634,69.4,621979,66.1,30655,4.7
14599,November 1999,Illinois,9323621,6503998,69.8,6222591,66.7,281407,4.3
14600,November 1999,Indiana,4582519,3132473,68.4,3031506,66.2,100967,3.2
14601,November 1999,Iowa,2229044,1591235,71.4,1552190,69.6,39045,2.5
14602,November 1999,Kansas,1995406,1421831,71.3,1374481,68.9,47350,3.3
14603,November 1999,Kentucky,3072924,1965183,64.0,1880944,61.2,84239,4.3
14604,November 1999,Louisiana,3286534,2044087,62.2,1939576,59.0,104511,5.1
14605,November 1999,Maine,988243,678308,68.6,652725,66.0,25583,3.8
14606,November 1999,Maryland,3970136,2774028,69.9,2680807,67.5,93221,3.4
14607,November 1999,Massachusetts,4909818,3348035,68.2,3243918,66.1,104117,3.1
14608,November 1999,Michigan,7488272,5152506,68.8,4973157,66.4,179349,3.5
14609,November 1999,Minnesota,3700522,2776905,75.0,2696482,72.9,80423,2.9
14610,November 1999,Mississippi,2091125,1306291,62.5,1236654,59.1,69637,5.3
14611,November 1999,Missouri,4217205,2918221,69.2,2828507,67.1,89714,3.1
14612,November 1999,Montana,682986,465742,68.2,441943,64.7,23799,5.1
14613,November 1999,Nebraska,1279007,940673,73.5,914297,71.5,26376,2.8
14614,November 1999,Nevada,1490148,1035033,69.5,994160,66.7,40873,3.9
14615,November 1999,New Hampshire,941391,679627,72.2,661421,70.3,18206,2.7
14616,November 1999,New Jersey,6417210,4290065,66.9,4114146,64.1,175919,4.1
14617,November 1999,New Mexico,1336256,838243,62.7,794486,59.5,43757,5.2
14618,November 1999,New York,14508625,9142965,63.0,8695676,59.9,447289,4.9
14619,November 1999,North Carolina,6074963,4094175,67.4,3956804,65.1,137371,3.4
14620,November 1999,North Dakota,485566,342352,70.5,331488,68.3,10864,3.2
14621,November 1999,Ohio,8606596,5783772,67.2,5539427,64.4,244345,4.2
14622,November 1999,Oklahoma,2570466,1660511,64.6,1606512,62.5,53999,3.3
14623,November 1999,Oregon,2625189,1804602,68.7,1710759,65.2,93843,5.2
14624,November 1999,Pennsylvania,9479592,6082079,64.2,5822868,61.4,259211,4.3
14625,November 1999,Rhode Island,809103,541440,66.9,519186,64.2,22254,4.1
14626,November 1999,South Carolina,3005378,1993320,66.3,1907894,63.5,85426,4.3
14627,November 1999,South Dakota,558571,408562,73.1,397876,71.2,10686,2.6
14628,November 1999,Tennessee,4334814,2850791,65.8,2741289,63.2,109502,3.8
14629,November 1999,Texas,15036561,10312387,68.6,9828720,65.4,483667,4.7
14630,November 1999,Utah,1565362,1125515,71.9,1088588,69.5,36927,3.3
14631,November 1999,Vermont,470900,329468,70.0,320135,68.0,9333,2.8
14632,November 1999,Virginia,5270190,3569500,67.7,3471087,65.9,98413,2.8
14633,November 1999,Washington,4430941,3080062,69.5,2930366,66.1,149696,4.9
14634,November 1999,West Virginia,1432302,808115,56.4,758332,52.9,49783,6.2
14635,November 1999,Wisconsin,4063203,2953800,72.7,2860260,70.4,93540,3.2
14636,November 1999,Wyoming,371556,264400,71.2,253038,68.1,11362,4.3
14637,December 1999,Alabama,3369250,2142726,63.6,2040918,60.6,101808,4.8
14638,December 1999,Alaska,434965,318983,73.3,298838,68.7,20145,6.3
14639,December 1999,Arizona,3807055,2495969,65.6,2391947,62.8,104022,4.2
14640,December 1999,Arkansas,2016413,1263302,62.7,1207477,59.9,55825,4.4
14641,December 1999,California,24907984,16624457,66.7,15791932,63.4,832525,5.0
14642,December 1999,Colorado,3227301,2351915,72.9,2283883,70.8,68032,2.9
14643,December 1999,Connecticut,2588569,1766476,68.2,1716023,66.3,50453,2.9
14644,December 1999,Delaware,593128,403638,68.1,389398,65.7,14240,3.5
14645,December 1999,District of Columbia,458873,308965,67.3,291406,63.5,17559,5.7
14646,December 1999,Florida,12389626,7740561,62.5,7454176,60.2,286385,3.7
14647,December 1999,Georgia,6031305,4190765,69.5,4034595,66.9,156170,3.7
14648,December 1999,Hawaii,902739,605956,67.1,576900,63.9,29056,4.8
14649,December 1999,Idaho,942015,653231,69.3,622952,66.1,30279,4.6
14650,December 1999,Illinois,9328870,6510267,69.8,6232245,66.8,278022,4.3
14651,December 1999,Indiana,4585086,3137297,68.4,3035707,66.2,101590,3.2
14652,December 1999,Iowa,2229372,1590539,71.3,1552174,69.6,38365,2.4
14653,December 1999,Kansas,1996418,1420768,71.2,1373205,68.8,47563,3.3
14654,December 1999,Kentucky,3074974,1966691,64.0,1883766,61.3,82925,4.2
14655,December 1999,Louisiana,3287555,2044868,62.2,1940984,59.0,103884,5.1
14656,December 1999,Maine,989220,679906,68.7,654740,66.2,25166,3.7
14657,December 1999,Maryland,3972961,2777980,69.9,2685000,67.6,92980,3.3
14658,December 1999,Massachusetts,4911808,3346383,68.1,3244732,66.1,101651,3.0
14659,December 1999,Michigan,7490972,5159246,68.9,4984687,66.5,174559,3.4
14660,December 1999,Minnesota,3705207,2782654,75.1,2701003,72.9,81651,2.9
14661,December 1999,Mississippi,2092227,1311686,62.7,1241024,59.3,70662,5.4
14662,December 1999,Missouri,4219787,2925940,69.3,2835825,67.2,90115,3.1
14663,December 1999,Montana,683952,466380,68.2,442677,64.7,23703,5.1
14664,December 1999,Nebraska,1280251,941505,73.5,915298,71.5,26207,2.8
14665,December 1999,Nevada,1495074,1039185,69.5,998554,66.8,40631,3.9
14666,December 1999,New Hampshire,942487,680731,72.2,662465,70.3,18266,2.7
14667,December 1999,New Jersey,6420388,4290658,66.8,4121734,64.2,168924,3.9
14668,December 1999,New Mexico,1337468,838867,62.7,795742,59.5,43125,5.1
14669,December 1999,New York,14513706,9145142,63.0,8707653,60.0,437489,4.8
14670,December 1999,North Carolina,6081450,4100340,67.4,3963570,65.2,136770,3.3
14671,December 1999,North Dakota,485638,342174,70.5,331496,68.3,10678,3.1
14672,December 1999,Ohio,8607525,5787927,67.2,5546970,64.4,240957,4.2
14673,December 1999,Oklahoma,2572655,1661066,64.6,1607542,62.5,53524,3.2
14674,December 1999,Oregon,2627459,1808519,68.8,1716481,65.3,92038,5.1
14675,December 1999,Pennsylvania,9481202,6083407,64.2,5830316,61.5,253091,4.2
14676,December 1999,Rhode Island,810591,541961,66.9,519862,64.1,22099,4.1
14677,December 1999,South Carolina,3008356,1994426,66.3,1911726,63.5,82700,4.1
14678,December 1999,South Dakota,559660,408983,73.1,398652,71.2,10331,2.5
14679,December 1999,Tennessee,4338409,2851535,65.7,2743685,63.2,107850,3.8
14680,December 1999,Texas,15059162,10333611,68.6,9850442,65.4,483169,4.7
14681,December 1999,Utah,1567810,1126784,71.9,1090865,69.6,35919,3.2
14682,December 1999,Vermont,470924,329025,69.9,319983,67.9,9042,2.7
14683,December 1999,Virginia,5275318,3579098,67.8,3482815,66.0,96283,2.7
14684,December 1999,Washington,4436184,3078111,69.4,2928284,66.0,149827,4.9
14685,December 1999,West Virginia,1431178,808146,56.5,759905,53.1,48241,6.0
14686,December 1999,Wisconsin,4066658,2957024,72.7,2862912,70.4,94112,3.2
14687,December 1999,Wyoming,371577,264719,71.2,253660,68.3,11059,4.2
14688,January 2000,Alabama,3370052,2142945,63.6,2042008,60.6,100937,4.7
14689,January 2000,Alaska,434957,319059,73.4,298897,68.7,20162,6.3
14690,January 2000,Arizona,3813839,2499980,65.6,2397307,62.9,102673,4.1
14691,January 2000,Arkansas,2017825,1264619,62.7,1209288,59.9,55331,4.4
14692,January 2000,California,24941075,16680246,66.9,15845618,63.5,834628,5.0
14693,January 2000,Colorado,3232278,2354671,72.8,2287986,70.8,66685,2.8
14694,January 2000,Connecticut,2590032,1768421,68.3,1719025,66.4,49396,2.8
14695,January 2000,Delaware,594204,405052,68.2,390690,65.8,14362,3.5
14696,January 2000,District of Columbia,458238,308686,67.4,291400,63.6,17286,5.6
14697,January 2000,Florida,12407981,7766891,62.6,7481891,60.3,285000,3.7
14698,January 2000,Georgia,6041316,4198288,69.5,4044235,66.9,154053,3.7
14699,January 2000,Hawaii,902870,606200,67.1,577849,64.0,28351,4.7
14700,January 2000,Idaho,943015,654084,69.4,624065,66.2,30019,4.6
14701,January 2000,Illinois,9333119,6516094,69.8,6239476,66.9,276618,4.2
14702,January 2000,Indiana,4587654,3140872,68.5,3038921,66.2,101951,3.2
14703,January 2000,Iowa,2229700,1590191,71.3,1551999,69.6,38192,2.4
14704,January 2000,Kansas,1997430,1419915,71.1,1371875,68.7,48040,3.4
14705,January 2000,Kentucky,3077024,1968042,64.0,1886193,61.3,81849,4.2
14706,January 2000,Louisiana,3287577,2045788,62.2,1942179,59.1,103609,5.1
14707,January 2000,Maine,990197,681087,68.8,656403,66.3,24684,3.6
14708,January 2000,Maryland,3975785,2782556,70.0,2689025,67.6,93531,3.4
14709,January 2000,Massachusetts,4914798,3343974,68.0,3245237,66.0,98737,3.0
14710,January 2000,Michigan,7493672,5164918,68.9,4995155,66.7,169763,3.3
14711,January 2000,Minnesota,3708892,2789080,75.2,2705802,73.0,83278,3.0
14712,January 2000,Mississippi,2093329,1316659,62.9,1244994,59.5,71665,5.4
14713,January 2000,Missouri,4223368,2934571,69.5,2842278,67.3,92293,3.1
14714,January 2000,Montana,683919,467085,68.3,443477,64.8,23608,5.1
14715,January 2000,Nebraska,1280495,942509,73.6,916413,71.6,26096,2.8
14716,January 2000,Nevada,1499999,1043367,69.6,1002619,66.8,40748,3.9
14717,January 2000,New Hampshire,943582,681930,72.3,663649,70.3,18281,2.7
14718,January 2000,New Jersey,6423566,4292278,66.8,4128971,64.3,163307,3.8
14719,January 2000,New Mexico,1338680,839640,62.7,797089,59.5,42551,5.1
14720,January 2000,New York,14519787,9148772,63.0,8718077,60.0,430695,4.7
14721,January 2000,North Carolina,6087937,4106947,67.5,3970504,65.2,136443,3.3
14722,January 2000,North Dakota,485710,342007,70.4,331508,68.3,10499,3.1
14723,January 2000,Ohio,8608455,5791423,67.3,5553437,64.5,237986,4.1
14724,January 2000,Oklahoma,2573844,1661302,64.5,1608423,62.5,52879,3.2
14725,January 2000,Oregon,2629730,1812342,68.9,1721397,65.5,90945,5.0
14726,January 2000,Pennsylvania,9482812,6086807,64.2,5838545,61.6,248262,4.1
14727,January 2000,Rhode Island,811080,542387,66.9,520447,64.2,21940,4.0
14728,January 2000,South Carolina,3012334,1995253,66.2,1915592,63.6,79661,4.0
14729,January 2000,South Dakota,559749,409296,73.1,399284,71.3,10012,2.4
14730,January 2000,Tennessee,4341004,2852337,65.7,2745591,63.2,106746,3.7
14731,January 2000,Texas,15081764,10352120,68.6,9871379,65.5,480741,4.6
14732,January 2000,Utah,1570259,1128581,71.9,1093326,69.6,35255,3.1
14733,January 2000,Vermont,470949,329193,69.9,320376,68.0,8817,2.7
14734,January 2000,Virginia,5281445,3587812,67.9,3494250,66.2,93562,2.6
14735,January 2000,Washington,4440427,3076825,69.3,2926365,65.9,150460,4.9
14736,January 2000,West Virginia,1431055,808244,56.5,761573,53.2,46671,5.8
14737,January 2000,Wisconsin,4070114,2960235,72.7,2865486,70.4,94749,3.2
14738,January 2000,Wyoming,372599,265024,71.1,254277,68.2,10747,4.1
14739,February 2000,Alabama,3370854,2142351,63.6,2042502,60.6,99849,4.7
14740,February 2000,Alaska,435948,319147,73.2,298961,68.6,20186,6.3
14741,February 2000,Arizona,3820622,2502752,65.5,2401290,62.9,101462,4.1
14742,February 2000,Arkansas,2019236,1265218,62.7,1210409,59.9,54809,4.3
14743,February 2000,California,24967167,16732795,67.0,15893795,63.7,839000,5.0
14744,February 2000,Colorado,3238256,2356780,72.8,2291250,70.8,65530,2.8
14745,February 2000,Connecticut,2590495,1769105,68.3,1721530,66.5,47575,2.7
14746,February 2000,Delaware,594280,406611,68.4,392098,66.0,14513,3.6
14747,February 2000,District of Columbia,458604,308340,67.2,291319,63.5,17021,5.5
14748,February 2000,Florida,12424337,7789735,62.7,7504692,60.4,285043,3.7
14749,February 2000,Georgia,6049327,4205995,69.5,4052871,67.0,153124,3.6
14750,February 2000,Hawaii,903001,606306,67.1,578645,64.1,27661,4.6
14751,February 2000,Idaho,945015,655120,69.3,625209,66.2,29911,4.6
14752,February 2000,Illinois,9334368,6518962,69.8,6242388,66.9,276574,4.2
14753,February 2000,Indiana,4588221,3142328,68.5,3040007,66.3,102321,3.3
14754,February 2000,Iowa,2230028,1589626,71.3,1551195,69.6,38431,2.4
14755,February 2000,Kansas,1997441,1418845,71.0,1370270,68.6,48575,3.4
14756,February 2000,Kentucky,3078073,1968722,64.0,1887688,61.3,81034,4.1
14757,February 2000,Louisiana,3287598,2046066,62.2,1942365,59.1,103701,5.1
14758,February 2000,Maine,991173,681766,68.8,657621,66.3,24145,3.5
14759,February 2000,Maryland,3977610,2787422,70.1,2692642,67.7,94780,3.4
14760,February 2000,Massachusetts,4916788,3340208,67.9,3244651,66.0,95557,2.9
14761,February 2000,Michigan,7495371,5168728,69.0,5002034,66.7,166694,3.2
14762,February 2000,Minnesota,3712577,2794851,75.3,2710434,73.0,84417,3.0
14763,February 2000,Mississippi,2093431,1320936,63.1,1248298,59.6,72638,5.5
14764,February 2000,Missouri,4224950,2941758,69.6,2847106,67.4,94652,3.2
14765,February 2000,Montana,684885,467691,68.3,444171,64.9,23520,5.0
14766,February 2000,Nebraska,1281738,943486,73.6,917439,71.6,26047,2.8
14767,February 2000,Nevada,1503925,1047435,69.6,1006304,66.9,41131,3.9
14768,February 2000,New Hampshire,944678,683233,72.3,664954,70.4,18279,2.7
14769,February 2000,New Jersey,6425745,4292831,66.8,4134282,64.3,158549,3.7
14770,February 2000,New Mexico,1339893,840470,62.7,798456,59.6,42014,5.0
14771,February 2000,New York,14522868,9150933,63.0,8724877,60.1,426056,4.7
14772,February 2000,North Carolina,6092424,4113878,67.5,3977161,65.3,136717,3.3
14773,February 2000,North Dakota,485782,341842,70.4,331527,68.2,10315,3.0
14774,February 2000,Ohio,8607384,5793274,67.3,5557799,64.6,235475,4.1
14775,February 2000,Oklahoma,2575032,1661119,64.5,1608971,62.5,52148,3.1
14776,February 2000,Oregon,2632000,1815669,69.0,1725101,65.5,90568,5.0
14777,February 2000,Pennsylvania,9482422,6090752,64.2,5845617,61.6,245135,4.0
14778,February 2000,Rhode Island,811568,542778,66.9,520939,64.2,21839,4.0
14779,February 2000,South Carolina,3014312,1996183,66.2,1919155,63.7,77028,3.9
14780,February 2000,South Dakota,559837,409464,73.1,399672,71.4,9792,2.4
14781,February 2000,Tennessee,4343599,2852381,65.7,2745811,63.2,106570,3.7
14782,February 2000,Texas,15101365,10363975,68.6,9888676,65.5,475299,4.6
14783,February 2000,Utah,1572707,1130836,71.9,1095833,69.7,35003,3.1
14784,February 2000,Vermont,471973,329551,69.8,320860,68.0,8691,2.6
14785,February 2000,Virginia,5286573,3594384,68.0,3503720,66.3,90664,2.5
14786,February 2000,Washington,4443671,3075359,69.2,2924067,65.8,151292,4.9
14787,February 2000,West Virginia,1430931,808465,56.5,763098,53.3,45367,5.6
14788,February 2000,Wisconsin,4072569,2963260,72.8,2867368,70.4,95892,3.2
14789,February 2000,Wyoming,372620,265306,71.2,254841,68.4,10465,3.9
14790,March 2000,Alabama,3371656,2140697,63.5,2041983,60.6,98714,4.6
14791,March 2000,Alaska,435940,319291,73.2,299096,68.6,20195,6.3
14792,March 2000,Arizona,3826406,2503992,65.4,2403395,62.8,100597,4.0
14793,March 2000,Arkansas,2021648,1264912,62.6,1210651,59.9,54261,4.3
14794,March 2000,California,24998258,16778343,67.1,15933360,63.7,844983,5.0
14795,March 2000,Colorado,3243233,2357991,72.7,2293200,70.7,64791,2.7
14796,March 2000,Connecticut,2590958,1768741,68.3,1723175,66.5,45566,2.6
14797,March 2000,Delaware,595356,408297,68.6,393574,66.1,14723,3.6
14798,March 2000,District of Columbia,458969,308027,67.1,291253,63.5,16774,5.4
14799,March 2000,Florida,12441692,7807619,62.8,7520983,60.4,286636,3.7
14800,March 2000,Georgia,6059337,4213192,69.5,4059729,67.0,153463,3.6
14801,March 2000,Hawaii,903133,606226,67.1,579217,64.1,27009,4.5
14802,March 2000,Idaho,946016,656194,69.4,626247,66.2,29947,4.6
14803,March 2000,Illinois,9338617,6517873,69.8,6240306,66.8,277567,4.3
14804,March 2000,Indiana,4590789,3141711,68.4,3038627,66.2,103084,3.3
14805,March 2000,Iowa,2231356,1588624,71.2,1549759,69.5,38865,2.4
14806,March 2000,Kansas,1998453,1417157,70.9,1368121,68.5,49036,3.5
14807,March 2000,Kentucky,3080123,1968494,63.9,1887922,61.3,80572,4.1
14808,March 2000,Louisiana,3287619,2044981,62.2,1940906,59.0,104075,5.1
14809,March 2000,Maine,992150,681964,68.7,658353,66.4,23611,3.5
14810,March 2000,Maryland,3980435,2791844,70.1,2695274,67.7,96570,3.5
14811,March 2000,Massachusetts,4918778,3335178,67.8,3242685,65.9,92493,2.8
14812,March 2000,Michigan,7497071,5170682,69.0,5003215,66.7,167467,3.2
14813,March 2000,Minnesota,3717262,2799169,75.3,2714446,73.0,84723,3.0
14814,March 2000,Mississippi,2094533,1324176,63.2,1250705,59.7,73471,5.5
14815,March 2000,Missouri,4227531,2946114,69.7,2849858,67.4,96256,3.3
14816,March 2000,Montana,684851,468063,68.3,444620,64.9,23443,5.0
14817,March 2000,Nebraska,1281982,944246,73.7,918174,71.6,26072,2.8
14818,March 2000,Nevada,1508850,1051389,69.7,1009806,66.9,41583,4.0
14819,March 2000,New Hampshire,945774,684572,72.4,666266,70.4,18306,2.7
14820,March 2000,New Jersey,6427923,4291454,66.8,4136512,64.4,154942,3.6
14821,March 2000,New Mexico,1340105,841358,62.8,799779,59.7,41579,4.9
14822,March 2000,New York,14526949,9149949,63.0,8726607,60.1,423342,4.6
14823,March 2000,North Carolina,6098911,4120718,67.6,3982596,65.3,138122,3.4
14824,March 2000,North Dakota,485854,341752,70.3,331604,68.3,10148,3.0
14825,March 2000,Ohio,8608314,5793337,67.3,5559186,64.6,234151,4.0
14826,March 2000,Oklahoma,2576221,1660590,64.5,1609053,62.5,51537,3.1
14827,March 2000,Oregon,2633271,1818372,69.1,1727424,65.6,90948,5.0
14828,March 2000,Pennsylvania,9484032,6094109,64.3,5850115,61.7,243994,4.0
14829,March 2000,Rhode Island,812056,543164,66.9,521317,64.2,21847,4.0
14830,March 2000,South Carolina,3017290,1997123,66.2,1921756,63.7,75367,3.8
14831,March 2000,South Dakota,560926,409423,73.0,399738,71.3,9685,2.4
14832,March 2000,Tennessee,4346194,2851026,65.6,2743688,63.1,107338,3.8
14833,March 2000,Texas,15122966,10368180,68.6,9900637,65.5,467543,4.5
14834,March 2000,Utah,1574156,1133369,72.0,1098193,69.8,35176,3.1
14835,March 2000,Vermont,471997,329949,69.9,321267,68.1,8682,2.6
14836,March 2000,Virginia,5291701,3597995,68.0,3509963,66.3,88032,2.4
14837,March 2000,Washington,4447914,3073238,69.1,2920715,65.7,152523,5.0
14838,March 2000,West Virginia,1429808,808690,56.6,764223,53.4,44467,5.5
14839,March 2000,Wisconsin,4075025,2966094,72.8,2868165,70.4,97929,3.3
14840,March 2000,Wyoming,372642,265592,71.3,255335,68.5,10257,3.9
14841,April 2000,Alabama,3374388,2138178,63.4,2040546,60.5,97632,4.6
14842,April 2000,Alaska,434498,319477,73.5,299269,68.9,20208,6.3
14843,April 2000,Arizona,3821926,2503989,65.5,2403807,62.9,100182,4.0
14844,April 2000,Arkansas,2022461,1263822,62.5,1210092,59.8,53730,4.3
14845,April 2000,California,25034666,16815943,67.2,15964423,63.8,851520,5.1
14846,April 2000,Colorado,3245428,2358321,72.7,2293730,70.7,64591,2.7
14847,April 2000,Connecticut,2589182,1767722,68.3,1723883,66.6,43839,2.5
14848,April 2000,Delaware,594827,410055,68.9,395051,66.4,15004,3.7
14849,April 2000,District of Columbia,457251,307908,67.3,291319,63.7,16589,5.4
14850,April 2000,Florida,12431288,7821650,62.9,7531975,60.6,289675,3.7
14851,April 2000,Georgia,6061556,4219262,69.6,4064425,67.1,154837,3.7
14852,April 2000,Hawaii,898109,605946,67.5,579490,64.5,26456,4.4
14853,April 2000,Idaho,946982,657235,69.4,627130,66.2,30105,4.6
14854,April 2000,Illinois,9328045,6513433,69.8,6233854,66.8,279579,4.3
14855,April 2000,Indiana,4591689,3139239,68.4,3035362,66.1,103877,3.3
14856,April 2000,Iowa,2230938,1587319,71.2,1547947,69.4,39372,2.5
14857,April 2000,Kansas,1997350,1414679,70.8,1365300,68.4,49379,3.5
14858,April 2000,Kentucky,3080332,1967218,63.9,1886889,61.3,80329,4.1
14859,April 2000,Louisiana,3287478,2042237,62.1,1937656,58.9,104581,5.1
14860,April 2000,Maine,991786,681675,68.7,658551,66.4,23124,3.4
14861,April 2000,Maryland,3981648,2795579,70.2,2696854,67.7,98725,3.5
14862,April 2000,Massachusetts,4916613,3329579,67.7,3239643,65.9,89936,2.7
14863,April 2000,Michigan,7502107,5170777,68.9,4998088,66.6,172689,3.3
14864,April 2000,Minnesota,3719417,2802390,75.3,2717820,73.1,84570,3.0
14865,April 2000,Mississippi,2092736,1325943,63.4,1252004,59.8,73939,5.6
14866,April 2000,Missouri,4225858,2947684,69.8,2850551,67.5,97133,3.3
14867,April 2000,Montana,685731,468226,68.3,444833,64.9,23393,5.0
14868,April 2000,Nebraska,1281742,944725,73.7,918565,71.7,26160,2.8
14869,April 2000,Nevada,1508246,1055413,70.0,1013383,67.2,42030,4.0
14870,April 2000,New Hampshire,946028,685841,72.5,667470,70.6,18371,2.7
14871,April 2000,New Jersey,6425530,4288575,66.7,4135524,64.4,153051,3.6
14872,April 2000,New Mexico,1339614,842276,62.9,800989,59.8,41287,4.9
14873,April 2000,New York,14522319,9145145,63.0,8723092,60.1,422053,4.6
14874,April 2000,North Carolina,6089112,4127403,67.8,3986425,65.5,140978,3.4
14875,April 2000,North Dakota,485023,341804,70.5,331754,68.4,10050,2.9
14876,April 2000,Ohio,8611098,5792129,67.3,5557794,64.5,234335,4.0
14877,April 2000,Oklahoma,2575814,1659997,64.4,1608791,62.5,51206,3.1
14878,April 2000,Oregon,2634245,1820366,69.1,1728525,65.6,91841,5.0
14879,April 2000,Pennsylvania,9475946,6096691,64.3,5851908,61.8,244783,4.0
14880,April 2000,Rhode Island,810153,543522,67.1,521554,64.4,21968,4.0
14881,April 2000,South Carolina,3017672,1997774,66.2,1922900,63.7,74874,3.7
14882,April 2000,South Dakota,560520,409173,73.0,399500,71.3,9673,2.4
14883,April 2000,Tennessee,4346560,2848175,65.5,2739370,63.0,108805,3.8
14884,April 2000,Texas,15133460,10366277,68.5,9907234,65.5,459043,4.4
14885,April 2000,Utah,1574374,1135920,72.2,1100234,69.9,35686,3.1
14886,April 2000,Vermont,473116,330367,69.8,321575,68.0,8792,2.7
14887,April 2000,Virginia,5282458,3598633,68.1,3512676,66.5,85957,2.4
14888,April 2000,Washington,4450803,3069974,69.0,2915855,65.5,154119,5.0
14889,April 2000,West Virginia,1430719,808769,56.5,764802,53.5,43967,5.4
14890,April 2000,Wisconsin,4077259,2968701,72.8,2867789,70.3,100912,3.4
14891,April 2000,Wyoming,372257,265906,71.4,255749,68.7,10157,3.8
14892,May 2000,Alabama,3376115,2135307,63.2,2038520,60.4,96787,4.5
14893,May 2000,Alaska,434753,319659,73.5,299410,68.9,20249,6.3
14894,May 2000,Arizona,3830993,2503461,65.3,2403463,62.7,99998,4.0
14895,May 2000,Arkansas,2023966,1262136,62.4,1208931,59.7,53205,4.2
14896,May 2000,California,25062445,16844925,67.2,15989651,63.8,855274,5.1
14897,May 2000,Colorado,3252117,2357978,72.5,2293201,70.5,64777,2.7
14898,May 2000,Connecticut,2590914,1766345,68.2,1723927,66.5,42418,2.4
14899,May 2000,Delaware,595635,411779,69.1,396465,66.6,15314,3.7
14900,May 2000,District of Columbia,457179,308060,67.4,291530,63.8,16530,5.4
14901,May 2000,Florida,12448757,7833369,62.9,7540303,60.6,293066,3.7
14902,May 2000,Georgia,6073419,4223636,69.5,4067325,67.0,156311,3.7
14903,May 2000,Hawaii,898282,605553,67.4,579520,64.5,26033,4.3
14904,May 2000,Idaho,948495,658198,69.4,627841,66.2,30357,4.6
14905,May 2000,Illinois,9332844,6506021,69.7,6224796,66.7,281225,4.3
14906,May 2000,Indiana,4595044,3134814,68.2,3031166,66.0,103648,3.3
14907,May 2000,Iowa,2231626,1586186,71.1,1546248,69.3,39938,2.5
14908,May 2000,Kansas,1998658,1411553,70.6,1361869,68.1,49684,3.5
14909,May 2000,Kentucky,3082558,1965116,63.7,1885008,61.2,80108,4.1
14910,May 2000,Louisiana,3288084,2037977,62.0,1933038,58.8,104939,5.1
14911,May 2000,Maine,992520,680794,68.6,658077,66.3,22717,3.3
14912,May 2000,Maryland,3985656,2798681,70.2,2697860,67.7,100821,3.6
14913,May 2000,Massachusetts,4920344,3324450,67.6,3236434,65.8,88016,2.6
14914,May 2000,Michigan,7507302,5168601,68.8,4988004,66.4,180597,3.5
14915,May 2000,Minnesota,3723374,2805323,75.3,2720697,73.1,84626,3.0
14916,May 2000,Mississippi,2094047,1325942,63.3,1252180,59.8,73762,5.6
14917,May 2000,Missouri,4228880,2948096,69.7,2849864,67.4,98232,3.3
14918,May 2000,Montana,686136,468200,68.2,444841,64.8,23359,5.0
14919,May 2000,Nebraska,1282421,944948,73.7,918661,71.6,26287,2.8
14920,May 2000,Nevada,1513401,1059666,70.0,1017139,67.2,42527,4.0
14921,May 2000,New Hampshire,947354,686928,72.5,668482,70.6,18446,2.7
14922,May 2000,New Jersey,6430360,4284575,66.6,4131803,64.3,152772,3.6
14923,May 2000,New Mexico,1340174,843255,62.9,802086,59.8,41169,4.9
14924,May 2000,New York,14528845,9136838,62.9,8716038,60.0,420800,4.6
14925,May 2000,North Carolina,6097166,4133490,67.8,3988637,65.4,144853,3.5
14926,May 2000,North Dakota,484894,341975,70.5,331965,68.5,10010,2.9
14927,May 2000,Ohio,8614966,5789756,67.2,5554549,64.5,235207,4.1
14928,May 2000,Oklahoma,2577332,1659582,64.4,1608478,62.4,51104,3.1
14929,May 2000,Oregon,2636789,1821537,69.1,1728646,65.6,92891,5.1
14930,May 2000,Pennsylvania,9477978,6098600,64.3,5851816,61.7,246784,4.0
14931,May 2000,Rhode Island,810826,543780,67.1,521625,64.3,22155,4.1
14932,May 2000,South Carolina,3021153,1997557,66.1,1922499,63.6,75058,3.8
14933,May 2000,South Dakota,560792,408782,72.9,399068,71.2,9714,2.4
14934,May 2000,Tennessee,4350842,2844087,65.4,2733826,62.8,110261,3.9
14935,May 2000,Texas,15156739,10360899,68.4,9910437,65.4,450462,4.3
14936,May 2000,Utah,1577260,1138332,72.2,1101945,69.9,36387,3.2
14937,May 2000,Vermont,473441,330799,69.9,321808,68.0,8991,2.7
14938,May 2000,Virginia,5289327,3597365,68.0,3513008,66.4,84357,2.3
14939,May 2000,Washington,4455649,3065479,68.8,2909727,65.3,155752,5.1
14940,May 2000,West Virginia,1430554,808649,56.5,764882,53.5,43767,5.4
14941,May 2000,Wisconsin,4080284,2970767,72.8,2866577,70.3,104190,3.5
14942,May 2000,Wyoming,372357,266236,71.5,256080,68.8,10156,3.8
14943,June 2000,Alabama,3378019,2132623,63.1,2036174,60.3,96449,4.5
14944,June 2000,Alaska,435039,319766,73.5,299453,68.8,20313,6.4
14945,June 2000,Arizona,3840218,2502998,65.2,2403304,62.6,99694,4.0
14946,June 2000,Arkansas,2025602,1260089,62.2,1207303,59.6,52786,4.2
14947,June 2000,California,25092141,16866287,67.2,16011773,63.8,854514,5.1
14948,June 2000,Colorado,3258979,2357302,72.3,2292153,70.3,65149,2.8
14949,June 2000,Connecticut,2592835,1764692,68.1,1723545,66.5,41147,2.3
14950,June 2000,Delaware,596507,413343,69.3,397759,66.7,15584,3.8
14951,June 2000,District of Columbia,457183,308534,67.5,291897,63.8,16637,5.4
14952,June 2000,Florida,12467007,7843623,62.9,7548177,60.5,295446,3.8
14953,June 2000,Georgia,6085633,4225755,69.4,4068914,66.9,156841,3.7
14954,June 2000,Hawaii,898329,605133,67.4,579451,64.5,25682,4.2
14955,June 2000,Idaho,950082,659082,69.4,628423,66.1,30659,4.7
14956,June 2000,Illinois,9338109,6496077,69.6,6214470,66.5,281607,4.3
14957,June 2000,Indiana,4598621,3128446,68.0,3026717,65.8,101729,3.3
14958,June 2000,Iowa,2232483,1585754,71.0,1545071,69.2,40683,2.6
14959,June 2000,Kansas,2000089,1408039,70.4,1357943,67.9,50096,3.6
14960,June 2000,Kentucky,3084920,1962889,63.6,1882814,61.0,80075,4.1
14961,June 2000,Louisiana,3288851,2033038,61.8,1927628,58.6,105410,5.2
14962,June 2000,Maine,993373,679395,68.4,656950,66.1,22445,3.3
14963,June 2000,Maryland,3989864,2801220,70.2,2698787,67.6,102433,3.7
14964,June 2000,Massachusetts,4924321,3320616,67.4,3233865,65.7,86751,2.6
14965,June 2000,Michigan,7512817,5163919,68.7,4975344,66.2,188575,3.7
14966,June 2000,Minnesota,3727522,2808736,75.4,2723118,73.1,85618,3.0
14967,June 2000,Mississippi,2095521,1324402,63.2,1251358,59.7,73044,5.5
14968,June 2000,Missouri,4232096,2948918,69.7,2848636,67.3,100282,3.4
14969,June 2000,Montana,686656,468032,68.2,444698,64.8,23334,5.0
14970,June 2000,Nebraska,1283175,945069,73.7,918588,71.6,26481,2.8
14971,June 2000,Nevada,1518690,1064200,70.1,1020971,67.2,43229,4.1
14972,June 2000,New Hampshire,948805,687780,72.5,669308,70.5,18472,2.7
14973,June 2000,New Jersey,6435521,4280052,66.5,4125998,64.1,154054,3.6
14974,June 2000,New Mexico,1340893,844378,63.0,803137,59.9,41241,4.9
14975,June 2000,New York,14536216,9126545,62.8,8707347,59.9,419198,4.6
14976,June 2000,North Carolina,6105495,4138090,67.8,3988898,65.3,149192,3.6
14977,June 2000,North Dakota,484811,342231,70.6,332207,68.5,10024,2.9
14978,June 2000,Ohio,8619180,5786238,67.1,5550444,64.4,235794,4.1
14979,June 2000,Oklahoma,2578950,1659412,64.3,1608294,62.4,51118,3.1
14980,June 2000,Oregon,2639540,1821849,69.0,1727952,65.5,93897,5.2
14981,June 2000,Pennsylvania,9480412,6100213,64.3,5850689,61.7,249524,4.1
14982,June 2000,Rhode Island,811626,543885,67.0,521526,64.3,22359,4.1
14983,June 2000,South Carolina,3024788,1996023,66.0,1920870,63.5,75153,3.8
14984,June 2000,South Dakota,561177,408367,72.8,398567,71.0,9800,2.4
14985,June 2000,Tennessee,4355320,2839455,65.2,2728036,62.6,111419,3.9
14986,June 2000,Texas,15181172,10355498,68.2,9912411,65.3,443087,4.3
14987,June 2000,Utah,1580225,1140607,72.2,1103366,69.8,37241,3.3
14988,June 2000,Vermont,473872,331203,69.9,321964,67.9,9239,2.8
14989,June 2000,Virginia,5296457,3595504,67.9,3512567,66.3,82937,2.3
14990,June 2000,Washington,4460652,3060176,68.6,2902766,65.1,157410,5.1
14991,June 2000,West Virginia,1430482,808363,56.5,764604,53.5,43759,5.4
14992,June 2000,Wisconsin,4083497,2971948,72.8,2864998,70.2,106950,3.6
14993,June 2000,Wyoming,372540,266591,71.6,256356,68.8,10235,3.8
14994,July 2000,Alabama,3379852,2130313,63.0,2033898,60.2,96415,4.5
14995,July 2000,Alaska,435275,319777,73.5,299386,68.8,20391,6.4
14996,July 2000,Arizona,3849529,2503457,65.0,2404429,62.5,99028,4.0
14997,July 2000,Arkansas,2027169,1257820,62.0,1205263,59.5,52557,4.2
14998,July 2000,California,25122108,16883614,67.2,16035176,63.8,848438,5.0
14999,July 2000,Colorado,3265808,2356861,72.2,2291396,70.2,65465,2.8
15000,July 2000,Connecticut,2594750,1762901,67.9,1722976,66.4,39925,2.3
15001,July 2000,Delaware,597308,414712,69.4,398934,66.8,15778,3.8
15002,July 2000,District of Columbia,457124,309447,67.7,292544,64.0,16903,5.5
15003,July 2000,Florida,12485621,7854270,62.9,7558468,60.5,295802,3.8
15004,July 2000,Georgia,6097791,4225523,69.3,4070215,66.7,155308,3.7
15005,July 2000,Hawaii,898534,604857,67.3,579512,64.5,25345,4.2
15006,July 2000,Idaho,951580,660000,69.4,628967,66.1,31033,4.7
15007,July 2000,Illinois,9343505,6485284,69.4,6204277,66.4,281007,4.3
15008,July 2000,Indiana,4602084,3120861,67.8,3022816,65.7,98045,3.1
15009,July 2000,Iowa,2233194,1586373,71.0,1544727,69.2,41646,2.6
15010,July 2000,Kansas,2001437,1404368,70.2,1353848,67.6,50520,3.6
15011,July 2000,Kentucky,3087202,1961421,63.5,1880996,60.9,80425,4.1
15012,July 2000,Louisiana,3289553,2028950,61.7,1922551,58.4,106399,5.2
15013,July 2000,Maine,994123,677792,68.2,655490,65.9,22302,3.3
15014,July 2000,Maryland,3994146,2803762,70.2,2700405,67.6,103357,3.7
15015,July 2000,Massachusetts,4928325,3318704,67.3,3232657,65.6,86047,2.6
15016,July 2000,Michigan,7518317,5158191,68.6,4964025,66.0,194166,3.8
15017,July 2000,Minnesota,3731556,2813086,75.4,2725381,73.0,87705,3.1
15018,July 2000,Mississippi,2096871,1321846,63.0,1249846,59.6,72000,5.4
15019,July 2000,Missouri,4235242,2951489,69.7,2848241,67.3,103248,3.5
15020,July 2000,Montana,687074,467724,68.1,444420,64.7,23304,5.0
15021,July 2000,Nebraska,1283867,945175,73.6,918460,71.5,26715,2.8
15022,July 2000,Nevada,1523973,1068902,70.1,1024708,67.2,44194,4.1
15023,July 2000,New Hampshire,950153,688447,72.5,670032,70.5,18415,2.7
15024,July 2000,New Jersey,6440878,4276328,66.4,4119877,64.0,156451,3.7
15025,July 2000,New Mexico,1341617,845707,63.0,804298,59.9,41409,4.9
15026,July 2000,New York,14543810,9117373,62.7,8700292,59.8,417081,4.6
15027,July 2000,North Carolina,6113834,4140751,67.7,3987401,65.2,153350,3.7
15028,July 2000,North Dakota,484684,342537,70.7,332439,68.6,10098,2.9
15029,July 2000,Ohio,8623387,5782129,67.1,5546925,64.3,235204,4.1
15030,July 2000,Oklahoma,2580531,1659454,64.3,1608428,62.3,51026,3.1
15031,July 2000,Oregon,2642201,1821305,68.9,1726726,65.4,94579,5.2
15032,July 2000,Pennsylvania,9482949,6102279,64.4,5849753,61.7,252526,4.1
15033,July 2000,Rhode Island,812307,543886,67.0,521361,64.2,22525,4.1
15034,July 2000,South Carolina,3028366,1993627,65.8,1918912,63.4,74715,3.7
15035,July 2000,South Dakota,561458,408038,72.7,398107,70.9,9931,2.4
15036,July 2000,Tennessee,4359743,2835491,65.0,2723387,62.5,112104,4.0
15037,July 2000,Texas,15205794,10353750,68.1,9916553,65.2,437197,4.2
15038,July 2000,Utah,1583044,1142892,72.2,1104672,69.8,38220,3.3
15039,July 2000,Vermont,474208,331566,69.9,322087,67.9,9479,2.9
15040,July 2000,Virginia,5303617,3595262,67.8,3513928,66.3,81334,2.3
15041,July 2000,Washington,4465758,3054823,68.4,2895781,64.8,159042,5.2
15042,July 2000,West Virginia,1430344,808136,56.5,764252,53.4,43884,5.4
15043,July 2000,Wisconsin,4086610,2972549,72.7,2863792,70.1,108757,3.7
15044,July 2000,Wyoming,372630,266974,71.6,256616,68.9,10358,3.9
15045,August 2000,Alabama,3381310,2128594,63.0,2032077,60.1,96517,4.5
15046,August 2000,Alaska,435991,319719,73.3,299242,68.6,20477,6.4
15047,August 2000,Arizona,3858859,2505964,64.9,2407748,62.4,98216,3.9
15048,August 2000,Arkansas,2028445,1255550,61.9,1203013,59.3,52537,4.2
15049,August 2000,California,25159823,16903091,67.2,16064840,63.9,838251,5.0
15050,August 2000,Colorado,3273219,2357452,72.0,2291922,70.0,65530,2.8
15051,August 2000,Connecticut,2596443,1761428,67.8,1722454,66.3,38974,2.2
15052,August 2000,Delaware,597988,415974,69.6,400046,66.9,15928,3.8
15053,August 2000,District of Columbia,457542,310795,67.9,293493,64.1,17302,5.6
15054,August 2000,Florida,12508314,7868460,62.9,7574015,60.6,294445,3.7
15055,August 2000,Georgia,6109604,4224983,69.2,4072986,66.7,151997,3.6
15056,August 2000,Hawaii,899321,604851,67.3,579867,64.5,24984,4.1
15057,August 2000,Idaho,953178,660985,69.3,629575,66.1,31410,4.8
15058,August 2000,Illinois,9350076,6476765,69.3,6196136,66.3,280629,4.3
15059,August 2000,Indiana,4604966,3114439,67.6,3020538,65.6,93901,3.0
15060,August 2000,Iowa,2234016,1588139,71.1,1545434,69.2,42705,2.7
15061,August 2000,Kansas,2002725,1401014,70.0,1350025,67.4,50989,3.6
15062,August 2000,Kentucky,3089097,1961456,63.5,1880200,60.9,81256,4.1
15063,August 2000,Louisiana,3290371,2027366,61.6,1919201,58.3,108165,5.3
15064,August 2000,Maine,995112,676247,68.0,654051,65.7,22196,3.3
15065,August 2000,Maryland,3999344,2807112,70.2,2703445,67.6,103667,3.7
15066,August 2000,Massachusetts,4932825,3319366,67.3,3233471,65.6,85895,2.6
15067,August 2000,Michigan,7523894,5154301,68.5,4956926,65.9,197375,3.8
15068,August 2000,Minnesota,3736180,2818258,75.4,2727914,73.0,90344,3.2
15069,August 2000,Mississippi,2097691,1318852,62.9,1248185,59.5,70667,5.4
15070,August 2000,Missouri,4238910,2957543,69.8,2850080,67.2,107463,3.6
15071,August 2000,Montana,687647,467304,68.0,444092,64.6,23212,5.0
15072,August 2000,Nebraska,1284599,945312,73.6,918383,71.5,26929,2.8
15073,August 2000,Nevada,1528991,1073640,70.2,1028289,67.3,45351,4.2
15074,August 2000,New Hampshire,951558,689098,72.4,670800,70.5,18298,2.7
15075,August 2000,New Jersey,6445735,4274539,66.3,4115282,63.8,159257,3.7
15076,August 2000,New Mexico,1342658,847239,63.1,805656,60.0,41583,4.9
15077,August 2000,New York,14553944,9113416,62.6,8699324,59.8,414092,4.5
15078,August 2000,North Carolina,6122225,4143288,67.7,3986099,65.1,157189,3.8
15079,August 2000,North Dakota,484699,342854,70.7,332675,68.6,10179,3.0
15080,August 2000,Ohio,8628086,5779731,67.0,5546475,64.3,233256,4.0
15081,August 2000,Oklahoma,2581871,1659673,64.3,1609122,62.3,50551,3.0
15082,August 2000,Oregon,2645715,1820228,68.8,1725568,65.2,94660,5.2
15083,August 2000,Pennsylvania,9486837,6105998,64.4,5850642,61.7,255356,4.2
15084,August 2000,Rhode Island,812996,543840,66.9,521248,64.1,22592,4.2
15085,August 2000,South Carolina,3031799,1991513,65.7,1917628,63.3,73885,3.7
15086,August 2000,South Dakota,561921,407867,72.6,397796,70.8,10071,2.5
15087,August 2000,Tennessee,4363746,2833678,64.9,2721455,62.4,112223,4.0
15088,August 2000,Texas,15232085,10359140,68.0,9926692,65.2,432448,4.2
15089,August 2000,Utah,1586352,1145409,72.2,1106159,69.7,39250,3.4
15090,August 2000,Vermont,474629,331950,69.9,322299,67.9,9651,2.9
15091,August 2000,Virginia,5310692,3598924,67.8,3519350,66.3,79574,2.2
15092,August 2000,Washington,4472133,3050447,68.2,2890047,64.6,160400,5.3
15093,August 2000,West Virginia,1430132,808253,56.5,764161,53.4,44092,5.5
15094,August 2000,Wisconsin,4090566,2973678,72.7,2864106,70.0,109572,3.7
15095,August 2000,Wyoming,372824,267361,71.7,256894,68.9,10467,3.9
15096,September 2000,Alabama,3382833,2127432,62.9,2030794,60.0,96638,4.5
15097,September 2000,Alaska,436686,319625,73.2,299075,68.5,20550,6.4
15098,September 2000,Arizona,3868349,2510866,64.9,2413298,62.4,97568,3.9
15099,September 2000,Arkansas,2029809,1253620,61.8,1200825,59.2,52795,4.2
15100,September 2000,California,25198907,16927979,67.2,16101860,63.9,826119,4.9
15101,September 2000,Colorado,3280778,2359410,71.9,2294060,69.9,65350,2.8
15102,September 2000,Connecticut,2598235,1760482,67.8,1721901,66.3,38581,2.2
15103,September 2000,Delaware,598716,417246,69.7,401160,67.0,16086,3.9
15104,September 2000,District of Columbia,457979,312303,68.2,294524,64.3,17779,5.7
15105,September 2000,Florida,12531514,7887105,62.9,7594909,60.6,292196,3.7
15106,September 2000,Georgia,6121592,4226525,69.0,4078278,66.6,148247,3.5
15107,September 2000,Hawaii,900064,605219,67.2,580592,64.5,24627,4.1
15108,September 2000,Idaho,954816,662019,69.3,630347,66.0,31672,4.8
15109,September 2000,Illinois,9357007,6472215,69.2,6190685,66.2,281530,4.3
15110,September 2000,Indiana,4607960,3111328,67.5,3020438,65.5,90890,2.9
15111,September 2000,Iowa,2234909,1590758,71.2,1547057,69.2,43701,2.7
15112,September 2000,Kansas,2004079,1398459,69.8,1346797,67.2,51662,3.7
15113,September 2000,Kentucky,3091067,1962928,63.5,1880568,60.8,82360,4.2
15114,September 2000,Louisiana,3291271,2028697,61.6,1918188,58.3,110509,5.4
15115,September 2000,Maine,996165,674992,67.8,652891,65.5,22101,3.3
15116,September 2000,Maryland,4004683,2811536,70.2,2708095,67.6,103441,3.7
15117,September 2000,Massachusetts,4937430,3322691,67.3,3236314,65.5,86377,2.6
15118,September 2000,Michigan,7529670,5153830,68.4,4953944,65.8,199886,3.9
15119,September 2000,Minnesota,3740906,2823635,75.5,2730936,73.0,92699,3.3
15120,September 2000,Mississippi,2098577,1315831,62.7,1246779,59.4,69052,5.2
15121,September 2000,Missouri,4242677,2967517,69.9,2854570,67.3,112947,3.8
15122,September 2000,Montana,688280,466889,67.8,443871,64.5,23018,4.9
15123,September 2000,Nebraska,1285348,945539,73.6,918444,71.5,27095,2.9
15124,September 2000,Nevada,1534032,1078406,70.3,1031830,67.3,46576,4.3
15125,September 2000,New Hampshire,952999,689971,72.4,671807,70.5,18164,2.6
15126,September 2000,New Jersey,6450861,4274273,66.3,4112798,63.8,161475,3.8
15127,September 2000,New Mexico,1343758,848903,63.2,807164,60.1,41739,4.9
15128,September 2000,New York,14564575,9116092,62.6,8706475,59.8,409617,4.5
15129,September 2000,North Carolina,6130839,4148062,67.7,3987286,65.0,160776,3.9
15130,September 2000,North Dakota,484737,343158,70.8,332952,68.7,10206,3.0
15131,September 2000,Ohio,8633000,5780759,67.0,5550794,64.3,229965,4.0
15132,September 2000,Oklahoma,2583304,1660124,64.3,1610430,62.3,49694,3.0
15133,September 2000,Oregon,2649251,1819174,68.7,1724976,65.1,94198,5.2
15134,September 2000,Pennsylvania,9490931,6112288,64.4,5854615,61.7,257673,4.2
15135,September 2000,Rhode Island,813748,543806,66.8,521280,64.1,22526,4.1
15136,September 2000,South Carolina,3035343,1990790,65.6,1917596,63.2,73194,3.7
15137,September 2000,South Dakota,562429,407909,72.5,397714,70.7,10195,2.5
15138,September 2000,Tennessee,4367858,2834362,64.9,2722661,62.3,111701,3.9
15139,September 2000,Texas,15259194,10371939,68.0,9943956,65.2,427983,4.1
15140,September 2000,Utah,1589727,1148144,72.2,1107901,69.7,40243,3.5
15141,September 2000,Vermont,475082,332411,70.0,322671,67.9,9740,2.9
15142,September 2000,Virginia,5317939,3606796,67.8,3528934,66.4,77862,2.2
15143,September 2000,Washington,4478629,3047655,68.0,2886321,64.4,161334,5.3
15144,September 2000,West Virginia,1429981,808785,56.6,764537,53.5,44248,5.5
15145,September 2000,Wisconsin,4094607,2976359,72.7,2866632,70.0,109727,3.7
15146,September 2000,Wyoming,373051,267730,71.8,257213,68.9,10517,3.9
15147,October 2000,Alabama,3384211,2126852,62.8,2030058,60.0,96794,4.6
15148,October 2000,Alaska,437393,319530,73.1,298955,68.3,20575,6.4
15149,October 2000,Arizona,3877696,2518133,64.9,2420741,62.4,97392,3.9
15150,October 2000,Arkansas,2031078,1252246,61.7,1198914,59.0,53332,4.3
15151,October 2000,California,25237042,16959864,67.2,16145401,64.0,814463,4.8
15152,October 2000,Colorado,3288185,2362477,71.8,2297454,69.9,65023,2.8
15153,October 2000,Connecticut,2599904,1760120,67.7,1721115,66.2,39005,2.2
15154,October 2000,Delaware,599406,418586,69.8,402330,67.1,16256,3.9
15155,October 2000,District of Columbia,458388,313572,68.4,295317,64.4,18255,5.8
15156,October 2000,Florida,12554196,7910710,63.0,7620312,60.7,290398,3.7
15157,October 2000,Georgia,6133273,4231594,69.0,4086399,66.6,145195,3.4
15158,October 2000,Hawaii,900855,605983,67.3,581669,64.6,24314,4.0
15159,October 2000,Idaho,956410,663216,69.3,631447,66.0,31769,4.8
15160,October 2000,Illinois,9363515,6472347,69.1,6187872,66.1,284475,4.4
15161,October 2000,Indiana,4610768,3112778,67.5,3022675,65.6,90103,2.9
15162,October 2000,Iowa,2235750,1593830,71.3,1549145,69.3,44685,2.8
15163,October 2000,Kansas,2005362,1396925,69.7,1344395,67.0,52530,3.8
15164,October 2000,Kentucky,3092897,1965207,63.5,1881728,60.8,83479,4.2
15165,October 2000,Louisiana,3292007,2032548,61.7,1919605,58.3,112943,5.6
15166,October 2000,Maine,997202,674135,67.6,652149,65.4,21986,3.3
15167,October 2000,Maryland,4009824,2816750,70.2,2713976,67.7,102774,3.6
15168,October 2000,Massachusetts,4941860,3328722,67.4,3240986,65.6,87736,2.6
15169,October 2000,Michigan,7535127,5157157,68.4,4954002,65.7,203155,3.9
15170,October 2000,Minnesota,3745484,2828747,75.5,2734499,73.0,94248,3.3
15171,October 2000,Mississippi,2099379,1313321,62.6,1245872,59.3,67449,5.1
15172,October 2000,Missouri,4246319,2980523,70.2,2861498,67.4,119025,4.0
15173,October 2000,Montana,688837,466574,67.7,443851,64.4,22723,4.9
15174,October 2000,Nebraska,1286070,945921,73.6,918702,71.4,27219,2.9
15175,October 2000,Nevada,1539014,1083230,70.4,1035500,67.3,47730,4.4
15176,October 2000,New Hampshire,954412,691199,72.4,673117,70.5,18082,2.6
15177,October 2000,New Jersey,6455676,4274352,66.2,4112238,63.7,162114,3.8
15178,October 2000,New Mexico,1344816,850596,63.2,808745,60.1,41851,4.9
15179,October 2000,New York,14574580,9124683,62.6,8721464,59.8,403219,4.4
15180,October 2000,North Carolina,6139174,4156817,67.7,3992069,65.0,164748,4.0
15181,October 2000,North Dakota,484741,343428,70.8,333289,68.8,10139,3.0
15182,October 2000,Ohio,8637548,5785564,67.0,5560123,64.4,225441,3.9
15183,October 2000,Oklahoma,2584571,1661165,64.3,1612330,62.4,48835,2.9
15184,October 2000,Oregon,2652736,1818581,68.6,1725040,65.0,93541,5.1
15185,October 2000,Pennsylvania,9494633,6121994,64.5,5862444,61.7,259550,4.2
15186,October 2000,Rhode Island,814463,543873,66.8,521478,64.0,22395,4.1
15187,October 2000,South Carolina,3038703,1992277,65.6,1918893,63.1,73384,3.7
15188,October 2000,South Dakota,562902,408177,72.5,397862,70.7,10315,2.5
15189,October 2000,Tennessee,4371798,2837370,64.9,2726759,62.4,110611,3.9
15190,October 2000,Texas,15285623,10390780,68.0,9967589,65.2,423191,4.1
15191,October 2000,Utah,1593001,1151019,72.3,1109801,69.7,41218,3.6
15192,October 2000,Vermont,475507,332931,70.0,323159,68.0,9772,2.9
15193,October 2000,Virginia,5324945,3618451,68.0,3541678,66.5,76773,2.1
15194,October 2000,Washington,4484987,3046555,67.9,2884431,64.3,162124,5.3
15195,October 2000,West Virginia,1429734,809711,56.6,765487,53.5,44224,5.5
15196,October 2000,Wisconsin,4098514,2981215,72.7,2871359,70.1,109856,3.7
15197,October 2000,Wyoming,373242,268053,71.8,257561,69.0,10492,3.9
15198,November 2000,Alabama,3385253,2126907,62.8,2029527,60.0,97380,4.6
15199,November 2000,Alaska,438096,319459,72.9,298939,68.2,20520,6.4
15200,November 2000,Arizona,3886639,2527291,65.0,2429202,62.5,98089,3.9
15201,November 2000,Arkansas,2032150,1251531,61.6,1197356,58.9,54175,4.3
15202,November 2000,California,25273037,16997809,67.3,16190207,64.1,807602,4.8
15203,November 2000,Colorado,3295378,2365870,71.8,2301056,69.8,64814,2.7
15204,November 2000,Connecticut,2601325,1760275,67.7,1719818,66.1,40457,2.3
15205,November 2000,Delaware,600063,419944,70.0,403561,67.3,16383,3.9
15206,November 2000,District of Columbia,458761,314217,68.5,295577,64.4,18640,5.9
15207,November 2000,Florida,12575102,7938329,63.1,7646952,60.8,291377,3.7
15208,November 2000,Georgia,6144529,4240279,69.0,4096038,66.7,144241,3.4
15209,November 2000,Hawaii,901673,607116,67.3,582944,64.7,24172,4.0
15210,November 2000,Idaho,957933,664677,69.4,632918,66.1,31759,4.8
15211,November 2000,Illinois,9369166,6476902,69.1,6186095,66.0,290807,4.5
15212,November 2000,Indiana,4613209,3118715,67.6,3026371,65.6,92344,3.0
15213,November 2000,Iowa,2236321,1597030,71.4,1551157,69.4,45873,2.9
15214,November 2000,Kansas,2006433,1396170,69.6,1342706,66.9,53464,3.8
15215,November 2000,Kentucky,3094531,1967701,63.6,1882745,60.8,84956,4.3
15216,November 2000,Louisiana,3292484,2037795,61.9,1922540,58.4,115255,5.7
15217,November 2000,Maine,998094,673671,67.5,651777,65.3,21894,3.2
15218,November 2000,Maryland,4014613,2821958,70.3,2719917,67.8,102041,3.6
15219,November 2000,Massachusetts,4945759,3337015,67.5,3246644,65.6,90371,2.7
15220,November 2000,Michigan,7539934,5163212,68.5,4954548,65.7,208664,4.0
15221,November 2000,Minnesota,3749779,2833383,75.6,2738196,73.0,95187,3.4
15222,November 2000,Mississippi,2099967,1311625,62.5,1245275,59.3,66350,5.1
15223,November 2000,Missouri,4249529,2994421,70.5,2869469,67.5,124952,4.2
15224,November 2000,Montana,689364,466423,67.7,444039,64.4,22384,4.8
15225,November 2000,Nebraska,1286643,946489,73.6,919151,71.4,27338,2.9
15226,November 2000,Nevada,1543911,1088048,70.5,1039271,67.3,48777,4.5
15227,November 2000,New Hampshire,955745,692708,72.5,674564,70.6,18144,2.6
15228,November 2000,New Jersey,6459817,4273777,66.2,4112517,63.7,161260,3.8
15229,November 2000,New Mexico,1345733,852167,63.3,810249,60.2,41918,4.9
15230,November 2000,New York,14583054,9135828,62.6,8740180,59.9,395648,4.3
15231,November 2000,North Carolina,6146939,4169397,67.8,3999274,65.1,170123,4.1
15232,November 2000,North Dakota,484715,343651,70.9,333665,68.8,9986,2.9
15233,November 2000,Ohio,8641255,5793467,67.0,5572462,64.5,221005,3.8
15234,November 2000,Oklahoma,2585631,1662931,64.3,1614470,62.4,48461,2.9
15235,November 2000,Oregon,2655969,1818641,68.5,1725324,65.0,93317,5.1
15236,November 2000,Pennsylvania,9497174,6134560,64.6,5873003,61.8,261557,4.3
15237,November 2000,Rhode Island,815074,544065,66.8,521732,64.0,22333,4.1
15238,November 2000,South Carolina,3041827,1996135,65.6,1920962,63.2,75173,3.8
15239,November 2000,South Dakota,563343,408625,72.5,398142,70.7,10483,2.6
15240,November 2000,Tennessee,4375368,2842158,65.0,2732375,62.4,109783,3.9
15241,November 2000,Texas,15310947,10413547,68.0,9993455,65.3,420092,4.0
15242,November 2000,Utah,1596218,1153832,72.3,1111570,69.6,42262,3.7
15243,November 2000,Vermont,475918,333485,70.1,323687,68.0,9798,2.9
15244,November 2000,Virginia,5331526,3632208,68.1,3554953,66.7,77255,2.1
15245,November 2000,Washington,4490922,3046676,67.8,2883197,64.2,163479,5.4
15246,November 2000,West Virginia,1429379,810955,56.7,766901,53.7,44054,5.4
15247,November 2000,Wisconsin,4102043,2988175,72.8,2877275,70.1,110900,3.7
15248,November 2000,Wyoming,373446,268322,71.9,257910,69.1,10412,3.9
15249,December 2000,Alabama,3386178,2127030,62.8,2028704,59.9,98326,4.6
15250,December 2000,Alaska,438773,319455,72.8,299058,68.2,20397,6.4
15251,December 2000,Arizona,3895390,2537351,65.1,2437634,62.6,99717,3.9
15252,December 2000,Arkansas,2033134,1251430,61.6,1196151,58.8,55279,4.4
15253,December 2000,California,25308044,17036809,67.3,16229214,64.1,807595,4.7
15254,December 2000,Colorado,3302410,2368896,71.7,2303807,69.8,65089,2.7
15255,December 2000,Connecticut,2602613,1760779,67.7,1717907,66.0,42872,2.4
15256,December 2000,Delaware,600688,421163,70.1,404793,67.4,16370,3.9
15257,December 2000,District of Columbia,459100,314060,68.4,295194,64.3,18866,6.0
15258,December 2000,Florida,12595548,7967452,63.3,7671059,60.9,296393,3.7
15259,December 2000,Georgia,6155531,4250682,69.1,4104965,66.7,145717,3.4
15260,December 2000,Hawaii,902472,608459,67.4,584172,64.7,24287,4.0
15261,December 2000,Idaho,959424,666404,69.5,634657,66.1,31747,4.8
15262,December 2000,Illinois,9374457,6484014,69.2,6183626,66.0,300388,4.6
15263,December 2000,Indiana,4615419,3127358,67.8,3030003,65.6,97355,3.1
15264,December 2000,Iowa,2236772,1599986,71.5,1552786,69.4,47200,3.0
15265,December 2000,Kansas,2007415,1395628,69.5,1341355,66.8,54273,3.9
15266,December 2000,Kentucky,3096008,1969532,63.6,1882681,60.8,86851,4.4
15267,December 2000,Louisiana,3292838,2042652,62.0,1925574,58.5,117078,5.7
15268,December 2000,Maine,998941,673584,67.4,651620,65.2,21964,3.3
15269,December 2000,Maryland,4019283,2826117,70.3,2724653,67.8,101464,3.6
15270,December 2000,Massachusetts,4949449,3346514,67.6,3252186,65.7,94328,2.8
15271,December 2000,Michigan,7544386,5169633,68.5,4952796,65.6,216837,4.2
15272,December 2000,Minnesota,3753858,2837269,75.6,2741383,73.0,95886,3.4
15273,December 2000,Mississippi,2100492,1310386,62.4,1244552,59.3,65834,5.0
15274,December 2000,Missouri,4252557,3006359,70.7,2876691,67.6,129668,4.3
15275,December 2000,Montana,689849,466461,67.6,444397,64.4,22064,4.7
15276,December 2000,Nebraska,1287185,947214,73.6,919752,71.5,27462,2.9
15277,December 2000,Nevada,1548738,1092671,70.6,1042907,67.3,49764,4.6
15278,December 2000,New Hampshire,957038,694282,72.5,675883,70.6,18399,2.7
15279,December 2000,New Jersey,6463696,4272154,66.1,4112706,63.6,159448,3.7
15280,December 2000,New Mexico,1346599,853505,63.4,811576,60.3,41929,4.9
15281,December 2000,New York,14591033,9145125,62.7,8756838,60.0,388287,4.2
15282,December 2000,North Carolina,6154456,4183822,68.0,4006512,65.1,177310,4.2
15283,December 2000,North Dakota,484664,343831,70.9,334028,68.9,9803,2.9
15284,December 2000,Ohio,8644649,5802505,67.1,5584621,64.6,217884,3.8
15285,December 2000,Oklahoma,2586577,1665092,64.4,1616398,62.5,48694,2.9
15286,December 2000,Oregon,2659061,1819199,68.4,1725189,64.9,94010,5.2
15287,December 2000,Pennsylvania,9499379,6147993,64.7,5884059,61.9,263934,4.3
15288,December 2000,Rhode Island,815630,544274,66.7,521859,64.0,22415,4.1
15289,December 2000,South Carolina,3044817,1983744,65.2,1905132,62.6,78612,4.0
15290,December 2000,South Dakota,563710,409196,72.6,398482,70.7,10714,2.6
15291,December 2000,Tennessee,4378754,2847476,65.0,2737791,62.5,109685,3.9
15292,December 2000,Texas,15335573,10437506,68.1,10016600,65.3,420906,4.0
15293,December 2000,Utah,1599387,1156309,72.3,1112923,69.6,43386,3.8
15294,December 2000,Vermont,476283,334044,70.1,324186,68.1,9858,3.0
15295,December 2000,Virginia,5337913,3645647,68.3,3565891,66.8,79756,2.2
15296,December 2000,Washington,4496757,3047336,67.8,2881489,64.1,165847,5.4
15297,December 2000,West Virginia,1428923,812160,56.8,768481,53.8,43679,5.4
15298,December 2000,Wisconsin,4105382,2996425,73.0,2883017,70.2,113408,3.8
15299,December 2000,Wyoming,373611,268534,71.9,258231,69.1,10303,3.8
15300,January 2001,Alabama,3387039,2126441,62.8,2027144,59.9,99297,4.7
15301,January 2001,Alaska,439457,319538,72.7,299280,68.1,20258,6.3
15302,January 2001,Arizona,3904061,2546950,65.2,2444878,62.6,102072,4.0
15303,January 2001,Arkansas,2034063,1251600,61.5,1195056,58.8,56544,4.5
15304,January 2001,California,25342675,17070072,67.4,16256366,64.1,813706,4.8
15305,January 2001,Colorado,3309347,2371069,71.6,2304962,69.7,66107,2.8
15306,January 2001,Connecticut,2603831,1761322,67.6,1715432,65.9,45890,2.6
15307,January 2001,Delaware,601304,422076,70.2,405925,67.5,16151,3.8
15308,January 2001,District of Columbia,459437,313235,68.2,294272,64.1,18963,6.1
15309,January 2001,Florida,12615545,7994604,63.4,7689913,61.0,304691,3.8
15310,January 2001,Georgia,6166480,4259706,69.1,4110959,66.7,148747,3.5
15311,January 2001,Hawaii,903274,609767,67.5,585116,64.8,24651,4.0
15312,January 2001,Idaho,960888,668377,69.6,636539,66.2,31838,4.8
15313,January 2001,Illinois,9379497,6490801,69.2,6179455,65.9,311346,4.8
15314,January 2001,Indiana,4617526,3135745,67.9,3031881,65.7,103864,3.3
15315,January 2001,Iowa,2237196,1602419,71.6,1553900,69.5,48519,3.0
15316,January 2001,Kansas,2008356,1394800,69.4,1339908,66.7,54892,3.9
15317,January 2001,Kentucky,3097382,1969813,63.6,1880974,60.7,88839,4.5
15318,January 2001,Louisiana,3293186,2045343,62.1,1927490,58.5,117853,5.8
15319,January 2001,Maine,999732,673783,67.4,651489,65.2,22294,3.3
15320,January 2001,Maryland,4023848,2828582,70.3,2727450,67.8,101132,3.6
15321,January 2001,Massachusetts,4952972,3355867,67.8,3256646,65.8,99221,3.0
15322,January 2001,Michigan,7548639,5173580,68.5,4946880,65.5,226700,4.4
15323,January 2001,Minnesota,3757861,2840164,75.6,2743530,73.0,96634,3.4
15324,January 2001,Mississippi,2100994,1308873,62.3,1243191,59.2,65682,5.0
15325,January 2001,Missouri,4255432,3014132,70.8,2881677,67.7,132455,4.4
15326,January 2001,Montana,690313,466668,67.6,444858,64.4,21810,4.7
15327,January 2001,Nebraska,1287664,948001,73.6,920388,71.5,27613,2.9
15328,January 2001,Nevada,1553524,1096906,70.6,1046214,67.3,50692,4.6
15329,January 2001,New Hampshire,958254,695706,72.6,676863,70.6,18843,2.7
15330,January 2001,New Jersey,6467345,4269917,66.0,4112090,63.6,157827,3.7
15331,January 2001,New Mexico,1347455,854620,63.4,812738,60.3,41882,4.9
15332,January 2001,New York,14598672,9149403,62.7,8766694,60.1,382709,4.2
15333,January 2001,North Carolina,6161819,4196828,68.1,4011080,65.1,185748,4.4
15334,January 2001,North Dakota,484574,343985,71.0,334336,69.0,9649,2.8
15335,January 2001,Ohio,8647714,5810051,67.2,5593396,64.7,216655,3.7
15336,January 2001,Oklahoma,2587395,1667244,64.4,1617773,62.5,49471,3.0
15337,January 2001,Oregon,2662042,1819942,68.4,1724172,64.8,95770,5.3
15338,January 2001,Pennsylvania,9501193,6159923,64.8,5893050,62.0,266873,4.3
15339,January 2001,Rhode Island,816184,544366,66.7,521705,63.9,22661,4.2
15340,January 2001,South Carolina,3047767,1974517,64.8,1891402,62.1,83115,4.2
15341,January 2001,South Dakota,564085,409835,72.7,398834,70.7,11001,2.7
15342,January 2001,Tennessee,4381992,2851744,65.1,2741486,62.6,110258,3.9
15343,January 2001,Texas,15360003,10459411,68.1,10032761,65.3,426650,4.1
15344,January 2001,Utah,1602535,1158246,72.3,1113703,69.5,44543,3.8
15345,January 2001,Vermont,476597,334553,70.2,324566,68.1,9987,3.0
15346,January 2001,Virginia,5344116,3656586,68.4,3572496,66.8,84090,2.3
15347,January 2001,Washington,4502401,3047623,67.7,2878365,63.9,169258,5.6
15348,January 2001,West Virginia,1428385,812949,56.9,769908,53.9,43041,5.3
15349,January 2001,Wisconsin,4108549,3004455,73.1,2887219,70.3,117236,3.9
15350,January 2001,Wyoming,373775,268719,71.9,258518,69.2,10201,3.8
15351,February 2001,Alabama,3387682,2124721,62.7,2024731,59.8,99990,4.7
15352,February 2001,Alaska,440088,319726,72.7,299559,68.1,20167,6.3
15353,February 2001,Arizona,3912564,2555131,65.3,2450316,62.6,104815,4.1
15354,February 2001,Arkansas,2034883,1251882,61.5,1193988,58.7,57894,4.6
15355,February 2001,California,25376427,17093194,67.4,16268791,64.1,824403,4.8
15356,February 2001,Colorado,3316218,2372464,71.5,2304480,69.5,67984,2.9
15357,February 2001,Connecticut,2604874,1761641,67.6,1712653,65.7,48988,2.8
15358,February 2001,Delaware,601855,422562,70.2,406840,67.6,15722,3.7
15359,February 2001,District of Columbia,459780,312045,67.9,293036,63.7,19009,6.1
15360,February 2001,Florida,12634814,8016913,63.5,7702522,61.0,314391,3.9
15361,February 2001,Georgia,6177204,4264933,69.0,4112679,66.6,152254,3.6
15362,February 2001,Hawaii,903961,610857,67.6,585663,64.8,25194,4.1
15363,February 2001,Idaho,962324,670534,69.7,638439,66.3,32095,4.8
15364,February 2001,Illinois,9384194,6494515,69.2,6173485,65.8,321030,4.9
15365,February 2001,Indiana,4619366,3141119,68.0,3030873,65.6,110246,3.5
15366,February 2001,Iowa,2237469,1604253,71.7,1554516,69.5,49737,3.1
15367,February 2001,Kansas,2009179,1393505,69.4,1338153,66.6,55352,4.0
15368,February 2001,Kentucky,3098647,1968375,63.5,1877674,60.6,90701,4.6
15369,February 2001,Louisiana,3293361,2045091,62.1,1927761,58.5,117330,5.7
15370,February 2001,Maine,1000503,674128,67.4,651205,65.1,22923,3.4
15371,February 2001,Maryland,4028165,2829454,70.2,2728234,67.7,101220,3.6
15372,February 2001,Massachusetts,4956302,3363947,67.9,3259517,65.8,104430,3.1
15373,February 2001,Michigan,7552510,5172477,68.5,4936532,65.4,235945,4.6
15374,February 2001,Minnesota,3761681,2842233,75.6,2744381,73.0,97852,3.4
15375,February 2001,Mississippi,2101429,1306547,62.2,1240893,59.0,65654,5.0
15376,February 2001,Missouri,4258133,3017174,70.9,2883711,67.7,133463,4.4
15377,February 2001,Montana,690759,466962,67.6,445328,64.5,21634,4.6
15378,February 2001,Nebraska,1288101,948799,73.7,920951,71.5,27848,2.9
15379,February 2001,Nevada,1558251,1100675,70.6,1049112,67.3,51563,4.7
15380,February 2001,New Hampshire,959514,696779,72.6,677315,70.6,19464,2.8
15381,February 2001,New Jersey,6470722,4267966,66.0,4110692,63.5,157274,3.7
15382,February 2001,New Mexico,1348249,855582,63.5,813750,60.4,41832,4.9
15383,February 2001,New York,14605671,9148011,62.6,8767790,60.0,380221,4.2
15384,February 2001,North Carolina,6168952,4205709,68.2,4011116,65.0,194593,4.6
15385,February 2001,North Dakota,484508,344071,71.0,334506,69.0,9565,2.8
15386,February 2001,Ohio,8650413,5814006,67.2,5596831,64.7,217175,3.7
15387,February 2001,Oklahoma,2588181,1669141,64.5,1618427,62.5,50714,3.0
15388,February 2001,Oregon,2664923,1820696,68.3,1722186,64.6,98510,5.4
15389,February 2001,Pennsylvania,9502499,6168610,64.9,5898122,62.1,270488,4.4
15390,February 2001,Rhode Island,816677,544294,66.6,521220,63.8,23074,4.2
15391,February 2001,South Carolina,3050568,1966697,64.5,1878723,61.6,87974,4.5
15392,February 2001,South Dakota,564472,410505,72.7,399159,70.7,11346,2.8
15393,February 2001,Tennessee,4385065,2854065,65.1,2742562,62.5,111503,3.9
15394,February 2001,Texas,15384055,10477511,68.1,10040042,65.3,437469,4.2
15395,February 2001,Utah,1605693,1159601,72.2,1113914,69.4,45687,3.9
15396,February 2001,Vermont,476959,335007,70.2,324815,68.1,10192,3.0
15397,February 2001,Virginia,5350121,3663965,68.5,3574300,66.8,89665,2.4
15398,February 2001,Washington,4507825,3046948,67.6,2873704,63.7,173244,5.7
15399,February 2001,West Virginia,1427881,813156,56.9,770957,54.0,42199,5.2
15400,February 2001,Wisconsin,4111573,3010776,73.2,2889027,70.3,121749,4.0
15401,February 2001,Wyoming,373943,268904,71.9,258760,69.2,10144,3.8
15402,March 2001,Alabama,3388360,2121781,62.6,2021544,59.7,100237,4.7
15403,March 2001,Alaska,440714,320042,72.6,299876,68.0,20166,6.3
15404,March 2001,Arizona,3920943,2561507,65.3,2453918,62.6,107589,4.2
15405,March 2001,Arkansas,2035722,1252232,61.5,1193061,58.6,59171,4.7
15406,March 2001,California,25408416,17104065,67.3,16266461,64.0,837604,4.9
15407,March 2001,Colorado,3323001,2373609,71.4,2302879,69.3,70730,3.0
15408,March 2001,Connecticut,2605932,1761533,67.6,1709866,65.6,51667,2.9
15409,March 2001,Delaware,602431,422600,70.1,407457,67.6,15143,3.6
15410,March 2001,District of Columbia,460062,310924,67.6,291853,63.4,19071,6.1
15411,March 2001,Florida,12653862,8031769,63.5,7708219,60.9,323550,4.0
15412,March 2001,Georgia,6187800,4264672,68.9,4109771,66.4,154901,3.6
15413,March 2001,Hawaii,904557,611587,67.6,585857,64.8,25730,4.2
15414,March 2001,Idaho,963750,672745,69.8,640236,66.4,32509,4.8
15415,March 2001,Illinois,9388724,6492605,69.2,6165471,65.7,327134,5.0
15416,March 2001,Indiana,4621335,3141853,68.0,3026628,65.5,115225,3.7
15417,March 2001,Iowa,2237792,1605481,71.7,1554779,69.5,50702,3.2
15418,March 2001,Kansas,2010010,1391756,69.2,1336093,66.5,55663,4.0
15419,March 2001,Kentucky,3099936,1965609,63.4,1873209,60.4,92400,4.7
15420,March 2001,Louisiana,3293479,2041778,62.0,1926262,58.5,115516,5.7
15421,March 2001,Maine,1001284,674428,67.4,650647,65.0,23781,3.5
15422,March 2001,Maryland,4032468,2829343,70.2,2727540,67.6,101803,3.6
15423,March 2001,Massachusetts,4959688,3370114,68.0,3260732,65.7,109382,3.2
15424,March 2001,Michigan,7556439,5165199,68.4,4922836,65.1,242363,4.7
15425,March 2001,Minnesota,3765569,2843436,75.5,2743893,72.9,99543,3.5
15426,March 2001,Mississippi,2101776,1303285,62.0,1237644,58.9,65641,5.0
15427,March 2001,Missouri,4260879,3015806,70.8,2882851,67.7,132955,4.4
15428,March 2001,Montana,691172,467168,67.6,445659,64.5,21509,4.6
15429,March 2001,Nebraska,1288559,949568,73.7,921394,71.5,28174,3.0
15430,March 2001,Nevada,1562928,1103948,70.6,1051497,67.3,52451,4.8
15431,March 2001,New Hampshire,960747,697409,72.6,677164,70.5,20245,2.9
15432,March 2001,New Jersey,6473995,4266725,65.9,4108734,63.5,157991,3.7
15433,March 2001,New Mexico,1348932,856320,63.5,814581,60.4,41739,4.9
15434,March 2001,New York,14612260,9141552,62.6,8760193,60.0,381359,4.2
15435,March 2001,North Carolina,6176006,4208650,68.1,4005944,64.9,202706,4.8
15436,March 2001,North Dakota,484430,343952,71.0,334401,69.0,9551,2.8
15437,March 2001,Ohio,8653257,5813427,67.2,5594567,64.7,218860,3.8
15438,March 2001,Oklahoma,2588891,1670596,64.5,1618292,62.5,52304,3.1
15439,March 2001,Oregon,2667795,1821160,68.3,1719391,64.4,101769,5.6
15440,March 2001,Pennsylvania,9504003,6173158,65.0,5898532,62.1,274626,4.4
15441,March 2001,Rhode Island,817187,544091,66.6,520488,63.7,23603,4.3
15442,March 2001,South Carolina,3053328,1959685,64.2,1867303,61.2,92382,4.7
15443,March 2001,South Dakota,564824,411194,72.8,399458,70.7,11736,2.9
15444,March 2001,Tennessee,4388151,2854268,65.0,2740888,62.5,113380,4.0
15445,March 2001,Texas,15407081,10490731,68.1,10038768,65.2,451963,4.3
15446,March 2001,Utah,1608787,1160545,72.1,1113744,69.2,46801,4.0
15447,March 2001,Vermont,477290,335433,70.3,324988,68.1,10445,3.1
15448,March 2001,Virginia,5356063,3667561,68.5,3571974,66.7,95587,2.6
15449,March 2001,Washington,4513254,3044886,67.5,2867854,63.5,177032,5.8
15450,March 2001,West Virginia,1427348,812769,56.9,771482,54.1,41287,5.1
15451,March 2001,Wisconsin,4114656,3014355,73.3,2888322,70.2,126033,4.2
15452,March 2001,Wyoming,374064,269102,71.9,258959,69.2,10143,3.8
15453,April 2001,Alabama,3389260,2117985,62.5,2017704,59.5,100281,4.7
15454,April 2001,Alaska,441403,320485,72.6,300234,68.0,20251,6.3
15455,April 2001,Arizona,3929648,2566426,65.3,2455848,62.5,110578,4.3
15456,April 2001,Arkansas,2036681,1252520,61.5,1192285,58.5,60235,4.8
15457,April 2001,California,25442952,17103944,67.2,16251524,63.9,852420,5.0
15458,April 2001,Colorado,3330031,2375054,71.3,2300762,69.1,74292,3.1
15459,April 2001,Connecticut,2607177,1760989,67.5,1707259,65.5,53730,3.1
15460,April 2001,Delaware,603034,422292,70.0,407763,67.6,14529,3.4
15461,April 2001,District of Columbia,460411,310248,67.4,291045,63.2,19203,6.2
15462,April 2001,Florida,12673851,8038229,63.4,7707425,60.8,330804,4.1
15463,April 2001,Georgia,6198801,4259280,68.7,4103096,66.2,156184,3.7
15464,April 2001,Hawaii,905292,611891,67.6,585919,64.7,25972,4.2
15465,April 2001,Idaho,965243,674888,69.9,641841,66.5,33047,4.9
15466,April 2001,Illinois,9393943,6484184,69.0,6154759,65.5,329425,5.1
15467,April 2001,Indiana,4623507,3138325,67.9,3019645,65.3,118680,3.8
15468,April 2001,Iowa,2238220,1606442,71.8,1555094,69.5,51348,3.2
15469,April 2001,Kansas,2010999,1389719,69.1,1333843,66.3,55876,4.0
15470,April 2001,Kentucky,3101406,1962099,63.3,1868079,60.2,94020,4.8
15471,April 2001,Louisiana,3293852,2036215,61.8,1923257,58.4,112958,5.5
15472,April 2001,Maine,1002123,674575,67.3,649873,64.8,24702,3.7
15473,April 2001,Maryland,4037045,2828897,70.1,2725862,67.5,103035,3.6
15474,April 2001,Massachusetts,4963354,3374246,68.0,3260409,65.7,113837,3.4
15475,April 2001,Michigan,7560859,5152596,68.1,4907151,64.9,245445,4.8
15476,April 2001,Minnesota,3769673,2843564,75.4,2742210,72.7,101354,3.6
15477,April 2001,Mississippi,2102305,1299370,61.8,1233601,58.7,65769,5.1
15478,April 2001,Missouri,4263899,3010928,70.6,2879504,67.5,131424,4.4
15479,April 2001,Montana,691662,467098,67.5,445699,64.4,21399,4.6
15480,April 2001,Nebraska,1289076,950221,73.7,921676,71.5,28545,3.0
15481,April 2001,Nevada,1567733,1106724,70.6,1053528,67.2,53196,4.8
15482,April 2001,New Hampshire,962016,697673,72.5,676480,70.3,21193,3.0
15483,April 2001,New Jersey,6477759,4266449,65.9,4106212,63.4,160237,3.8
15484,April 2001,New Mexico,1349772,856779,63.5,815215,60.4,41564,4.9
15485,April 2001,New York,14620046,9132763,62.5,8745968,59.8,386795,4.2
15486,April 2001,North Carolina,6183471,4205507,68.0,3995949,64.6,209558,5.0
15487,April 2001,North Dakota,484353,343550,70.9,333973,69.0,9577,2.8
15488,April 2001,Ohio,8656582,5809056,67.1,5587474,64.5,221582,3.8
15489,April 2001,Oklahoma,2589817,1671460,64.5,1617375,62.5,54085,3.2
15490,April 2001,Oregon,2670864,1821270,68.2,1716061,64.3,105209,5.8
15491,April 2001,Pennsylvania,9506024,6173712,64.9,5894619,62.0,279093,4.5
15492,April 2001,Rhode Island,817767,543858,66.5,519698,63.6,24160,4.4
15493,April 2001,South Carolina,3056309,1953422,63.9,1857616,60.8,95806,4.9
15494,April 2001,South Dakota,565199,411840,72.9,399706,70.7,12134,2.9
15495,April 2001,Tennessee,4391508,2852767,65.0,2736987,62.3,115780,4.1
15496,April 2001,Texas,15431594,10499251,68.0,10030823,65.0,468428,4.5
15497,April 2001,Utah,1612034,1161319,72.0,1113420,69.1,47899,4.1
15498,April 2001,Vermont,477637,335847,70.3,325149,68.1,10698,3.2
15499,April 2001,Virginia,5362396,3667975,68.4,3566723,66.5,101252,2.8
15500,April 2001,Washington,4518982,3041405,67.3,2861161,63.3,180244,5.9
15501,April 2001,West Virginia,1426891,811898,56.9,771454,54.1,40444,5.0
15502,April 2001,Wisconsin,4117964,3014927,73.2,2885563,70.1,129364,4.3
15503,April 2001,Wyoming,374225,269317,72.0,259125,69.2,10192,3.8
15504,May 2001,Alabama,3390258,2114232,62.4,2013625,59.4,100607,4.8
15505,May 2001,Alaska,442100,321019,72.6,300635,68.0,20384,6.3
15506,May 2001,Arizona,3938383,2571158,65.3,2457001,62.4,114157,4.4
15507,May 2001,Arkansas,2037739,1252804,61.5,1191734,58.5,61070,4.9
15508,May 2001,California,25477019,17100740,67.1,16230429,63.7,870311,5.1
15509,May 2001,Colorado,3337135,2377689,71.2,2299027,68.9,78662,3.3
15510,May 2001,Connecticut,2608492,1760376,67.5,1705120,65.4,55256,3.1
15511,May 2001,Delaware,603678,421843,69.9,407816,67.6,14027,3.3
15512,May 2001,District of Columbia,460745,310186,67.3,290779,63.1,19407,6.3
15513,May 2001,Florida,12694136,8040603,63.3,7703868,60.7,336735,4.2
15514,May 2001,Georgia,6209942,4252167,68.5,4094953,65.9,157214,3.7
15515,May 2001,Hawaii,905953,611794,67.5,585884,64.7,25910,4.2
15516,May 2001,Idaho,966791,676904,70.0,643259,66.5,33645,5.0
15517,May 2001,Illinois,9399314,6472068,68.9,6142287,65.3,329781,5.1
15518,May 2001,Indiana,4625967,3133405,67.7,3011731,65.1,121674,3.9
15519,May 2001,Iowa,2238858,1607674,71.8,1555933,69.5,51741,3.2
15520,May 2001,Kansas,2012049,1387887,69.0,1331789,66.2,56098,4.0
15521,May 2001,Kentucky,3103053,1958708,63.1,1862931,60.0,95777,4.9
15522,May 2001,Louisiana,3294280,2030267,61.6,1919571,58.3,110696,5.5
15523,May 2001,Maine,1003074,674676,67.3,649115,64.7,25561,3.8
15524,May 2001,Maryland,4041659,2828978,70.0,2723705,67.4,105273,3.7
15525,May 2001,Massachusetts,4967224,3377108,68.0,3259205,65.6,117903,3.5
15526,May 2001,Michigan,7565542,5137609,67.9,4890853,64.6,246756,4.8
15527,May 2001,Minnesota,3774037,2842942,75.3,2739983,72.6,102959,3.6
15528,May 2001,Mississippi,2102875,1295449,61.6,1229188,58.5,66261,5.1
15529,May 2001,Missouri,4267104,3004613,70.4,2874741,67.4,129872,4.3
15530,May 2001,Montana,692184,466725,67.4,445440,64.4,21285,4.6
15531,May 2001,Nebraska,1289688,950704,73.7,921774,71.5,28930,3.0
15532,May 2001,Nevada,1572539,1109176,70.5,1055309,67.1,53867,4.9
15533,May 2001,New Hampshire,963368,697727,72.4,675440,70.1,22287,3.2
15534,May 2001,New Jersey,6481579,4268732,65.9,4104333,63.3,164399,3.9
15535,May 2001,New Mexico,1350584,857059,63.5,815687,60.4,41372,4.8
15536,May 2001,New York,14627920,9126617,62.4,8729233,59.7,397384,4.4
15537,May 2001,North Carolina,6191086,4199252,67.8,3983496,64.3,215756,5.1
15538,May 2001,North Dakota,484353,342931,70.8,333285,68.8,9646,2.8
15539,May 2001,Ohio,8660283,5804287,67.0,5578201,64.4,226086,3.9
15540,May 2001,Oklahoma,2590836,1672065,64.5,1616011,62.4,56054,3.4
15541,May 2001,Oregon,2674062,1821401,68.1,1712690,64.0,108711,6.0
15542,May 2001,Pennsylvania,9508525,6172512,64.9,5888438,61.9,284074,4.6
15543,May 2001,Rhode Island,818383,543674,66.4,519016,63.4,24658,4.5
15544,May 2001,South Carolina,3059343,1948506,63.7,1850022,60.5,98484,5.1
15545,May 2001,South Dakota,565629,412392,72.9,399869,70.7,12523,3.0
15546,May 2001,Tennessee,4395078,2851324,64.9,2732505,62.2,118819,4.2
15547,May 2001,Texas,15456099,10506482,68.0,10020588,64.8,485894,4.6
15548,May 2001,Utah,1615352,1162154,71.9,1113154,68.9,49000,4.2
15549,May 2001,Vermont,478054,336265,70.3,325358,68.1,10907,3.2
15550,May 2001,Virginia,5368787,3667259,68.3,3560434,66.3,106825,2.9
15551,May 2001,Washington,4524913,3037415,67.1,2854433,63.1,182982,6.0
15552,May 2001,West Virginia,1426529,810765,56.8,771005,54.0,39760,4.9
15553,May 2001,Wisconsin,4121525,3013694,73.1,2881993,69.9,131701,4.4
15554,May 2001,Wyoming,374421,269527,72.0,259254,69.2,10273,3.8
15555,June 2001,Alabama,3391415,2111291,62.3,2009510,59.3,101781,4.8
15556,June 2001,Alaska,442790,321563,72.6,301032,68.0,20531,6.4
15557,June 2001,Arizona,3947379,2576725,65.3,2458198,62.3,118527,4.6
15558,June 2001,Arkansas,2038912,1253045,61.5,1191351,58.4,61694,4.9
15559,June 2001,California,25512789,17101431,67.0,16208473,63.5,892958,5.2
15560,June 2001,Colorado,3344448,2382031,71.2,2298113,68.7,83918,3.5
15561,June 2001,Connecticut,2609938,1759895,67.4,1703569,65.3,56326,3.2
15562,June 2001,Delaware,604340,421469,69.7,407720,67.5,13749,3.3
15563,June 2001,District of Columbia,461078,310587,67.4,290915,63.1,19672,6.3
15564,June 2001,Florida,12715218,8043285,63.3,7700031,60.6,343254,4.3
15565,June 2001,Georgia,6221345,4247170,68.3,4087435,65.7,159735,3.8
15566,June 2001,Hawaii,906693,611453,67.4,585572,64.6,25881,4.2
15567,June 2001,Idaho,968401,678710,70.1,644477,66.6,34233,5.0
15568,June 2001,Illinois,9405189,6459193,68.7,6128517,65.2,330676,5.1
15569,June 2001,Indiana,4628628,3130095,67.6,3004675,64.9,125420,4.0
15570,June 2001,Iowa,2239580,1609469,71.9,1557382,69.5,52087,3.2
15571,June 2001,Kansas,2013249,1386756,68.9,1330231,66.1,56525,4.1
15572,June 2001,Kentucky,3104831,1956033,63.0,1858118,59.8,97915,5.0
15573,June 2001,Louisiana,3294875,2025352,61.5,1915693,58.1,109659,5.4
15574,June 2001,Maine,1004055,674794,67.2,648540,64.6,26254,3.9
15575,June 2001,Maryland,4046455,2830529,70.0,2721806,67.3,108723,3.8
15576,June 2001,Massachusetts,4971387,3379462,68.0,3257530,65.5,121932,3.6
15577,June 2001,Michigan,7570642,5122886,67.7,4873656,64.4,249230,4.9
15578,June 2001,Minnesota,3778582,2842222,75.2,2737922,72.5,104300,3.7
15579,June 2001,Mississippi,2103548,1291947,61.4,1224656,58.2,67291,5.2
15580,June 2001,Missouri,4270528,2998970,70.2,2869192,67.2,129778,4.3
15581,June 2001,Montana,692756,466176,67.3,445025,64.2,21151,4.5
15582,June 2001,Nebraska,1290397,950997,73.7,921707,71.4,29290,3.1
15583,June 2001,Nevada,1577431,1111494,70.5,1056665,67.0,54829,4.9
15584,June 2001,New Hampshire,964752,697729,72.3,674265,69.9,23464,3.4
15585,June 2001,New Jersey,6485824,4274391,65.9,4103949,63.3,170442,4.0
15586,June 2001,New Mexico,1351501,857267,63.4,816006,60.4,41261,4.8
15587,June 2001,New York,14636641,9125876,62.3,8712890,59.5,412986,4.5
15588,June 2001,North Carolina,6199031,4193253,67.6,3970940,64.1,222313,5.3
15589,June 2001,North Dakota,484331,342173,70.6,332443,68.6,9730,2.8
15590,June 2001,Ohio,8664455,5802267,67.0,5569147,64.3,233120,4.0
15591,June 2001,Oklahoma,2591986,1672846,64.5,1614524,62.3,58322,3.5
15592,June 2001,Oregon,2677372,1821711,68.0,1709409,63.8,112302,6.2
15593,June 2001,Pennsylvania,9511507,6171934,64.9,5882167,61.8,289767,4.7
15594,June 2001,Rhode Island,819032,543559,66.4,518509,63.3,25050,4.6
15595,June 2001,South Carolina,3062531,1945191,63.5,1844269,60.2,100922,5.2
15596,June 2001,South Dakota,566141,412830,72.9,399978,70.6,12852,3.1
15597,June 2001,Tennessee,4398768,2851208,64.8,2728637,62.0,122571,4.3
15598,June 2001,Texas,15481630,10514918,67.9,10010984,64.7,503934,4.8
15599,June 2001,Utah,1618754,1163088,71.9,1113018,68.8,50070,4.3
15600,June 2001,Vermont,478500,336734,70.4,325660,68.1,11074,3.3
15601,June 2001,Virginia,5375521,3667065,68.2,3554152,66.1,112913,3.1
15602,June 2001,Washington,4531055,3033719,67.0,2848078,62.9,185641,6.1
15603,June 2001,West Virginia,1426251,809578,56.8,770297,54.0,39281,4.9
15604,June 2001,Wisconsin,4125319,3012018,73.0,2878448,69.8,133570,4.4
15605,June 2001,Wyoming,374643,269685,72.0,259339,69.2,10346,3.8
15606,July 2001,Alabama,3392436,2109963,62.2,2005520,59.1,104443,4.9
15607,July 2001,Alaska,443480,322013,72.6,301345,68.0,20668,6.4
15608,July 2001,Arizona,3956253,2583941,65.3,2460229,62.2,123712,4.8
15609,July 2001,Arkansas,2040000,1253331,61.4,1191086,58.4,62245,5.0
15610,July 2001,California,25547539,17110734,67.0,16189295,63.4,921439,5.4
15611,July 2001,Colorado,3351629,2388265,71.3,2298151,68.6,90114,3.8
15612,July 2001,Connecticut,2611305,1759599,67.4,1702571,65.2,57028,3.2
15613,July 2001,Delaware,604959,421290,69.6,407563,67.4,13727,3.3
15614,July 2001,District of Columbia,461416,311015,67.4,291073,63.1,19942,6.4
15615,July 2001,Florida,12735879,8049913,63.2,7697332,60.4,352581,4.4
15616,July 2001,Georgia,6232538,4247141,68.1,4082040,65.5,165101,3.9
15617,July 2001,Hawaii,907380,611068,67.3,584822,64.5,26246,4.3
15618,July 2001,Idaho,969962,680187,70.1,645462,66.5,34725,5.1
15619,July 2001,Illinois,9410722,6448283,68.5,6114115,65.0,334168,5.2
15620,July 2001,Indiana,4631127,3130456,67.6,2999665,64.8,130791,4.2
15621,July 2001,Iowa,2240220,1611962,72.0,1559258,69.6,52704,3.3
15622,July 2001,Kansas,2014364,1386634,68.8,1329310,66.0,57324,4.1
15623,July 2001,Kentucky,3106501,1954436,62.9,1853776,59.7,100660,5.2
15624,July 2001,Louisiana,3295346,2022420,61.4,1911962,58.0,110458,5.5
15625,July 2001,Maine,1004970,674849,67.2,648125,64.5,26724,4.0
15626,July 2001,Maryland,4051099,2833819,70.0,2720682,67.2,113137,4.0
15627,July 2001,Massachusetts,4975374,3382215,68.0,3255845,65.4,126370,3.7
15628,July 2001,Michigan,7575452,5110090,67.5,4854674,64.1,255416,5.0
15629,July 2001,Minnesota,3782985,2842199,75.1,2736380,72.3,105819,3.7
15630,July 2001,Mississippi,2104112,1289267,61.3,1220195,58.0,69072,5.4
15631,July 2001,Missouri,4273800,2995352,70.1,2863258,67.0,132094,4.4
15632,July 2001,Montana,693281,465615,67.2,444604,64.1,21011,4.5
15633,July 2001,Nebraska,1291022,951246,73.7,921582,71.4,29664,3.1
15634,July 2001,Nevada,1582281,1113871,70.4,1057493,66.8,56378,5.1
15635,July 2001,New Hampshire,966097,697774,72.2,673131,69.7,24643,3.5
15636,July 2001,New Jersey,6489852,4282973,66.0,4104800,63.2,178173,4.2
15637,July 2001,New Mexico,1352426,857531,63.4,816171,60.3,41360,4.8
15638,July 2001,New York,14644737,9132095,62.4,8699049,59.4,433046,4.7
15639,July 2001,North Carolina,6206740,4190276,67.5,3959892,63.8,230384,5.5
15640,July 2001,North Dakota,484331,341370,70.5,331558,68.5,9812,2.9
15641,July 2001,Ohio,8668225,5804800,67.0,5561919,64.2,242881,4.2
15642,July 2001,Oklahoma,2593022,1674406,64.6,1613325,62.2,61081,3.6
15643,July 2001,Oregon,2680623,1822500,68.0,1706103,63.6,116397,6.4
15644,July 2001,Pennsylvania,9514118,6173483,64.9,5877275,61.8,296208,4.8
15645,July 2001,Rhode Island,819634,543505,66.3,518169,63.2,25336,4.7
15646,July 2001,South Carolina,3065575,1943435,63.4,1839899,60.0,103536,5.3
15647,July 2001,South Dakota,566558,413211,72.9,400105,70.6,13106,3.2
15648,July 2001,Tennessee,4402350,2853451,64.8,2726174,61.9,127277,4.5
15649,July 2001,Texas,15506619,10527073,67.9,10003746,64.5,523327,5.0
15650,July 2001,Utah,1622108,1164046,71.8,1112834,68.6,51212,4.4
15651,July 2001,Vermont,478876,337253,70.4,326020,68.1,11233,3.3
15652,July 2001,Virginia,5381987,3668296,68.2,3548360,65.9,119936,3.3
15653,July 2001,Washington,4537005,3031389,66.8,2842413,62.6,188976,6.2
15654,July 2001,West Virginia,1425904,808466,56.7,769486,54.0,38980,4.8
15655,July 2001,Wisconsin,4128936,3010945,72.9,2875312,69.6,135633,4.5
15656,July 2001,Wyoming,374826,269767,72.0,259389,69.2,10378,3.8
15657,August 2001,Alabama,3393842,2109935,62.2,2001306,59.0,108629,5.1
15658,August 2001,Alaska,444285,322282,72.5,301499,67.9,20783,6.4
15659,August 2001,Arizona,3966230,2592392,65.4,2462929,62.1,129463,5.0
15660,August 2001,Arkansas,2041352,1253601,61.4,1190602,58.3,62999,5.0
15661,August 2001,California,25579419,17126405,67.0,16170299,63.2,956106,5.6
15662,August 2001,Colorado,3356755,2395575,71.4,2298315,68.5,97260,4.1
15663,August 2001,Connecticut,2613460,1759137,67.3,1701741,65.1,57396,3.3
15664,August 2001,Delaware,605731,421274,69.5,407354,67.2,13920,3.3
15665,August 2001,District of Columbia,461490,311110,67.4,290959,63.0,20151,6.5
15666,August 2001,Florida,12760563,8059278,63.2,7693587,60.3,365691,4.5
15667,August 2001,Georgia,6243529,4251371,68.1,4077950,65.3,173421,4.1
15668,August 2001,Hawaii,908102,610738,67.3,583582,64.3,27156,4.4
15669,August 2001,Idaho,971636,681270,70.1,646109,66.5,35161,5.2
15670,August 2001,Illinois,9416565,6439518,68.4,6097509,64.8,342009,5.3
15671,August 2001,Indiana,4633815,3134052,67.6,2996062,64.7,137990,4.4
15672,August 2001,Iowa,2241032,1614907,72.1,1561056,69.7,53851,3.3
15673,August 2001,Kansas,2015802,1387423,68.8,1328827,65.9,58596,4.2
15674,August 2001,Kentucky,3108740,1953685,62.8,1849532,59.5,104153,5.3
15675,August 2001,Louisiana,3296898,2020894,61.3,1907729,57.9,113165,5.6
15676,August 2001,Maine,1006027,674788,67.1,647728,64.4,27060,4.0
15677,August 2001,Maryland,4056512,2838385,70.0,2720246,67.1,118139,4.2
15678,August 2001,Massachusetts,4978736,3385355,68.0,3253796,65.4,131559,3.9
15679,August 2001,Michigan,7580334,5098903,67.3,4832582,63.8,266321,5.2
15680,August 2001,Minnesota,3786891,2843346,75.1,2735179,72.2,108167,3.8
15681,August 2001,Mississippi,2105002,1287527,61.2,1215702,57.8,71825,5.6
15682,August 2001,Missouri,4277491,2992959,70.0,2856413,66.8,136546,4.6
15683,August 2001,Montana,693935,465176,67.0,444287,64.0,20889,4.5
15684,August 2001,Nebraska,1291856,951491,73.7,921354,71.3,30137,3.2
15685,August 2001,Nevada,1587031,1116280,70.3,1057616,66.6,58664,5.3
15686,August 2001,New Hampshire,967467,697863,72.1,672113,69.5,25750,3.7
15687,August 2001,New Jersey,6494803,4292974,66.1,4105420,63.2,187554,4.4
15688,August 2001,New Mexico,1354374,857960,63.3,816241,60.3,41719,4.9
15689,August 2001,New York,14654382,9142544,62.4,8685756,59.3,456788,5.0
15690,August 2001,North Carolina,6214390,4189891,67.4,3949320,63.6,240571,5.7
15691,August 2001,North Dakota,484414,340630,70.3,330688,68.3,9942,2.9
15692,August 2001,Ohio,8672828,5810789,67.0,5555372,64.1,255417,4.4
15693,August 2001,Oklahoma,2594977,1676764,64.6,1612316,62.1,64448,3.8
15694,August 2001,Oregon,2684522,1823859,67.9,1702353,63.4,121506,6.7
15695,August 2001,Pennsylvania,9519305,6176904,64.9,5873165,61.7,303739,4.9
15696,August 2001,Rhode Island,820473,543522,66.2,517963,63.1,25559,4.7
15697,August 2001,South Carolina,3068806,1942580,63.3,1836132,59.8,106448,5.5
15698,August 2001,South Dakota,567022,413574,72.9,400243,70.6,13331,3.2
15699,August 2001,Tennessee,4406467,2857847,64.9,2724332,61.8,133515,4.7
15700,August 2001,Texas,15532102,10542194,67.9,9996904,64.4,545290,5.2
15701,August 2001,Utah,1625142,1164967,71.7,1112371,68.4,52596,4.5
15702,August 2001,Vermont,479322,337760,70.5,326344,68.1,11416,3.4
15703,August 2001,Virginia,5388977,3669981,68.1,3542141,65.7,127840,3.5
15704,August 2001,Washington,4543227,3030824,66.7,2836916,62.4,193908,6.4
15705,August 2001,West Virginia,1426270,807446,56.6,768496,53.9,38950,4.8
15706,August 2001,Wisconsin,4133051,3010496,72.8,2871889,69.5,138607,4.6
15707,August 2001,Wyoming,375274,269750,71.9,259382,69.1,10368,3.8
15708,September 2001,Alabama,3395327,2110339,62.2,1996677,58.8,113662,5.4
15709,September 2001,Alaska,445086,322405,72.4,301515,67.7,20890,6.5
15710,September 2001,Arizona,3976343,2601571,65.4,2466146,62.0,135425,5.2
15711,September 2001,Arkansas,2042763,1253762,61.4,1189727,58.2,64035,5.1
15712,September 2001,California,25612457,17145088,66.9,16150410,63.1,994678,5.8
15713,September 2001,Colorado,3362033,2403007,71.5,2298010,68.4,104997,4.4
15714,September 2001,Connecticut,2615702,1758418,67.2,1700916,65.0,57502,3.3
15715,September 2001,Delaware,606500,421330,69.5,407067,67.1,14263,3.4
15716,September 2001,District of Columbia,461617,310790,67.3,290516,62.9,20274,6.5
15717,September 2001,Florida,12785780,8069917,63.1,7688500,60.1,381417,4.7
15718,September 2001,Georgia,6254668,4257923,68.1,4074348,65.1,183575,4.3
15719,September 2001,Hawaii,908840,610436,67.2,581940,64.0,28496,4.7
15720,September 2001,Idaho,973376,682002,70.1,646321,66.4,35681,5.2
15721,September 2001,Illinois,9422769,6432465,68.3,6078229,64.5,354236,5.5
15722,September 2001,Indiana,4636658,3139525,67.7,2993175,64.6,146350,4.7
15723,September 2001,Iowa,2241912,1618068,72.2,1562526,69.7,55542,3.4
15724,September 2001,Kansas,2017324,1388916,68.8,1328625,65.9,60291,4.3
15725,September 2001,Kentucky,3111061,1953373,62.8,1845338,59.3,108035,5.5
15726,September 2001,Louisiana,3298599,2019760,61.2,1902657,57.7,117103,5.8
15727,September 2001,Maine,1007135,674535,67.0,647231,64.3,27304,4.0
15728,September 2001,Maryland,4062032,2843778,70.0,2720608,67.0,123170,4.3
15729,September 2001,Massachusetts,4982192,3388852,68.0,3251382,65.3,137470,4.1
15730,September 2001,Michigan,7585464,5088626,67.1,4808346,63.4,280280,5.5
15731,September 2001,Minnesota,3790917,2845757,75.1,2734088,72.1,111669,3.9
15732,September 2001,Mississippi,2105990,1286658,61.1,1211298,57.5,75360,5.9
15733,September 2001,Missouri,4281344,2991029,69.9,2848999,66.5,142030,4.7
15734,September 2001,Montana,694619,464902,66.9,444124,63.9,20778,4.5
15735,September 2001,Nebraska,1292727,951671,73.6,920921,71.2,30750,3.2
15736,September 2001,Nevada,1591816,1118458,70.3,1056969,66.4,61489,5.5
15737,September 2001,New Hampshire,968822,697980,72.0,671202,69.3,26778,3.8
15738,September 2001,New Jersey,6499980,4303564,66.2,4105422,63.2,198142,4.6
15739,September 2001,New Mexico,1356389,858658,63.3,816349,60.2,42309,4.9
15740,September 2001,New York,14664496,9154926,62.4,8672427,59.1,482499,5.3
15741,September 2001,North Carolina,6222312,4190644,67.3,3938423,63.3,252221,6.0
15742,September 2001,North Dakota,484522,340068,70.2,329903,68.1,10165,3.0
15743,September 2001,Ohio,8677675,5818594,67.1,5548471,63.9,270123,4.6
15744,September 2001,Oklahoma,2596992,1679559,64.7,1611485,62.1,68074,4.1
15745,September 2001,Oregon,2688495,1825725,67.9,1698122,63.2,127603,7.0
15746,September 2001,Pennsylvania,9524726,6181732,64.9,5869415,61.6,312317,5.1
15747,September 2001,Rhode Island,821326,543631,66.2,517872,63.1,25759,4.7
15748,September 2001,South Carolina,3072157,1941785,63.2,1832479,59.6,109306,5.6
15749,September 2001,South Dakota,567478,413891,72.9,400357,70.6,13534,3.3
15750,September 2001,Tennessee,4410746,2864052,64.9,2722726,61.7,141326,4.9
15751,September 2001,Texas,15558281,10559372,67.9,9989990,64.2,569382,5.4
15752,September 2001,Utah,1628218,1166276,71.6,1111943,68.3,54333,4.7
15753,September 2001,Vermont,479777,338225,70.5,326587,68.1,11638,3.4
15754,September 2001,Virginia,5396149,3672084,68.1,3535982,65.5,136102,3.7
15755,September 2001,Washington,4549549,3032187,66.6,2831745,62.2,200442,6.6
15756,September 2001,West Virginia,1426700,806587,56.5,767266,53.8,39321,4.9
15757,September 2001,Wisconsin,4137216,3010466,72.8,2867611,69.3,142855,4.7
15758,September 2001,Wyoming,375705,269616,71.8,259295,69.0,10321,3.8
15759,October 2001,Alabama,3396655,2110607,62.1,1991811,58.6,118796,5.6
15760,October 2001,Alaska,445888,322501,72.3,301462,67.6,21039,6.5
15761,October 2001,Arizona,3986221,2611118,65.5,2469958,62.0,141160,5.4
15762,October 2001,Arkansas,2044106,1254026,61.3,1188736,58.2,65290,5.2
15763,October 2001,California,25644032,17164421,66.9,16131509,62.9,1032912,6.0
15764,October 2001,Colorado,3367175,2410087,71.6,2297403,68.2,112684,4.7
15765,October 2001,Connecticut,2617761,1757599,67.1,1700123,64.9,57476,3.3
15766,October 2001,Delaware,607285,421357,69.4,406660,67.0,14697,3.5
15767,October 2001,District of Columbia,461697,310133,67.2,289817,62.8,20316,6.6
15768,October 2001,Florida,12809888,8040672,62.8,7576046,59.1,464626,5.8
15769,October 2001,Georgia,6265646,4265381,68.1,4071307,65.0,194074,4.5
15770,October 2001,Hawaii,909486,610015,67.1,580075,63.8,29940,4.9
15771,October 2001,Idaho,975049,682403,70.0,646063,66.3,36340,5.3
15772,October 2001,Illinois,9428484,6426471,68.2,6057789,64.2,368682,5.7
15773,October 2001,Indiana,4639299,3145459,67.8,2990765,64.5,154694,4.9
15774,October 2001,Iowa,2242738,1621260,72.3,1563710,69.7,57550,3.5
15775,October 2001,Kansas,2018770,1390890,68.9,1328615,65.8,62275,4.5
15776,October 2001,Kentucky,3113301,1953155,62.7,1841556,59.2,111599,5.7
15777,October 2001,Louisiana,3300144,2018081,61.2,1896959,57.5,121122,6.0
15778,October 2001,Maine,1008157,674081,66.9,646608,64.1,27473,4.1
15779,October 2001,Maryland,4067332,2849473,70.1,2722035,66.9,127438,4.5
15780,October 2001,Massachusetts,4985426,3392777,68.1,3249044,65.2,143733,4.2
15781,October 2001,Michigan,7590159,5078861,66.9,4783896,63.0,294965,5.8
15782,October 2001,Minnesota,3794796,2849013,75.1,2732967,72.0,116046,4.1
15783,October 2001,Mississippi,2106910,1286375,61.1,1207342,57.3,79033,6.1
15784,October 2001,Missouri,4284972,2989611,69.8,2842120,66.3,147491,4.9
15785,October 2001,Montana,695276,464847,66.9,444149,63.9,20698,4.5
15786,October 2001,Nebraska,1293543,951777,73.6,920293,71.1,31484,3.3
15787,October 2001,Nevada,1596483,1120266,70.2,1055873,66.1,64393,5.7
15788,October 2001,New Hampshire,970145,698171,72.0,670441,69.1,27730,4.0
15789,October 2001,New Jersey,6504669,4314491,66.3,4105114,63.1,209377,4.9
15790,October 2001,New Mexico,1358259,859710,63.3,816639,60.1,43071,5.0
15791,October 2001,New York,14673722,9168482,62.5,8660555,59.0,507927,5.5
15792,October 2001,North Carolina,6229831,4191631,67.3,3927940,63.1,263691,6.3
15793,October 2001,North Dakota,484603,339744,70.1,329262,67.9,10482,3.1
15794,October 2001,Ohio,8682072,5827156,67.1,5541503,63.8,285653,4.9
15795,October 2001,Oklahoma,2598867,1682293,64.7,1611040,62.0,71253,4.2
15796,October 2001,Oregon,2692299,1827828,67.9,1693870,62.9,133958,7.3
15797,October 2001,Pennsylvania,9529554,6187574,64.9,5866333,61.6,321241,5.2
15798,October 2001,Rhode Island,822183,543834,66.1,517909,63.0,25925,4.8
15799,October 2001,South Carolina,3075310,1940357,63.1,1828774,59.5,111583,5.8
15800,October 2001,South Dakota,567929,414163,72.9,400453,70.5,13710,3.3
15801,October 2001,Tennessee,4414767,2871767,65.0,2721751,61.7,150016,5.2
15802,October 2001,Texas,15583700,10578152,67.9,9984676,64.1,593476,5.6
15803,October 2001,Utah,1631320,1168260,71.6,1111871,68.2,56389,4.8
15804,October 2001,Vermont,480215,338681,70.5,326777,68.0,11904,3.5
15805,October 2001,Virginia,5403027,3674919,68.0,3531248,65.4,143671,3.9
15806,October 2001,Washington,4555657,3035360,66.6,2827672,62.1,207688,6.8
15807,October 2001,West Virginia,1427049,805911,56.5,765788,53.7,40123,5.0
15808,October 2001,Wisconsin,4141269,3010752,72.7,2862715,69.1,148037,4.9
15809,October 2001,Wyoming,376150,269399,71.6,259138,68.9,10261,3.8
15810,November 2001,Alabama,3397377,2110105,62.1,1986957,58.5,123148,5.8
15811,November 2001,Alaska,446603,322692,72.3,301413,67.5,21279,6.6
15812,November 2001,Arizona,3995539,2620418,65.6,2474170,61.9,146248,5.6
15813,November 2001,Arkansas,2045037,1254704,61.4,1187995,58.1,66709,5.3
15814,November 2001,California,25672349,17181235,66.9,16114443,62.8,1066792,6.2
15815,November 2001,Colorado,3371794,2416394,71.7,2296659,68.1,119735,5.0
15816,November 2001,Connecticut,2619402,1756865,67.1,1699318,64.9,57547,3.3
15817,November 2001,Delaware,607953,421285,69.3,406090,66.8,15195,3.6
15818,November 2001,District of Columbia,461695,309356,67.0,289052,62.6,20304,6.6
15819,November 2001,Florida,12831933,8049668,62.7,7572928,59.0,476740,5.9
15820,November 2001,Georgia,6275466,4272215,68.1,4068904,64.8,203311,4.8
15821,November 2001,Hawaii,910197,609224,66.9,578199,63.5,31025,5.1
15822,November 2001,Idaho,976561,682547,69.9,645416,66.1,37131,5.4
15823,November 2001,Illinois,9432664,6419973,68.1,6037149,64.0,382824,6.0
15824,November 2001,Indiana,4641180,3150115,67.9,2988362,64.4,161753,5.1
15825,November 2001,Iowa,2243111,1624334,72.4,1564718,69.8,59616,3.7
15826,November 2001,Kansas,2019873,1393148,69.0,1328740,65.8,64408,4.6
15827,November 2001,Kentucky,3115007,1952403,62.7,1838430,59.0,113973,5.8
15828,November 2001,Louisiana,3301094,2015002,61.0,1890954,57.3,124048,6.2
15829,November 2001,Maine,1009049,673480,66.7,645873,64.0,27607,4.1
15830,November 2001,Maryland,4071927,2854957,70.1,2724486,66.9,130471,4.6
15831,November 2001,Massachusetts,4987817,3397030,68.1,3247021,65.1,150009,4.4
15832,November 2001,Michigan,7593576,5068791,66.8,4761014,62.7,307777,6.1
15833,November 2001,Minnesota,3798068,2852581,75.1,2731699,71.9,120882,4.2
15834,November 2001,Mississippi,2107407,1286282,61.0,1204012,57.1,82270,6.4
15835,November 2001,Missouri,4287890,2988835,69.7,2836510,66.2,152325,5.1
15836,November 2001,Montana,695802,465001,66.8,444318,63.9,20683,4.4
15837,November 2001,Nebraska,1294148,951842,73.5,919545,71.1,32297,3.4
15838,November 2001,Nevada,1600992,1121702,70.1,1054891,65.9,66811,6.0
15839,November 2001,New Hampshire,971333,698481,71.9,669887,69.0,28594,4.1
15840,November 2001,New Jersey,6508396,4324811,66.4,4104342,63.1,220469,5.1
15841,November 2001,New Mexico,1359996,861115,63.3,817185,60.1,43930,5.1
15842,November 2001,New York,14680571,9182280,62.5,8651335,58.9,530945,5.8
15843,November 2001,North Carolina,6236322,4192051,67.2,3918440,62.8,273611,6.5
15844,November 2001,North Dakota,484590,339655,70.1,328774,67.8,10881,3.2
15845,November 2001,Ohio,8684968,5835026,67.2,5534385,63.7,300641,5.2
15846,November 2001,Oklahoma,2600322,1684621,64.8,1610941,62.0,73680,4.4
15847,November 2001,Oregon,2695721,1829757,67.9,1690130,62.7,139627,7.6
15848,November 2001,Pennsylvania,9532737,6193876,65.0,5864014,61.5,329862,5.3
15849,November 2001,Rhode Island,822844,544155,66.1,518108,63.0,26047,4.8
15850,November 2001,South Carolina,3077957,1938288,63.0,1825238,59.3,113050,5.8
15851,November 2001,South Dakota,568300,414427,72.9,400552,70.5,13875,3.3
15852,November 2001,Tennessee,4418100,2879728,65.2,2721514,61.6,158214,5.5
15853,November 2001,Texas,15607012,10596903,67.9,9981729,64.0,615174,5.8
15854,November 2001,Utah,1634134,1170796,71.6,1112156,68.1,58640,5.0
15855,November 2001,Vermont,480606,339176,70.6,326977,68.0,12199,3.6
15856,November 2001,Virginia,5409044,3678283,68.0,3528681,65.2,149602,4.1
15857,November 2001,Washington,4561056,3039950,66.7,2825087,61.9,214863,7.1
15858,November 2001,West Virginia,1427176,805281,56.4,764002,53.5,41279,5.1
15859,November 2001,Wisconsin,4144622,3011157,72.7,2857615,68.9,153542,5.1
15860,November 2001,Wyoming,376559,269170,71.5,258929,68.8,10241,3.8
15861,December 2001,Alabama,3398108,2108837,62.1,1982694,58.3,126143,6.0
15862,December 2001,Alaska,447347,323030,72.2,301416,67.4,21614,6.7
15863,December 2001,Arizona,4004764,2629540,65.7,2478895,61.9,150645,5.7
15864,December 2001,Arkansas,2046024,1256205,61.4,1188056,58.1,68149,5.4
15865,December 2001,California,25700341,17196546,66.9,16102353,62.7,1094193,6.4
15866,December 2001,Colorado,3376403,2421809,71.7,2296270,68.0,125539,5.2
15867,December 2001,Connecticut,2621052,1756742,67.0,1698611,64.8,58131,3.3
15868,December 2001,Delaware,608616,421097,69.2,405358,66.6,15739,3.7
15869,December 2001,District of Columbia,461680,308702,66.9,288418,62.5,20284,6.6
15870,December 2001,Florida,12853859,8057010,62.7,7573724,58.9,483286,6.0
15871,December 2001,Georgia,6285374,4278521,68.1,4068160,64.7,210361,4.9
15872,December 2001,Hawaii,910871,607947,66.7,576568,63.3,31379,5.2
15873,December 2001,Idaho,978096,682560,69.8,644640,65.9,37920,5.6
15874,December 2001,Illinois,9436821,6413132,68.0,6018004,63.8,395128,6.2
15875,December 2001,Indiana,4643062,3153290,67.9,2986435,64.3,166855,5.3
15876,December 2001,Iowa,2243507,1627449,72.5,1565955,69.8,61494,3.8
15877,December 2001,Kansas,2020944,1395681,69.1,1329183,65.8,66498,4.8
15878,December 2001,Kentucky,3116719,1951076,62.6,1836252,58.9,114824,5.9
15879,December 2001,Louisiana,3302065,2010894,60.9,1885504,57.1,125390,6.2
15880,December 2001,Maine,1009929,672810,66.6,645124,63.9,27686,4.1
15881,December 2001,Maryland,4076605,2859975,70.2,2727823,66.9,132152,4.6
15882,December 2001,Massachusetts,4990241,3402012,68.2,3245942,65.0,156070,4.6
15883,December 2001,Michigan,7597070,5058690,66.6,4741907,62.4,316783,6.3
15884,December 2001,Minnesota,3801321,2855900,75.1,2730358,71.8,125542,4.4
15885,December 2001,Mississippi,2107926,1286280,61.0,1201468,57.0,84812,6.6
15886,December 2001,Missouri,4290818,2989293,69.7,2833028,66.0,156265,5.2
15887,December 2001,Montana,696333,465253,66.8,444533,63.8,20720,4.5
15888,December 2001,Nebraska,1294719,951927,73.5,918819,71.0,33108,3.5
15889,December 2001,Nevada,1605494,1122920,69.9,1054640,65.7,68280,6.1
15890,December 2001,New Hampshire,972527,698902,71.9,669538,68.8,29364,4.2
15891,December 2001,New Jersey,6512103,4333824,66.6,4103245,63.0,230579,5.3
15892,December 2001,New Mexico,1361746,862841,63.4,818018,60.1,44823,5.2
15893,December 2001,New York,14687494,9197679,62.6,8647591,58.9,550088,6.0
15894,December 2001,North Carolina,6242843,4192439,67.2,3911234,62.7,281205,6.7
15895,December 2001,North Dakota,484593,339759,70.1,328430,67.8,11329,3.3
15896,December 2001,Ohio,8687916,5842104,67.2,5527909,63.6,314195,5.4
15897,December 2001,Oklahoma,2601753,1686851,64.8,1611296,61.9,75555,4.5
15898,December 2001,Oregon,2699120,1831234,67.8,1687561,62.5,143673,7.8
15899,December 2001,Pennsylvania,9535917,6201022,65.0,5863333,61.5,337689,5.4
15900,December 2001,Rhode Island,823528,544646,66.1,518490,63.0,26156,4.8
15901,December 2001,South Carolina,3080635,1936423,62.9,1822629,59.2,113794,5.9
15902,December 2001,South Dakota,568672,414718,72.9,400708,70.5,14010,3.4
15903,December 2001,Tennessee,4421453,2887177,65.3,2722808,61.6,164369,5.7
15904,December 2001,Texas,15630107,10616118,67.9,9982878,63.9,633240,6.0
15905,December 2001,Utah,1636921,1173734,71.7,1112743,68.0,60991,5.2
15906,December 2001,Vermont,480956,339746,70.6,327256,68.0,12490,3.7
15907,December 2001,Virginia,5415147,3683084,68.0,3529384,65.2,153700,4.2
15908,December 2001,Washington,4566506,3045784,66.7,2824504,61.9,221280,7.3
15909,December 2001,West Virginia,1427291,804725,56.4,762033,53.4,42692,5.3
15910,December 2001,Wisconsin,4147972,3011821,72.6,2853310,68.8,158511,5.3
15911,December 2001,Wyoming,376925,269005,71.4,258703,68.6,10302,3.8
15912,January 2002,Alabama,3399005,2107022,62.0,1979465,58.2,127557,6.1
15913,January 2002,Alaska,448136,323503,72.2,301490,67.3,22013,6.8
15914,January 2002,Arizona,4014110,2638754,65.7,2484317,61.9,154437,5.9
15915,January 2002,Arkansas,2047083,1258727,61.5,1189330,58.1,69397,5.5
15916,January 2002,California,25729038,17211457,66.9,16096902,62.6,1114555,6.5
15917,January 2002,Colorado,3381106,2426393,71.8,2296628,67.9,129765,5.3
15918,January 2002,Connecticut,2622807,1757658,67.0,1698148,64.7,59510,3.4
15919,January 2002,Delaware,609322,420776,69.1,404483,66.4,16293,3.9
15920,January 2002,District of Columbia,461733,308251,66.8,287999,62.4,20252,6.6
15921,January 2002,Florida,12876040,8063779,62.6,7579800,58.9,483979,6.0
15922,January 2002,Georgia,6295616,4285043,68.1,4069939,64.6,215104,5.0
15923,January 2002,Hawaii,911557,606336,66.5,575430,63.1,30906,5.1
15924,January 2002,Idaho,979698,682569,69.7,644024,65.7,38545,5.6
15925,January 2002,Illinois,9441311,6406079,67.9,6001252,63.6,404827,6.3
15926,January 2002,Indiana,4645046,3155451,67.9,2985585,64.3,169866,5.4
15927,January 2002,Iowa,2243962,1630809,72.7,1567821,69.9,62988,3.9
15928,January 2002,Kansas,2022069,1398384,69.2,1330120,65.8,68264,4.9
15929,January 2002,Kentucky,3118507,1949415,62.5,1835019,58.8,114396,5.9
15930,January 2002,Louisiana,3303232,2006632,60.7,1881315,57.0,125317,6.2
15931,January 2002,Maine,1010842,672274,66.5,644507,63.8,27767,4.1
15932,January 2002,Maryland,4081417,2864368,70.2,2731672,66.9,132696,4.6
15933,January 2002,Massachusetts,4992707,3407838,68.3,3246110,65.0,161728,4.7
15934,January 2002,Michigan,7600764,5049203,66.4,4727676,62.2,321527,6.4
15935,January 2002,Minnesota,3804678,2858370,75.1,2729028,71.7,129342,4.5
15936,January 2002,Mississippi,2108546,1286290,61.0,1199818,56.9,86472,6.7
15937,January 2002,Missouri,4293808,2991163,69.7,2831893,66.0,159270,5.3
15938,January 2002,Montana,696879,465502,66.8,444715,63.8,20787,4.5
15939,January 2002,Nebraska,1295374,952087,73.5,918250,70.9,33837,3.6
15940,January 2002,Nevada,1609988,1124046,69.8,1055412,65.6,68634,6.1
15941,January 2002,New Hampshire,973706,699379,71.8,669319,68.7,30060,4.3
15942,January 2002,New Jersey,6515894,4341107,66.6,4102023,63.0,239084,5.5
15943,January 2002,New Mexico,1363473,864819,63.4,819094,60.1,45725,5.3
15944,January 2002,New York,14694911,9215047,62.7,8650499,58.9,564548,6.1
15945,January 2002,North Carolina,6249603,4192861,67.1,3906847,62.5,286014,6.8
15946,January 2002,North Dakota,484594,339977,70.2,328192,67.7,11785,3.5
15947,January 2002,Ohio,8691057,5848220,67.3,5522723,63.5,325497,5.6
15948,January 2002,Oklahoma,2603219,1688913,64.9,1612042,61.9,76871,4.6
15949,January 2002,Oregon,2702531,1832007,67.8,1686515,62.4,145492,7.9
15950,January 2002,Pennsylvania,9539280,6208905,65.1,5864799,61.5,344106,5.5
15951,January 2002,Rhode Island,824219,545311,66.2,519044,63.0,26267,4.8
15952,January 2002,South Carolina,3083424,1935744,62.8,1821724,59.1,114020,5.9
15953,January 2002,South Dakota,569009,415035,72.9,400968,70.5,14067,3.4
15954,January 2002,Tennessee,4424888,2893537,65.4,2726173,61.6,167364,5.8
15955,January 2002,Texas,15653763,10636509,67.9,9988954,63.8,647555,6.1
15956,January 2002,Utah,1639828,1176650,71.8,1113397,67.9,63253,5.4
15957,January 2002,Vermont,481315,340414,70.7,327665,68.1,12749,3.7
15958,January 2002,Virginia,5421363,3689739,68.1,3533571,65.2,156168,4.2
15959,January 2002,Washington,4571991,3052331,66.8,2826097,61.8,226234,7.4
15960,January 2002,West Virginia,1427374,804275,56.3,760037,53.2,44238,5.5
15961,January 2002,Wisconsin,4151392,3012845,72.6,2850698,68.7,162147,5.4
15962,January 2002,Wyoming,377308,268926,71.3,258486,68.5,10440,3.9
15963,February 2002,Alabama,3399402,2104914,61.9,1977317,58.2,127597,6.1
15964,February 2002,Alaska,448798,324044,72.2,301599,67.2,22445,6.9
15965,February 2002,Arizona,4022929,2647828,65.8,2490127,61.9,157701,6.0
15966,February 2002,Arkansas,2047798,1261982,61.6,1191739,58.2,70243,5.6
15967,February 2002,California,25755035,17224746,66.9,16096157,62.5,1128589,6.6
15968,February 2002,Colorado,3385487,2430101,71.8,2297663,67.9,132438,5.4
15969,February 2002,Connecticut,2624141,1759625,67.1,1697894,64.7,61731,3.5
15970,February 2002,Delaware,609922,420290,68.9,403498,66.2,16792,4.0
15971,February 2002,District of Columbia,461673,308005,66.7,287820,62.3,20185,6.6
15972,February 2002,Florida,12896372,8069997,62.6,7589859,58.9,480138,5.9
15973,February 2002,Georgia,6305144,4291780,68.1,4074138,64.6,217642,5.1
15974,February 2002,Hawaii,912110,604597,66.3,574859,63.0,29738,4.9
15975,February 2002,Idaho,981094,682694,69.6,643795,65.6,38899,5.7
15976,February 2002,Illinois,9444668,6398245,67.7,5986048,63.4,412197,6.4
15977,February 2002,Indiana,4646491,3157267,67.9,2986289,64.3,170978,5.4
15978,February 2002,Iowa,2244055,1634357,72.8,1570313,70.0,64044,3.9
15979,February 2002,Kansas,2022953,1401139,69.3,1331542,65.8,69597,5.0
15980,February 2002,Kentucky,3119948,1947340,62.4,1834376,58.8,112964,5.8
15981,February 2002,Louisiana,3303952,2002973,60.6,1878616,56.9,124357,6.2
15982,February 2002,Maine,1011593,672098,66.4,644171,63.7,27927,4.2
15983,February 2002,Maryland,4085716,2867713,70.2,2735296,66.9,132417,4.6
15984,February 2002,Massachusetts,4994638,3414034,68.4,3247161,65.0,166873,4.9
15985,February 2002,Michigan,7603498,5040734,66.3,4717634,62.0,323100,6.4
15986,February 2002,Minnesota,3807582,2859741,75.1,2727925,71.6,131816,4.6
15987,February 2002,Mississippi,2108953,1286137,61.0,1198942,56.9,87195,6.8
15988,February 2002,Missouri,4296276,2993668,69.7,2832132,65.9,161536,5.4
15989,February 2002,Montana,697360,465738,66.8,444877,63.8,20861,4.5
15990,February 2002,Nebraska,1295829,952343,73.5,917928,70.8,34415,3.6
15991,February 2002,Nevada,1614350,1125098,69.7,1057063,65.5,68035,6.0
15992,February 2002,New Hampshire,974835,699871,71.8,669224,68.6,30647,4.4
15993,February 2002,New Jersey,6518981,4345884,66.7,4100218,62.9,245666,5.7
15994,February 2002,New Mexico,1365077,866950,63.5,820329,60.1,46621,5.4
15995,February 2002,New York,14700518,9232774,62.8,8658481,58.9,574293,6.2
15996,February 2002,North Carolina,6255644,4192913,67.0,3904655,62.4,288258,6.9
15997,February 2002,North Dakota,484542,340232,70.2,328031,67.7,12201,3.6
15998,February 2002,Ohio,8693156,5852797,67.3,5518625,63.5,334172,5.7
15999,February 2002,Oklahoma,2604437,1690253,64.9,1612733,61.9,77520,4.6
16000,February 2002,Oregon,2705630,1832050,67.7,1686953,62.3,145097,7.9
16001,February 2002,Pennsylvania,9541334,6216369,65.2,5867638,61.5,348731,5.6
16002,February 2002,Rhode Island,824817,546063,66.2,519681,63.0,26382,4.8
16003,February 2002,South Carolina,3085853,1936494,62.8,1822644,59.1,113850,5.9
16004,February 2002,South Dakota,569314,415376,73.0,401378,70.5,13998,3.4
16005,February 2002,Tennessee,4427865,2898256,65.5,2731339,61.7,166917,5.8
16006,February 2002,Texas,15675829,10657551,68.0,9998790,63.8,658761,6.2
16007,February 2002,Utah,1642558,1179115,71.8,1113877,67.8,65238,5.5
16008,February 2002,Vermont,481654,341147,70.8,328182,68.1,12965,3.8
16009,February 2002,Virginia,5427008,3697408,68.1,3540024,65.2,157384,4.3
16010,February 2002,Washington,4577007,3058885,66.8,2829475,61.8,229410,7.5
16011,February 2002,West Virginia,1427372,803797,56.3,758068,53.1,45729,5.7
16012,February 2002,Wisconsin,4154323,3013993,72.6,2849935,68.6,164058,5.4
16013,February 2002,Wyoming,377686,268916,71.2,258300,68.4,10616,3.9
16014,March 2002,Alabama,3399942,2102910,61.9,1976134,58.1,126776,6.0
16015,March 2002,Alaska,449530,324565,72.2,301686,67.1,22879,7.0
16016,March 2002,Arizona,4031755,2656594,65.9,2496029,61.9,160565,6.0
16017,March 2002,Arkansas,2048658,1265380,61.8,1194793,58.3,70587,5.6
16018,March 2002,California,25780233,17235515,66.9,16097533,62.4,1137982,6.6
16019,March 2002,Colorado,3389916,2433076,71.8,2299278,67.8,133798,5.5
16020,March 2002,Connecticut,2625538,1762399,67.1,1697767,64.7,64632,3.7
16021,March 2002,Delaware,610535,419636,68.7,402478,65.9,17158,4.1
16022,March 2002,District of Columbia,461692,307862,66.7,287788,62.3,20074,6.5
16023,March 2002,Florida,12916606,8076223,62.5,7602078,58.9,474145,5.9
16024,March 2002,Georgia,6314817,4298887,68.1,4080271,64.6,218616,5.1
16025,March 2002,Hawaii,912658,602963,66.1,574713,63.0,28250,4.7
16026,March 2002,Idaho,982583,682951,69.5,644016,65.5,38935,5.7
16027,March 2002,Illinois,9448199,6389001,67.6,5971273,63.2,417728,6.5
16028,March 2002,Indiana,4648125,3159782,68.0,2989064,64.3,170718,5.4
16029,March 2002,Iowa,2244254,1637809,73.0,1573059,70.1,64750,4.0
16030,March 2002,Kansas,2023880,1403932,69.4,1333424,65.9,70508,5.0
16031,March 2002,Kentucky,3121497,1944942,62.3,1833963,58.8,110979,5.7
16032,March 2002,Louisiana,3304766,2000395,60.5,1877247,56.8,123148,6.2
16033,March 2002,Maine,1012390,672400,66.4,644212,63.6,28188,4.2
16034,March 2002,Maryland,4090119,2869786,70.2,2738180,66.9,131606,4.6
16035,March 2002,Massachusetts,4996735,3419972,68.4,3248504,65.0,171468,5.0
16036,March 2002,Michigan,7606496,5033244,66.2,4710417,61.9,322827,6.4
16037,March 2002,Minnesota,3810635,2860206,75.1,2727347,71.6,132859,4.6
16038,March 2002,Mississippi,2109384,1285667,60.9,1198570,56.8,87097,6.8
16039,March 2002,Missouri,4298928,2995963,69.7,2832671,65.9,163292,5.5
16040,March 2002,Montana,697821,465951,66.8,445059,63.8,20892,4.5
16041,March 2002,Nebraska,1296333,952657,73.5,917864,70.8,34793,3.7
16042,March 2002,Nevada,1618698,1126107,69.6,1059222,65.4,66885,5.9
16043,March 2002,New Hampshire,975961,700359,71.8,669289,68.6,31070,4.4
16044,March 2002,New Jersey,6522054,4347820,66.7,4097687,62.8,250133,5.8
16045,March 2002,New Mexico,1366596,869133,63.6,821640,60.1,47493,5.5
16046,March 2002,New York,14706242,9249119,62.9,8669535,59.0,579584,6.3
16047,March 2002,North Carolina,6261836,4192300,67.0,3904037,62.3,288263,6.9
16048,March 2002,North Dakota,484488,340483,70.3,327951,67.7,12532,3.7
16049,March 2002,Ohio,8695571,5855442,67.3,5515350,63.4,340092,5.8
16050,March 2002,Oklahoma,2605665,1690570,64.9,1612996,61.9,77574,4.6
16051,March 2002,Oregon,2708829,1831656,67.6,1688681,62.3,142975,7.8
16052,March 2002,Pennsylvania,9543727,6222096,65.2,5870685,61.5,351411,5.6
16053,March 2002,Rhode Island,825430,546812,66.2,520299,63.0,26513,4.8
16054,March 2002,South Carolina,3088373,1938335,62.8,1824931,59.1,113404,5.9
16055,March 2002,South Dakota,569620,415760,73.0,401956,70.6,13804,3.3
16056,March 2002,Tennessee,4430974,2901181,65.5,2737702,61.8,163479,5.6
16057,March 2002,Texas,15697510,10678637,68.0,10010910,63.8,667727,6.3
16058,March 2002,Utah,1645359,1180850,71.8,1114024,67.7,66826,5.7
16059,March 2002,Vermont,481999,341884,70.9,328731,68.2,13153,3.8
16060,March 2002,Virginia,5432738,3705408,68.2,3547398,65.3,158010,4.3
16061,March 2002,Washington,4582078,3065036,66.9,2834166,61.9,230870,7.5
16062,March 2002,West Virginia,1427372,803157,56.3,756211,53.0,46946,5.8
16063,March 2002,Wisconsin,4157408,3015033,72.5,2850567,68.6,164466,5.5
16064,March 2002,Wyoming,378036,268927,71.1,258160,68.3,10767,4.0
16065,April 2002,Alabama,3400511,2101696,61.8,1976039,58.1,125657,6.0
16066,April 2002,Alaska,450277,325032,72.2,301737,67.0,23295,7.2
16067,April 2002,Arizona,4040671,2665340,66.0,2502499,61.9,162841,6.1
16068,April 2002,Arkansas,2049502,1268600,61.9,1198134,58.5,70466,5.6
16069,April 2002,California,25806595,17245819,66.8,16101941,62.4,1143878,6.6
16070,April 2002,Colorado,3394409,2436172,71.8,2301814,67.8,134358,5.5
16071,April 2002,Connecticut,2627024,1765876,67.2,1697915,64.6,67961,3.8
16072,April 2002,Delaware,611183,418853,68.5,401522,65.7,17331,4.1
16073,April 2002,District of Columbia,461675,307670,66.6,287765,62.3,19905,6.5
16074,April 2002,Florida,12937202,8085225,62.5,7617229,58.9,467996,5.8
16075,April 2002,Georgia,6324507,4306982,68.1,4088510,64.6,218472,5.1
16076,April 2002,Hawaii,913296,601660,65.9,574734,62.9,26926,4.5
16077,April 2002,Idaho,984072,683265,69.4,644596,65.5,38669,5.7
16078,April 2002,Illinois,9451880,6378638,67.5,5957701,63.0,420937,6.6
16079,April 2002,Indiana,4649772,3163949,68.0,2994416,64.4,169533,5.4
16080,April 2002,Iowa,2244508,1640889,73.1,1575696,70.2,65193,4.0
16081,April 2002,Kansas,2024833,1406863,69.5,1335839,66.0,71024,5.0
16082,April 2002,Kentucky,3123099,1942987,62.2,1833794,58.7,109193,5.6
16083,April 2002,Louisiana,3305599,1999408,60.5,1877290,56.8,122118,6.1
16084,April 2002,Maine,1013225,673143,66.4,644614,63.6,28529,4.2
16085,April 2002,Maryland,4094526,2870846,70.1,2740445,66.9,130401,4.5
16086,April 2002,Massachusetts,4998907,3425697,68.5,3250147,65.0,175550,5.1
16087,April 2002,Michigan,7609548,5027146,66.1,4705863,61.8,321283,6.4
16088,April 2002,Minnesota,3813741,2860264,75.0,2727633,71.5,132631,4.6
16089,April 2002,Mississippi,2109787,1285109,60.9,1198754,56.8,86355,6.7
16090,April 2002,Missouri,4301583,2998049,69.7,2833660,65.9,164389,5.5
16091,April 2002,Montana,698307,466131,66.8,445312,63.8,20819,4.5
16092,April 2002,Nebraska,1296857,953028,73.5,918045,70.8,34983,3.7
16093,April 2002,Nevada,1623098,1127097,69.4,1061424,65.4,65673,5.8
16094,April 2002,New Hampshire,977104,700845,71.7,669534,68.5,31311,4.5
16095,April 2002,New Jersey,6525347,4347948,66.6,4095751,62.8,252197,5.8
16096,April 2002,New Mexico,1368206,871297,63.7,823026,60.2,48271,5.5
16097,April 2002,New York,14712306,9263603,63.0,8683503,59.0,580100,6.3
16098,April 2002,North Carolina,6268081,4191758,66.9,3905396,62.3,286362,6.8
16099,April 2002,North Dakota,484459,340685,70.3,327939,67.7,12746,3.7
16100,April 2002,Ohio,8698086,5856527,67.3,5513808,63.4,342719,5.9
16101,April 2002,Oklahoma,2606960,1690086,64.8,1612848,61.9,77238,4.6
16102,April 2002,Oregon,2712033,1831456,67.5,1691574,62.4,139882,7.6
16103,April 2002,Pennsylvania,9546247,6226081,65.2,5874083,61.5,351998,5.7
16104,April 2002,Rhode Island,826076,547532,66.3,520853,63.1,26679,4.9
16105,April 2002,South Carolina,3090857,1941025,62.8,1828234,59.1,112791,5.8
16106,April 2002,South Dakota,569935,416203,73.0,402688,70.7,13515,3.2
16107,April 2002,Tennessee,4434095,2903401,65.5,2745246,61.9,158155,5.4
16108,April 2002,Texas,15719749,10701117,68.1,10026219,63.8,674898,6.3
16109,April 2002,Utah,1648148,1181898,71.7,1113903,67.6,67995,5.8
16110,April 2002,Vermont,482348,342557,71.0,329232,68.3,13325,3.9
16111,April 2002,Virginia,5438518,3714103,68.3,3555752,65.4,158351,4.3
16112,April 2002,Washington,4587299,3071258,67.0,2840344,61.9,230914,7.5
16113,April 2002,West Virginia,1427380,802386,56.2,754657,52.9,47729,5.9
16114,April 2002,Wisconsin,4160519,3016252,72.5,2852446,68.6,163806,5.4
16115,April 2002,Wyoming,378392,268935,71.1,258089,68.2,10846,4.0
16116,May 2002,Alabama,3401328,2101698,61.8,1977060,58.1,124638,5.9
16117,May 2002,Alaska,451047,325471,72.2,301790,66.9,23681,7.3
16118,May 2002,Arizona,4049916,2673923,66.0,2509479,62.0,164444,6.1
16119,May 2002,Arkansas,2050547,1271388,62.0,1201396,58.6,69992,5.5
16120,May 2002,California,25833940,17256450,66.8,16109272,62.4,1147178,6.6
16121,May 2002,Colorado,3399138,2439827,71.8,2305162,67.8,134665,5.5
16122,May 2002,Connecticut,2628719,1769812,67.3,1698274,64.6,71538,4.0
16123,May 2002,Delaware,611867,417988,68.3,400689,65.5,17299,4.1
16124,May 2002,District of Columbia,461658,307294,66.6,287609,62.3,19685,6.4
16125,May 2002,Florida,12959162,8098095,62.5,7635413,58.9,462682,5.7
16126,May 2002,Georgia,6334589,4315919,68.1,4098495,64.7,217424,5.0
16127,May 2002,Hawaii,913889,600777,65.7,574816,62.9,25961,4.3
16128,May 2002,Idaho,985659,683588,69.4,645407,65.5,38181,5.6
16129,May 2002,Illinois,9456254,6367557,67.3,5945768,62.9,421789,6.6
16130,May 2002,Indiana,4651908,3169536,68.1,3001795,64.5,167741,5.3
16131,May 2002,Iowa,2245018,1643266,73.2,1577831,70.3,65435,4.0
16132,May 2002,Kansas,2026012,1409936,69.6,1338622,66.1,71314,5.1
16133,May 2002,Kentucky,3125031,1941933,62.1,1833835,58.7,108098,5.6
16134,May 2002,Louisiana,3306659,2000002,60.5,1878570,56.8,121432,6.1
16135,May 2002,Maine,1014188,674111,66.5,645262,63.6,28849,4.3
16136,May 2002,Maryland,4099229,2871170,70.0,2742372,66.9,128798,4.5
16137,May 2002,Massachusetts,5001592,3431211,68.6,3252000,65.0,179211,5.2
16138,May 2002,Michigan,7613320,5022531,66.0,4703694,61.8,318837,6.3
16139,May 2002,Minnesota,3817273,2860212,74.9,2728728,71.5,131484,4.6
16140,May 2002,Mississippi,2110317,1284793,60.9,1199497,56.8,85296,6.6
16141,May 2002,Missouri,4304730,2999985,69.7,2835407,65.9,164578,5.5
16142,May 2002,Montana,698870,466308,66.7,445677,63.8,20631,4.4
16143,May 2002,Nebraska,1297541,953464,73.5,918455,70.8,35009,3.7
16144,May 2002,Nevada,1627566,1128074,69.3,1063474,65.3,64600,5.7
16145,May 2002,New Hampshire,978369,701366,71.7,669949,68.5,31417,4.5
16146,May 2002,New Jersey,6529085,4347336,66.6,4095001,62.7,252335,5.8
16147,May 2002,New Mexico,1369866,873285,63.7,824465,60.2,48820,5.6
16148,May 2002,New York,14719348,9275952,63.0,8699645,59.1,576307,6.2
16149,May 2002,North Carolina,6274796,4191385,66.8,3908483,62.3,282902,6.7
16150,May 2002,North Dakota,484485,340792,70.3,327951,67.7,12841,3.8
16151,May 2002,Ohio,8701460,5856509,67.3,5514375,63.4,342134,5.8
16152,May 2002,Oklahoma,2608481,1689101,64.8,1612294,61.8,76807,4.5
16153,May 2002,Oregon,2715529,1831972,67.5,1695253,62.4,136719,7.5
16154,May 2002,Pennsylvania,9549866,6228490,65.2,5877812,61.5,350678,5.6
16155,May 2002,Rhode Island,826768,548259,66.3,521378,63.1,26881,4.9
16156,May 2002,South Carolina,3093596,1944162,62.8,1832153,59.2,112009,5.8
16157,May 2002,South Dakota,570347,416707,73.1,403528,70.8,13179,3.2
16158,May 2002,Tennessee,4437612,2905781,65.5,2753392,62.0,152389,5.2
16159,May 2002,Texas,15742777,10725163,68.1,10044638,63.8,680525,6.3
16160,May 2002,Utah,1651119,1182607,71.6,1113771,67.5,68836,5.8
16161,May 2002,Vermont,482761,343102,71.1,329625,68.3,13477,3.9
16162,May 2002,Virginia,5444702,3723149,68.4,3564919,65.5,158230,4.2
16163,May 2002,Washington,4592891,3077864,67.0,2847834,62.0,230030,7.5
16164,May 2002,West Virginia,1427582,801550,56.1,753499,52.8,48051,6.0
16165,May 2002,Wisconsin,4164122,3017914,72.5,2855328,68.6,162586,5.4
16166,May 2002,Wyoming,378808,268953,71.0,258119,68.1,10834,4.0
16167,June 2002,Alabama,3402356,2102827,61.8,1979125,58.2,123702,5.9
16168,June 2002,Alaska,451808,325921,72.1,301917,66.8,24004,7.4
16169,June 2002,Arizona,4059426,2682097,66.1,2516621,62.0,165476,6.2
16170,June 2002,Arkansas,2051705,1273564,62.1,1204211,58.7,69353,5.4
16171,June 2002,California,25863088,17266132,66.8,16118157,62.3,1147975,6.6
16172,June 2002,Colorado,3404075,2443731,71.8,2308771,67.8,134960,5.5
16173,June 2002,Connecticut,2630600,1773887,67.4,1698674,64.6,75213,4.2
16174,June 2002,Delaware,612606,417078,68.1,399975,65.3,17103,4.1
16175,June 2002,District of Columbia,461677,306666,66.4,287235,62.2,19431,6.3
16176,June 2002,Florida,12981925,8113558,62.5,7655811,59.0,457747,5.6
16177,June 2002,Georgia,6344978,4325008,68.2,4109382,64.8,215626,5.0
16178,June 2002,Hawaii,914553,600235,65.6,575022,62.9,25213,4.2
16179,June 2002,Idaho,987341,683942,69.3,646306,65.5,37636,5.5
16180,June 2002,Illinois,9461164,6356257,67.2,5935687,62.7,420570,6.6
16181,June 2002,Indiana,4654304,3175468,68.2,3009878,64.7,165590,5.2
16182,June 2002,Iowa,2245696,1644665,73.2,1579129,70.3,65536,4.0
16183,June 2002,Kansas,2027326,1413079,69.7,1341523,66.2,71556,5.1
16184,June 2002,Kentucky,3127066,1941692,62.1,1834055,58.7,107637,5.5
16185,June 2002,Louisiana,3307869,2001842,60.5,1880711,56.9,121131,6.1
16186,June 2002,Maine,1015204,675067,66.5,645978,63.6,29089,4.3
16187,June 2002,Maryland,4104114,2871039,70.0,2744140,66.9,126899,4.4
16188,June 2002,Massachusetts,5004538,3436297,68.7,3253910,65.0,182387,5.3
16189,June 2002,Michigan,7617506,5018516,65.9,4703392,61.7,315124,6.3
16190,June 2002,Minnesota,3821031,2860082,74.9,2730401,71.5,129681,4.5
16191,June 2002,Mississippi,2111014,1284828,60.9,1200617,56.9,84211,6.6
16192,June 2002,Missouri,4308070,3001649,69.7,2838103,65.9,163546,5.4
16193,June 2002,Montana,699484,466509,66.7,446126,63.8,20383,4.4
16194,June 2002,Nebraska,1298295,953892,73.5,918981,70.8,34911,3.7
16195,June 2002,Nevada,1632156,1129034,69.2,1065500,65.3,63534,5.6
16196,June 2002,New Hampshire,979672,701957,71.7,670472,68.4,31485,4.5
16197,June 2002,New Jersey,6533268,4346669,66.5,4095257,62.7,251412,5.8
16198,June 2002,New Mexico,1371676,874980,63.8,825900,60.2,49080,5.6
16199,June 2002,New York,14727246,9286050,63.1,8716472,59.2,569578,6.1
16200,June 2002,North Carolina,6281887,4190725,66.7,3912400,62.3,278325,6.6
16201,June 2002,North Dakota,484549,340817,70.3,327961,67.7,12856,3.8
16202,June 2002,Ohio,8705279,5855518,67.3,5516589,63.4,338929,5.8
16203,June 2002,Oklahoma,2610169,1687780,64.7,1611349,61.7,76431,4.5
16204,June 2002,Oregon,2719230,1833461,67.4,1699185,62.5,134276,7.3
16205,June 2002,Pennsylvania,9554009,6229132,65.2,5881236,61.6,347896,5.6
16206,June 2002,Rhode Island,827595,549061,66.3,521963,63.1,27098,4.9
16207,June 2002,South Carolina,3096466,1947433,62.9,1836245,59.3,111188,5.7
16208,June 2002,South Dakota,570782,417247,73.1,404366,70.8,12881,3.1
16209,June 2002,Tennessee,4441378,2908418,65.5,2761363,62.2,147055,5.1
16210,June 2002,Texas,15766911,10749742,68.2,10065271,63.8,684471,6.4
16211,June 2002,Utah,1654153,1183447,71.5,1113976,67.3,69471,5.9
16212,June 2002,Vermont,483209,343487,71.1,329880,68.3,13607,4.0
16213,June 2002,Virginia,5451225,3731744,68.5,3574268,65.6,157476,4.2
16214,June 2002,Washington,4598753,3084674,67.1,2856060,62.1,228614,7.4
16215,June 2002,West Virginia,1427862,800727,56.1,752707,52.7,48020,6.0
16216,June 2002,Wisconsin,4167960,3020202,72.5,2859019,68.6,161183,5.3
16217,June 2002,Wyoming,379237,269001,70.9,258240,68.1,10761,4.0
16218,July 2002,Alabama,3403420,2104604,61.8,1981669,58.2,122935,5.8
16219,July 2002,Alaska,452597,326427,72.1,302187,66.8,24240,7.4
16220,July 2002,Arizona,4068974,2689164,66.1,2523091,62.0,166073,6.2
16221,July 2002,Arkansas,2052905,1274997,62.1,1206237,58.8,68760,5.4
16222,July 2002,California,25892172,17272995,66.7,16124848,62.3,1148147,6.6
16223,July 2002,Colorado,3409041,2447093,71.8,2311774,67.8,135319,5.5
16224,July 2002,Connecticut,2632445,1777664,67.5,1698756,64.5,78908,4.4
16225,July 2002,Delaware,613315,416167,67.9,399349,65.1,16818,4.0
16226,July 2002,District of Columbia,461714,305894,66.3,286696,62.1,19198,6.3
16227,July 2002,Florida,13004706,8128237,62.5,7675185,59.0,453052,5.6
16228,July 2002,Georgia,6355530,4333585,68.2,4119610,64.8,213975,4.9
16229,July 2002,Hawaii,915205,599813,65.5,575288,62.9,24525,4.1
16230,July 2002,Idaho,988987,684374,69.2,647131,65.4,37243,5.4
16231,July 2002,Illinois,9466124,6344278,67.0,5926355,62.6,417923,6.6
16232,July 2002,Indiana,4656712,3180125,68.3,3016720,64.8,163405,5.1
16233,July 2002,Iowa,2246337,1644682,73.2,1579162,70.3,65520,4.0
16234,July 2002,Kansas,2028625,1416003,69.8,1344178,66.3,71825,5.1
16235,July 2002,Kentucky,3129155,1941963,62.1,1834187,58.6,107776,5.5
16236,July 2002,Louisiana,3309155,2004004,60.6,1882708,56.9,121296,6.1
16237,July 2002,Maine,1016191,675858,66.5,646588,63.6,29270,4.3
16238,July 2002,Maryland,4109054,2870717,69.9,2745583,66.8,125134,4.4
16239,July 2002,Massachusetts,5007522,3440226,68.7,3255164,65.0,185062,5.4
16240,July 2002,Michigan,7621745,5013844,65.8,4703289,61.7,310555,6.2
16241,July 2002,Minnesota,3824792,2859793,74.8,2732182,71.4,127611,4.5
16242,July 2002,Mississippi,2111700,1285104,60.9,1201727,56.9,83377,6.5
16243,July 2002,Missouri,4311449,3002861,69.6,2841131,65.9,161730,5.4
16244,July 2002,Montana,700089,466820,66.7,446655,63.8,20165,4.3
16245,July 2002,Nebraska,1299061,954209,73.5,919438,70.8,34771,3.6
16246,July 2002,Nevada,1636758,1129966,69.0,1067410,65.2,62556,5.5
16247,July 2002,New Hampshire,980968,702615,71.6,671031,68.4,31584,4.5
16248,July 2002,New Jersey,6537458,4346306,66.5,4095762,62.7,250544,5.8
16249,July 2002,New Mexico,1373468,876327,63.8,827244,60.2,49083,5.6
16250,July 2002,New York,14735197,9292936,63.1,8730281,59.2,562655,6.1
16251,July 2002,North Carolina,6289023,4189008,66.6,3915272,62.3,273736,6.5
16252,July 2002,North Dakota,484597,340790,70.3,327958,67.7,12832,3.8
16253,July 2002,Ohio,8709127,5853436,67.2,5518780,63.4,334656,5.7
16254,July 2002,Oklahoma,2611859,1686159,64.6,1609817,61.6,76342,4.5
16255,July 2002,Oregon,2722882,1835482,67.4,1702519,62.5,132963,7.2
16256,July 2002,Pennsylvania,9558096,6227784,65.2,5882499,61.5,345285,5.5
16257,July 2002,Rhode Island,828345,549992,66.4,522661,63.1,27331,5.0
16258,July 2002,South Carolina,3099393,1950188,62.9,1839764,59.4,110424,5.7
16259,July 2002,South Dakota,571214,417775,73.1,405084,70.9,12691,3.0
16260,July 2002,Tennessee,4445160,2910604,65.5,2767778,62.3,142826,4.9
16261,July 2002,Texas,15791186,10771961,68.2,10084917,63.9,687044,6.4
16262,July 2002,Utah,1657216,1184683,71.5,1114742,67.3,69941,5.9
16263,July 2002,Vermont,483617,343733,71.1,329998,68.2,13735,4.0
16264,July 2002,Virginia,5457742,3738523,68.5,3582081,65.6,156442,4.2
16265,July 2002,Washington,4604606,3090729,67.1,2863606,62.2,227123,7.3
16266,July 2002,West Virginia,1428122,799907,56.0,752065,52.7,47842,6.0
16267,July 2002,Wisconsin,4171808,3023036,72.5,2862953,68.6,160083,5.3
16268,July 2002,Wyoming,379662,269117,70.9,258426,68.1,10691,4.0
16269,August 2002,Alabama,3405507,2106792,61.9,1984310,58.3,122482,5.8
16270,August 2002,Alaska,453243,327024,72.2,302624,66.8,24400,7.5
16271,August 2002,Arizona,4078506,2694734,66.1,2528429,62.0,166305,6.2
16272,August 2002,Arkansas,2054532,1275846,62.1,1207454,58.8,68392,5.4
16273,August 2002,California,25923440,17277546,66.6,16127877,62.2,1149669,6.7
16274,August 2002,Colorado,3413275,2449681,71.8,2313877,67.8,135804,5.5
16275,August 2002,Connecticut,2634571,1780893,67.6,1698377,64.5,82516,4.6
16276,August 2002,Delaware,614168,415317,67.6,398800,64.9,16517,4.0
16277,August 2002,District of Columbia,461715,305119,66.1,286071,62.0,19048,6.2
16278,August 2002,Florida,13027230,8140435,62.5,7691633,59.0,448802,5.5
16279,August 2002,Georgia,6365990,4341903,68.2,4128462,64.9,213441,4.9
16280,August 2002,Hawaii,915763,599445,65.5,575600,62.9,23845,4.0
16281,August 2002,Idaho,990626,684966,69.1,647855,65.4,37111,5.4
16282,August 2002,Illinois,9471904,6332078,66.9,5917303,62.5,414775,6.6
16283,August 2002,Indiana,4660120,3182504,68.3,3021222,64.8,161282,5.1
16284,August 2002,Iowa,2247235,1643205,73.1,1577698,70.2,65507,4.0
16285,August 2002,Kansas,2030028,1418491,69.9,1346404,66.3,72087,5.1
16286,August 2002,Kentucky,3132038,1942520,62.0,1834107,58.6,108413,5.6
16287,August 2002,Louisiana,3311148,2005979,60.6,1884136,56.9,121843,6.1
16288,August 2002,Maine,1017263,676473,66.5,647019,63.6,29454,4.4
16289,August 2002,Maryland,4113818,2870484,69.8,2746687,66.8,123797,4.3
16290,August 2002,Massachusetts,5010165,3442553,68.7,3255316,65.0,187237,5.4
16291,August 2002,Michigan,7626953,5008678,65.7,4702293,61.7,306385,6.1
16292,August 2002,Minnesota,3828391,2859536,74.7,2733638,71.4,125898,4.4
16293,August 2002,Mississippi,2112746,1285695,60.9,1202637,56.9,83058,6.5
16294,August 2002,Missouri,4315054,3004047,69.6,2844067,65.9,159980,5.3
16295,August 2002,Montana,700879,467293,66.7,447223,63.8,20070,4.3
16296,August 2002,Nebraska,1299957,954553,73.4,919876,70.8,34677,3.6
16297,August 2002,Nevada,1641510,1130939,68.9,1069243,65.1,61696,5.5
16298,August 2002,New Hampshire,982164,703306,71.6,671570,68.4,31736,4.5
16299,August 2002,New Jersey,6541685,4346687,66.4,4096141,62.6,250546,5.8
16300,August 2002,New Mexico,1375264,877426,63.8,828449,60.2,48977,5.6
16301,August 2002,New York,14745511,9297709,63.1,8739159,59.3,558550,6.0
16302,August 2002,North Carolina,6296297,4186285,66.5,3915967,62.2,270318,6.5
16303,August 2002,North Dakota,484725,340739,70.3,327946,67.7,12793,3.8
16304,August 2002,Ohio,8714246,5851362,67.1,5520268,63.3,331094,5.7
16305,August 2002,Oklahoma,2613541,1684724,64.5,1607848,61.5,76876,4.6
16306,August 2002,Oregon,2726154,1837468,67.4,1704680,62.5,132788,7.2
16307,August 2002,Pennsylvania,9563962,6224827,65.1,5880430,61.5,344397,5.5
16308,August 2002,Rhode Island,829021,551118,66.5,523506,63.1,27612,5.0
16309,August 2002,South Carolina,3102735,1952687,62.9,1842425,59.4,110262,5.6
16310,August 2002,South Dakota,571710,418292,73.2,405648,71.0,12644,3.0
16311,August 2002,Tennessee,4449931,2912054,65.4,2771928,62.3,140126,4.8
16312,August 2002,Texas,15815630,10790555,68.2,10101364,63.9,689191,6.4
16313,August 2002,Utah,1660075,1186303,71.5,1116043,67.2,70260,5.9
16314,August 2002,Vermont,484042,343910,71.0,330018,68.2,13892,4.0
16315,August 2002,Virginia,5463319,3743211,68.5,3587564,65.7,155647,4.2
16316,August 2002,Washington,4609900,3095392,67.1,2869476,62.2,225916,7.3
16317,August 2002,West Virginia,1428658,799060,55.9,751397,52.6,47663,6.0
16318,August 2002,Wisconsin,4175782,3026548,72.5,2866747,68.7,159801,5.3
16319,August 2002,Wyoming,379950,269362,70.9,258670,68.1,10692,4.0
16320,September 2002,Alabama,3407668,2109245,61.9,1986849,58.3,122396,5.8
16321,September 2002,Alaska,453876,327699,72.2,303168,66.8,24531,7.5
16322,September 2002,Arizona,4088189,2698786,66.0,2532559,61.9,166227,6.2
16323,September 2002,Arkansas,2056241,1276294,62.1,1207906,58.7,68388,5.4
16324,September 2002,California,25955547,17280761,66.6,16126530,62.1,1154231,6.7
16325,September 2002,Colorado,3417582,2451709,71.7,2315156,67.7,136553,5.6
16326,September 2002,Connecticut,2636738,1783548,67.6,1697599,64.4,85949,4.8
16327,September 2002,Delaware,615047,414573,67.4,398280,64.8,16293,3.9
16328,September 2002,District of Columbia,461696,304436,65.9,285411,61.8,19025,6.2
16329,September 2002,Florida,13050162,8149610,62.4,7703939,59.0,445671,5.5
16330,September 2002,Georgia,6376576,4350017,68.2,4135699,64.9,214318,4.9
16331,September 2002,Hawaii,916404,599174,65.4,575964,62.9,23210,3.9
16332,September 2002,Idaho,992340,685713,69.1,648533,65.4,37180,5.4
16333,September 2002,Illinois,9477986,6320656,66.7,5908153,62.3,412503,6.5
16334,September 2002,Indiana,4663649,3182517,68.2,3023022,64.8,159495,5.0
16335,September 2002,Iowa,2248220,1640331,73.0,1574692,70.0,65639,4.0
16336,September 2002,Kansas,2031501,1420443,69.9,1348194,66.4,72249,5.1
16337,September 2002,Kentucky,3135036,1943301,62.0,1833682,58.5,109619,5.6
16338,September 2002,Louisiana,3313261,2007885,60.6,1885167,56.9,122718,6.1
16339,September 2002,Maine,1018360,677033,66.5,647259,63.6,29774,4.4
16340,September 2002,Maryland,4118710,2870452,69.7,2747334,66.7,123118,4.3
16341,September 2002,Massachusetts,5012887,3442962,68.7,3254048,64.9,188914,5.5
16342,September 2002,Michigan,7632348,5004318,65.6,4699620,61.6,304698,6.1
16343,September 2002,Minnesota,3832098,2859576,74.6,2734464,71.4,125112,4.4
16344,September 2002,Mississippi,2113865,1286582,60.9,1203301,56.9,83281,6.5
16345,September 2002,Missouri,4318745,3005277,69.6,2846364,65.9,158913,5.3
16346,September 2002,Montana,701723,467897,66.7,447757,63.8,20140,4.3
16347,September 2002,Nebraska,1300847,955159,73.4,920464,70.8,34695,3.6
16348,September 2002,Nevada,1646297,1132117,68.8,1071139,65.1,60978,5.4
16349,September 2002,New Hampshire,983441,703891,71.6,672034,68.3,31857,4.5
16350,September 2002,New Jersey,6546069,4347648,66.4,4095879,62.6,251769,5.8
16351,September 2002,New Mexico,1377134,878421,63.8,829509,60.2,48912,5.6
16352,September 2002,New York,14756250,9301647,63.0,8742256,59.2,559391,6.0
16353,September 2002,North Carolina,6303721,4182598,66.4,3913712,62.1,268886,6.4
16354,September 2002,North Dakota,484841,340697,70.3,327915,67.6,12782,3.8
16355,September 2002,Ohio,8719586,5850869,67.1,5520759,63.3,330110,5.6
16356,September 2002,Oklahoma,2615302,1684008,64.4,1605679,61.4,78329,4.7
16357,September 2002,Oregon,2729478,1839017,67.4,1705455,62.5,133562,7.3
16358,September 2002,Pennsylvania,9570058,6220457,65.0,5874348,61.4,346109,5.6
16359,September 2002,Rhode Island,829724,552472,66.6,524500,63.2,27972,5.1
16360,September 2002,South Carolina,3106205,1956061,63.0,1844379,59.4,111682,5.7
16361,September 2002,South Dakota,572236,418839,73.2,406059,71.0,12780,3.1
16362,September 2002,Tennessee,4454783,2912809,65.4,2773569,62.3,139240,4.8
16363,September 2002,Texas,15840524,10805966,68.2,10113207,63.8,692759,6.4
16364,September 2002,Utah,1662991,1187938,71.4,1117450,67.2,70488,5.9
16365,September 2002,Vermont,484500,344085,71.0,329990,68.1,14095,4.1
16366,September 2002,Virginia,5469003,3745885,68.5,3590376,65.6,155509,4.2
16367,September 2002,Washington,4615349,3098560,67.1,2873179,62.3,225381,7.3
16368,September 2002,West Virginia,1429235,798119,55.8,750526,52.5,47593,6.0
16369,September 2002,Wisconsin,4179843,3030831,72.5,2870188,68.7,160643,5.3
16370,September 2002,Wyoming,380242,269786,71.0,258965,68.1,10821,4.0
16371,October 2002,Alabama,3409782,2111166,61.9,1988843,58.3,122323,5.8
16372,October 2002,Alaska,454550,328400,72.2,303731,66.8,24669,7.5
16373,October 2002,Arizona,4097842,2701144,65.9,2535294,61.9,165850,6.1
16374,October 2002,Arkansas,2057929,1276225,62.0,1207429,58.7,68796,5.4
16375,October 2002,California,25987483,17280269,66.5,16118891,62.0,1161378,6.7
16376,October 2002,Colorado,3421889,2453200,71.7,2315498,67.7,137702,5.6
16377,October 2002,Connecticut,2638916,1785566,67.7,1696458,64.3,89108,5.0
16378,October 2002,Delaware,615913,413954,67.2,397704,64.6,16250,3.9
16379,October 2002,District of Columbia,461700,303946,65.8,284794,61.7,19152,6.3
16380,October 2002,Florida,13072974,8154198,62.4,7710618,59.0,443580,5.4
16381,October 2002,Georgia,6387104,4356954,68.2,4140926,64.8,216028,5.0
16382,October 2002,Hawaii,916970,599081,65.3,576387,62.9,22694,3.8
16383,October 2002,Idaho,993976,686550,69.1,649188,65.3,37362,5.4
16384,October 2002,Illinois,9483893,6310176,66.5,5897923,62.2,412253,6.5
16385,October 2002,Indiana,4667145,3180483,68.1,3022157,64.8,158326,5.0
16386,October 2002,Iowa,2249163,1636245,72.7,1570261,69.8,65984,4.0
16387,October 2002,Kansas,2032959,1421835,69.9,1349535,66.4,72300,5.1
16388,October 2002,Kentucky,3137960,1944067,62.0,1832774,58.4,111293,5.7
16389,October 2002,Louisiana,3315312,2009624,60.6,1885700,56.9,123924,6.2
16390,October 2002,Maine,1019471,677668,66.5,647356,63.5,30312,4.5
16391,October 2002,Maryland,4123542,2870541,69.6,2747136,66.6,123405,4.3
16392,October 2002,Massachusetts,5015587,3441030,68.6,3250955,64.8,190075,5.5
16393,October 2002,Michigan,7637675,5001102,65.5,4694414,61.5,306688,6.1
16394,October 2002,Minnesota,3835796,2859769,74.6,2734542,71.3,125227,4.4
16395,October 2002,Mississippi,2114928,1287446,60.9,1203654,56.9,83792,6.5
16396,October 2002,Missouri,4322412,3005779,69.5,2847205,65.9,158574,5.3
16397,October 2002,Montana,702522,468525,66.7,448189,63.8,20336,4.3
16398,October 2002,Nebraska,1301784,956071,73.4,921205,70.8,34866,3.6
16399,October 2002,Nevada,1651061,1133550,68.7,1073122,65.0,60428,5.3
16400,October 2002,New Hampshire,984675,704229,71.5,672372,68.3,31857,4.5
16401,October 2002,New Jersey,6550397,4347893,66.4,4094103,62.5,253790,5.8
16402,October 2002,New Mexico,1378955,879379,63.8,830417,60.2,48962,5.6
16403,October 2002,New York,14766777,9303119,63.0,8738599,59.2,564520,6.1
16404,October 2002,North Carolina,6311050,4176890,66.2,3907732,61.9,269158,6.4
16405,October 2002,North Dakota,484971,340695,70.3,327867,67.6,12828,3.8
16406,October 2002,Ohio,8724813,5852320,67.1,5519288,63.3,333032,5.7
16407,October 2002,Oklahoma,2617031,1683841,64.3,1603229,61.3,80612,4.8
16408,October 2002,Oregon,2732802,1839921,67.3,1704859,62.4,135062,7.3
16409,October 2002,Pennsylvania,9576039,6214053,64.9,5863923,61.2,350130,5.6
16410,October 2002,Rhode Island,830446,554017,66.7,525583,63.3,28434,5.1
16411,October 2002,South Carolina,3109622,1960701,63.1,1845880,59.4,114821,5.9
16412,October 2002,South Dakota,572718,419389,73.2,406332,70.9,13057,3.1
16413,October 2002,Tennessee,4459606,2912442,65.3,2772378,62.2,140064,4.8
16414,October 2002,Texas,15865366,10817664,68.2,10118977,63.8,698687,6.5
16415,October 2002,Utah,1665919,1189258,71.4,1118631,67.1,70627,5.9
16416,October 2002,Vermont,484964,344284,71.0,329955,68.0,14329,4.2
16417,October 2002,Virginia,5474685,3746262,68.4,3590164,65.6,156098,4.2
16418,October 2002,Washington,4620749,3100168,67.1,2874439,62.2,225729,7.3
16419,October 2002,West Virginia,1429809,796951,55.7,749240,52.4,47711,6.0
16420,October 2002,Wisconsin,4183908,3035451,72.6,2872906,68.7,162545,5.4
16421,October 2002,Wyoming,380549,270353,71.0,259278,68.1,11075,4.1
16422,November 2002,Alabama,3411574,2112361,61.9,1990309,58.3,122052,5.8
16423,November 2002,Alaska,455168,329063,72.3,304232,66.8,24831,7.5
16424,November 2002,Arizona,4107099,2702558,65.8,2537511,61.8,165047,6.1
16425,November 2002,Arkansas,2059408,1275540,61.9,1206046,58.6,69494,5.4
16426,November 2002,California,26017694,17277019,66.4,16108458,61.9,1168561,6.8
16427,November 2002,Colorado,3425994,2454837,71.7,2315602,67.6,139235,5.7
16428,November 2002,Connecticut,2640838,1787059,67.7,1695232,64.2,91827,5.1
16429,November 2002,Delaware,616748,413478,67.0,397047,64.4,16431,4.0
16430,November 2002,District of Columbia,461642,303732,65.8,284309,61.6,19423,6.4
16431,November 2002,Florida,13094247,8155967,62.3,7714237,58.9,441730,5.4
16432,November 2002,Georgia,6397237,4362863,68.2,4145191,64.8,217672,5.0
16433,November 2002,Hawaii,917617,599269,65.3,576882,62.9,22387,3.7
16434,November 2002,Idaho,995570,687433,69.0,649841,65.3,37592,5.5
16435,November 2002,Illinois,9489084,6301525,66.4,5888140,62.1,413385,6.6
16436,November 2002,Indiana,4670256,3177768,68.0,3020076,64.7,157692,5.0
16437,November 2002,Iowa,2249894,1631504,72.5,1564879,69.6,66625,4.1
16438,November 2002,Kansas,2034195,1422902,69.9,1350601,66.4,72301,5.1
16439,November 2002,Kentucky,3140683,1944935,61.9,1831821,58.3,113114,5.8
16440,November 2002,Louisiana,3317084,2011479,60.6,1886143,56.9,125336,6.2
16441,November 2002,Maine,1020485,678485,66.5,647430,63.4,31055,4.6
16442,November 2002,Maryland,4128063,2870874,69.5,2746409,66.5,124465,4.3
16443,November 2002,Massachusetts,5017859,3437467,68.5,3246782,64.7,190685,5.5
16444,November 2002,Michigan,7642325,4999820,65.4,4687557,61.3,312263,6.2
16445,November 2002,Minnesota,3839158,2860212,74.5,2734220,71.2,125992,4.4
16446,November 2002,Mississippi,2115799,1288230,60.9,1203995,56.9,84235,6.5
16447,November 2002,Missouri,4325706,3005665,69.5,2847157,65.8,158508,5.3
16448,November 2002,Montana,703286,469091,66.7,448496,63.8,20595,4.4
16449,November 2002,Nebraska,1302594,957299,73.5,922076,70.8,35223,3.7
16450,November 2002,Nevada,1655768,1135151,68.6,1075102,64.9,60049,5.3
16451,November 2002,New Hampshire,985861,704298,71.4,672568,68.2,31730,4.5
16452,November 2002,New Jersey,6554101,4347103,66.3,4091489,62.4,255614,5.9
16453,November 2002,New Mexico,1380684,880387,63.8,831224,60.2,49163,5.6
16454,November 2002,New York,14776030,9302259,63.0,8730762,59.1,571497,6.1
16455,November 2002,North Carolina,6317959,4169519,66.0,3899422,61.7,270097,6.5
16456,November 2002,North Dakota,485069,340762,70.3,327841,67.6,12921,3.8
16457,November 2002,Ohio,8729243,5856126,67.1,5516855,63.2,339271,5.8
16458,November 2002,Oklahoma,2618501,1683957,64.3,1600789,61.1,83168,4.9
16459,November 2002,Oregon,2735886,1840528,67.3,1703388,62.3,137140,7.5
16460,November 2002,Pennsylvania,9580992,6206032,64.8,5851035,61.1,354997,5.7
16461,November 2002,Rhode Island,831084,555649,66.9,526685,63.4,28964,5.2
16462,November 2002,South Carolina,3112778,1966380,63.2,1847301,59.3,119079,6.1
16463,November 2002,South Dakota,573202,419910,73.3,406519,70.9,13391,3.2
16464,November 2002,Tennessee,4464120,2911713,65.2,2769532,62.0,142181,4.9
16465,November 2002,Texas,15889181,10827973,68.1,10121758,63.7,706215,6.5
16466,November 2002,Utah,1668693,1190304,71.3,1119627,67.1,70677,5.9
16467,November 2002,Vermont,485392,344500,71.0,329915,68.0,14585,4.2
16468,November 2002,Virginia,5479937,3745646,68.4,3588573,65.5,157073,4.2
16469,November 2002,Washington,4625771,3100762,67.0,2874145,62.1,226617,7.3
16470,November 2002,West Virginia,1430234,795582,55.6,747605,52.3,47977,6.0
16471,November 2002,Wisconsin,4187575,3040352,72.6,2875161,68.7,165191,5.4
16472,November 2002,Wyoming,380830,270985,71.2,259585,68.2,11400,4.2
16473,December 2002,Alabama,3412910,2113065,61.9,1991282,58.3,121783,5.8
16474,December 2002,Alaska,455741,329670,72.3,304629,66.8,25041,7.6
16475,December 2002,Arizona,4115824,2703962,65.7,2540225,61.7,163737,6.1
16476,December 2002,Arkansas,2060635,1274165,61.8,1203829,58.4,70336,5.5
16477,December 2002,California,26044606,17271392,66.3,16098315,61.8,1173077,6.8
16478,December 2002,Colorado,3429650,2457271,71.6,2316185,67.5,141086,5.7
16479,December 2002,Connecticut,2642420,1787932,67.7,1694075,64.1,93857,5.2
16480,December 2002,Delaware,617498,413135,66.9,396357,64.2,16778,4.1
16481,December 2002,District of Columbia,461531,303839,65.8,284063,61.5,19776,6.5
16482,December 2002,Florida,13113801,8156648,62.2,7717089,58.8,439559,5.4
16483,December 2002,Georgia,6406507,4367800,68.2,4149298,64.8,218502,5.0
16484,December 2002,Hawaii,918142,599738,65.3,577390,62.9,22348,3.7
16485,December 2002,Idaho,997058,688276,69.0,650398,65.2,37878,5.5
16486,December 2002,Illinois,9493053,6294161,66.3,5879860,61.9,414301,6.6
16487,December 2002,Indiana,4672749,3175462,68.0,3018102,64.6,157360,5.0
16488,December 2002,Iowa,2250292,1626556,72.3,1558949,69.3,67607,4.2
16489,December 2002,Kansas,2035183,1423859,70.0,1351503,66.4,72356,5.1
16490,December 2002,Kentucky,3142981,1946050,61.9,1831222,58.3,114828,5.9
16491,December 2002,Louisiana,3318446,2013265,60.7,1886620,56.9,126645,6.3
16492,December 2002,Maine,1021339,679486,66.5,647558,63.4,31928,4.7
16493,December 2002,Maryland,4132076,2871516,69.5,2745672,66.4,125844,4.4
16494,December 2002,Massachusetts,5019466,3433244,68.4,3242328,64.6,190916,5.6
16495,December 2002,Michigan,7646000,5000840,65.4,4679989,61.2,320851,6.4
16496,December 2002,Minnesota,3842000,2861157,74.5,2733911,71.2,127246,4.4
16497,December 2002,Mississippi,2116412,1288929,60.9,1204547,56.9,84382,6.5
16498,December 2002,Missouri,4328401,3005695,69.4,2846899,65.8,158796,5.3
16499,December 2002,Montana,703932,469565,66.7,448693,63.7,20872,4.4
16500,December 2002,Nebraska,1303218,958774,73.6,923020,70.8,35754,3.7
16501,December 2002,Nevada,1660229,1136723,68.5,1076903,64.9,59820,5.3
16502,December 2002,New Hampshire,986897,704155,71.4,672655,68.2,31500,4.5
16503,December 2002,New Jersey,6556983,4345413,66.3,4088946,62.4,256467,5.9
16504,December 2002,New Mexico,1382249,881427,63.8,831962,60.2,49465,5.6
16505,December 2002,New York,14783425,9298512,62.9,8720863,59.0,577649,6.2
16506,December 2002,North Carolina,6324038,4161214,65.8,3890397,61.5,270817,6.5
16507,December 2002,North Dakota,485090,340891,70.3,327866,67.6,13025,3.8
16508,December 2002,Ohio,8732536,5861630,67.1,5514591,63.1,347039,5.9
16509,December 2002,Oklahoma,2619600,1684087,64.3,1598567,61.0,85520,5.1
16510,December 2002,Oregon,2738585,1841232,67.2,1701484,62.1,139748,7.6
16511,December 2002,Pennsylvania,9584675,6196755,64.7,5837830,60.9,358925,5.8
16512,December 2002,Rhode Island,831611,557216,67.0,527754,63.5,29462,5.3
16513,December 2002,South Carolina,3115568,1972351,63.3,1848753,59.3,123598,6.3
16514,December 2002,South Dakota,573574,420382,73.3,406650,70.9,13732,3.3
16515,December 2002,Tennessee,4468035,2911426,65.2,2766134,61.9,145292,5.0
16516,December 2002,Texas,15910931,10838197,68.1,10124547,63.6,713650,6.6
16517,December 2002,Utah,1671298,1191037,71.3,1120481,67.0,70556,5.9
16518,December 2002,Vermont,485718,344698,71.0,329852,67.9,14846,4.3
16519,December 2002,Virginia,5484530,3744775,68.3,3587049,65.4,157726,4.2
16520,December 2002,Washington,4630181,3100872,67.0,2873195,62.1,227677,7.3
16521,December 2002,West Virginia,1430462,793977,55.5,745706,52.1,48271,6.1
16522,December 2002,Wisconsin,4190712,3045179,72.7,2877039,68.7,168140,5.5
16523,December 2002,Wyoming,381063,271599,71.3,259876,68.2,11723,4.3
16524,January 2003,Alabama,3414396,2113996,61.9,1991914,58.3,122082,5.8
16525,January 2003,Alaska,456362,330227,72.4,304929,66.8,25298,7.7
16526,January 2003,Arizona,4124592,2706655,65.6,2544395,61.7,162260,6.0
16527,January 2003,Arkansas,2061880,1272297,61.7,1201005,58.2,71292,5.6
16528,January 2003,California,26072135,17267788,66.2,16091904,61.7,1175884,6.8
16529,January 2003,Colorado,3433355,2461045,71.7,2317839,67.5,143206,5.8
16530,January 2003,Connecticut,2644003,1788315,67.6,1693095,64.0,95220,5.3
16531,January 2003,Delaware,618270,412960,66.8,395765,64.0,17195,4.2
16532,January 2003,District of Columbia,461472,304290,65.9,284139,61.6,20151,6.6
16533,January 2003,Florida,13133514,8159615,62.1,7721738,58.8,437877,5.4
16534,January 2003,Georgia,6415943,4372800,68.2,4153971,64.7,218829,5.0
16535,January 2003,Hawaii,918710,600369,65.3,577752,62.9,22617,3.8
16536,January 2003,Idaho,998526,689016,69.0,650792,65.2,38224,5.5
16537,January 2003,Illinois,9497119,6289479,66.2,5874230,61.9,415249,6.6
16538,January 2003,Indiana,4675288,3175008,67.9,3017370,64.5,157638,5.0
16539,January 2003,Iowa,2250711,1621909,72.1,1552990,69.0,68919,4.2
16540,January 2003,Kansas,2036212,1425102,70.0,1352395,66.4,72707,5.1
16541,January 2003,Kentucky,3145239,1947893,61.9,1831348,58.2,116545,6.0
16542,January 2003,Louisiana,3319932,2015146,60.7,1887175,56.8,127971,6.4
16543,January 2003,Maine,1022204,680540,66.6,647759,63.4,32781,4.8
16544,January 2003,Maryland,4136125,2872843,69.5,2745486,66.4,127357,4.4
16545,January 2003,Massachusetts,5021081,3429756,68.3,3238418,64.5,191338,5.6
16546,January 2003,Michigan,7649678,5004991,65.4,4673246,61.1,331745,6.6
16547,January 2003,Minnesota,3844875,2863044,74.5,2733890,71.1,129154,4.5
16548,January 2003,Mississippi,2117100,1289885,60.9,1205411,56.9,84474,6.5
16549,January 2003,Missouri,4331112,3007409,69.4,2847349,65.7,160060,5.3
16550,January 2003,Montana,704588,469870,66.7,448740,63.7,21130,4.5
16551,January 2003,Nebraska,1303840,960375,73.7,923966,70.9,36409,3.8
16552,January 2003,Nevada,1664718,1138155,68.4,1078424,64.8,59731,5.2
16553,January 2003,New Hampshire,987888,703949,71.3,672740,68.1,31209,4.4
16554,January 2003,New Jersey,6559876,4343689,66.2,4087213,62.3,256476,5.9
16555,January 2003,New Mexico,1383819,882476,63.8,832661,60.2,49815,5.6
16556,January 2003,New York,14791079,9293854,62.8,8711662,58.9,582192,6.3
16557,January 2003,North Carolina,6330162,4219318,66.7,3947851,62.4,271467,6.4
16558,January 2003,North Dakota,485108,341085,70.3,327976,67.6,13109,3.8
16559,January 2003,Ohio,8735841,5868891,67.2,5513331,63.1,355560,6.1
16560,January 2003,Oklahoma,2620758,1684484,64.3,1596769,60.9,87715,5.2
16561,January 2003,Oregon,2741263,1842582,67.2,1699599,62.0,142983,7.8
16562,January 2003,Pennsylvania,9588389,6187787,64.5,5826808,60.8,360979,5.8
16563,January 2003,Rhode Island,832106,558612,67.1,528753,63.5,29859,5.3
16564,January 2003,South Carolina,3118375,1978143,63.4,1850315,59.3,127828,6.5
16565,January 2003,South Dakota,573953,420793,73.3,406734,70.9,14059,3.3
16566,January 2003,Tennessee,4471905,2912845,65.1,2763321,61.8,149524,5.1
16567,January 2003,Texas,15933096,10851387,68.1,10130205,63.6,721182,6.6
16568,January 2003,Utah,1673900,1191676,71.2,1121384,67.0,70292,5.9
16569,January 2003,Vermont,486043,344855,71.0,329787,67.9,15068,4.4
16570,January 2003,Virginia,5489117,3744855,68.2,3586938,65.3,157917,4.2
16571,January 2003,Washington,4634614,3101612,66.9,2872566,62.0,229046,7.4
16572,January 2003,West Virginia,1430662,792243,55.4,743721,52.0,48522,6.1
16573,January 2003,Wisconsin,4193845,3049845,72.7,2878693,68.6,171152,5.6
16574,January 2003,Wyoming,381254,272143,71.4,260160,68.2,11983,4.4
16575,February 2003,Alabama,3414778,2115588,62.0,1992400,58.3,123188,5.8
16576,February 2003,Alaska,456807,330705,72.4,305141,66.8,25564,7.7
16577,February 2003,Arizona,4132450,2711503,65.6,2550501,61.7,161002,5.9
16578,February 2003,Arkansas,2062580,1270302,61.6,1197968,58.1,72334,5.7
16579,February 2003,California,26094053,17269968,66.2,16091634,61.7,1178334,6.8
16580,February 2003,Colorado,3436189,2466367,71.8,2320944,67.5,145423,5.9
16581,February 2003,Connecticut,2644968,1788459,67.6,1692353,64.0,96106,5.4
16582,February 2003,Delaware,618854,412995,66.7,395407,63.9,17588,4.3
16583,February 2003,District of Columbia,461211,305041,66.1,284527,61.7,20514,6.7
16584,February 2003,Florida,13150127,8167366,62.1,7730209,58.8,437157,5.4
16585,February 2003,Georgia,6423477,4379180,68.2,4159788,64.8,219392,5.0
16586,February 2003,Hawaii,918969,601082,65.4,577895,62.9,23187,3.9
16587,February 2003,Idaho,999754,689569,69.0,650968,65.1,38601,5.6
16588,February 2003,Illinois,9498837,6288923,66.2,5872405,61.8,416518,6.6
16589,February 2003,Indiana,4676608,3177109,67.9,3018046,64.5,159063,5.0
16590,February 2003,Iowa,2250583,1617916,71.9,1547509,68.8,70407,4.4
16591,February 2003,Kansas,2036703,1427021,70.1,1353391,66.5,73630,5.2
16592,February 2003,Kentucky,3146771,1950900,62.0,1832389,58.2,118511,6.1
16593,February 2003,Louisiana,3320353,2017301,60.8,1887707,56.9,129594,6.4
16594,February 2003,Maine,1022832,681480,66.6,648006,63.4,33474,4.9
16595,February 2003,Maryland,4139046,2875336,69.5,2746548,66.4,128788,4.5
16596,February 2003,Massachusetts,5021549,3427888,68.3,3235629,64.4,192259,5.6
16597,February 2003,Michigan,7651421,5012192,65.5,4668636,61.0,343556,6.9
16598,February 2003,Minnesota,3846805,2865861,74.5,2734182,71.1,131679,4.6
16599,February 2003,Mississippi,2117143,1291508,61.0,1206745,57.0,84763,6.6
16600,February 2003,Missouri,4332750,3011671,69.5,2849311,65.8,162360,5.4
16601,February 2003,Montana,705108,469926,66.6,448585,63.6,21341,4.5
16602,February 2003,Nebraska,1304155,961921,73.8,924812,70.9,37109,3.9
16603,February 2003,Nevada,1668826,1139429,68.3,1079696,64.7,59733,5.2
16604,February 2003,New Hampshire,988739,703876,71.2,672934,68.1,30942,4.4
16605,February 2003,New Jersey,6561309,4343392,66.2,4086971,62.3,256421,5.9
16606,February 2003,New Mexico,1385188,883593,63.8,833384,60.2,50209,5.7
16607,February 2003,New York,14795140,9290354,62.8,8705298,58.8,585056,6.3
16608,February 2003,North Carolina,6334657,4247800,67.1,3975441,62.8,272359,6.4
16609,February 2003,North Dakota,485012,341348,70.4,328203,67.7,13145,3.9
16610,February 2003,Ohio,8737003,5877632,67.3,5513570,63.1,364062,6.2
16611,February 2003,Oklahoma,2621249,1685496,64.3,1595626,60.9,89870,5.3
16612,February 2003,Oregon,2743343,1844794,67.2,1698052,61.9,146742,8.0
16613,February 2003,Pennsylvania,9589850,6180722,64.5,5819798,60.7,360924,5.8
16614,February 2003,Rhode Island,832447,559781,67.2,529664,63.6,30117,5.4
16615,February 2003,South Carolina,3120346,1983676,63.6,1852049,59.4,131627,6.6
16616,February 2003,South Dakota,574212,421143,73.3,406801,70.8,14342,3.4
16617,February 2003,Tennessee,4474672,2916421,65.2,2761754,61.7,154667,5.3
16618,February 2003,Texas,15951655,10869345,68.1,10140465,63.6,728880,6.7
16619,February 2003,Utah,1676103,1192445,71.1,1122526,67.0,69919,5.9
16620,February 2003,Vermont,486328,344975,70.9,329764,67.8,15211,4.4
16621,February 2003,Virginia,5492366,3746918,68.2,3589024,65.3,157894,4.2
16622,February 2003,Washington,4637971,3103807,66.9,2873080,61.9,230727,7.4
16623,February 2003,West Virginia,1430582,790657,55.3,741918,51.9,48739,6.2
16624,February 2003,Wisconsin,4195995,3054167,72.8,2880294,68.6,173873,5.7
16625,February 2003,Wyoming,381432,272584,71.5,260454,68.3,12130,4.5
16626,March 2003,Alabama,3415165,2117543,62.0,1992639,58.3,124904,5.9
16627,March 2003,Alaska,457242,331074,72.4,305268,66.8,25806,7.8
16628,March 2003,Arizona,4140103,2718015,65.7,2557872,61.8,160143,5.9
16629,March 2003,Arkansas,2063221,1268529,61.5,1195131,57.9,73398,5.8
16630,March 2003,California,26113712,17276224,66.2,16095216,61.6,1181008,6.8
16631,March 2003,Colorado,3438934,2472593,71.9,2325090,67.6,147503,6.0
16632,March 2003,Connecticut,2645875,1788361,67.6,1691673,63.9,96688,5.4
16633,March 2003,Delaware,619442,413246,66.7,395337,63.8,17909,4.3
16634,March 2003,District of Columbia,460940,305888,66.4,285056,61.8,20832,6.8
16635,March 2003,Florida,13165982,8178441,62.1,7741149,58.8,437292,5.3
16636,March 2003,Georgia,6430745,4386668,68.2,4166278,64.8,220390,5.0
16637,March 2003,Hawaii,919140,601773,65.5,577856,62.9,23917,4.0
16638,March 2003,Idaho,1000990,689879,68.9,650874,65.0,39005,5.7
16639,March 2003,Illinois,9500180,6291947,66.2,5873406,61.8,418541,6.7
16640,March 2003,Indiana,4677936,3181064,68.0,3019116,64.5,161948,5.1
16641,March 2003,Iowa,2250457,1614524,71.7,1542674,68.5,71850,4.5
16642,March 2003,Kansas,2037190,1429546,70.2,1354399,66.5,75147,5.3
16643,March 2003,Kentucky,3148265,1954614,62.1,1834084,58.3,120530,6.2
16644,March 2003,Louisiana,3320700,2019069,60.8,1887539,56.8,131530,6.5
16645,March 2003,Maine,1023474,682201,66.7,648270,63.3,33931,5.0
16646,March 2003,Maryland,4141769,2878943,69.5,2749121,66.4,129822,4.5
16647,March 2003,Massachusetts,5021914,3427308,68.2,3233586,64.4,193722,5.7
16648,March 2003,Michigan,7653059,5020545,65.6,4665883,61.0,354662,7.1
16649,March 2003,Minnesota,3848728,2869236,74.6,2734627,71.1,134609,4.7
16650,March 2003,Mississippi,2117085,1293818,61.1,1208535,57.1,85283,6.6
16651,March 2003,Missouri,4334368,3017672,69.6,2852206,65.8,165466,5.5
16652,March 2003,Montana,705616,469842,66.6,448314,63.5,21528,4.6
16653,March 2003,Nebraska,1304463,963202,73.8,925434,70.9,37768,3.9
16654,March 2003,Nevada,1672836,1140533,68.2,1080817,64.6,59716,5.2
16655,March 2003,New Hampshire,989563,704154,71.2,673371,68.0,30783,4.4
16656,March 2003,New Jersey,6562361,4344759,66.2,4087842,62.3,256917,5.9
16657,March 2003,New Mexico,1386327,884835,63.8,834173,60.2,50662,5.7
16658,March 2003,New York,14798377,9286833,62.8,8700335,58.8,586498,6.3
16659,March 2003,North Carolina,6338920,4261974,67.2,3988250,62.9,273724,6.4
16660,March 2003,North Dakota,484898,341721,70.5,328585,67.8,13136,3.8
16661,March 2003,Ohio,8738069,5885823,67.4,5514512,63.1,371311,6.3
16662,March 2003,Oklahoma,2621697,1686821,64.3,1594997,60.8,91824,5.4
16663,March 2003,Oregon,2745383,1847374,67.3,1696796,61.8,150578,8.2
16664,March 2003,Pennsylvania,9591186,6175525,64.4,5816637,60.6,358888,5.8
16665,March 2003,Rhode Island,832765,560671,67.3,530448,63.7,30223,5.4
16666,March 2003,South Carolina,3122181,1988592,63.7,1853800,59.4,134792,6.8
16667,March 2003,South Dakota,574445,421482,73.4,406913,70.8,14569,3.5
16668,March 2003,Tennessee,4477375,2920770,65.2,2760793,61.7,159977,5.5
16669,March 2003,Texas,15968829,10889972,68.2,10153815,63.6,736157,6.8
16670,March 2003,Utah,1678267,1193437,71.1,1123989,67.0,69448,5.8
16671,March 2003,Vermont,486559,345064,70.9,329834,67.8,15230,4.4
16672,March 2003,Virginia,5495405,3750084,68.2,3592434,65.4,157650,4.2
16673,March 2003,Washington,4641204,3107339,67.0,2874813,61.9,232526,7.5
16674,March 2003,West Virginia,1430480,789369,55.2,740425,51.8,48944,6.2
16675,March 2003,Wisconsin,4198093,3057436,72.8,2881414,68.6,176022,5.8
16676,March 2003,Wyoming,381562,272923,71.5,260769,68.3,12154,4.5
16677,April 2003,Alabama,3415998,2119127,62.0,1992263,58.3,126864,6.0
16678,April 2003,Alaska,457783,331298,72.4,305316,66.7,25982,7.8
16679,April 2003,Arizona,4148283,2724802,65.7,2565008,61.8,159794,5.9
16680,April 2003,Arkansas,2064161,1267127,61.4,1192684,57.8,74443,5.9
16681,April 2003,California,26137633,17280709,66.1,16096131,61.6,1184578,6.9
16682,April 2003,Colorado,3442163,2478382,72.0,2329254,67.7,149128,6.0
16683,April 2003,Connecticut,2647132,1787706,67.5,1690615,63.9,97091,5.4
16684,April 2003,Delaware,620089,413663,66.7,395529,63.8,18134,4.4
16685,April 2003,District of Columbia,460751,306625,66.5,285546,62.0,21079,6.9
16686,April 2003,Florida,13183724,8188639,62.1,7750256,58.8,438383,5.4
16687,April 2003,Georgia,6438979,4393447,68.2,4171881,64.8,221566,5.0
16688,April 2003,Hawaii,919533,602346,65.5,577678,62.8,24668,4.1
16689,April 2003,Idaho,1002322,689908,68.8,650536,64.9,39372,5.7
16690,April 2003,Illinois,9502880,6296745,66.3,5874101,61.8,422644,6.7
16691,April 2003,Indiana,4679781,3185330,68.1,3019237,64.5,166093,5.2
16692,April 2003,Iowa,2250596,1611290,71.6,1538268,68.3,73022,4.5
16693,April 2003,Kansas,2037898,1432257,70.3,1355173,66.5,77084,5.4
16694,April 2003,Kentucky,3150164,1958146,62.2,1835880,58.3,122266,6.2
16695,April 2003,Louisiana,3321512,2019447,60.8,1885891,56.8,133556,6.6
16696,April 2003,Maine,1024226,682688,66.7,648532,63.3,34156,5.0
16697,April 2003,Maryland,4145133,2882676,69.5,2752409,66.4,130267,4.5
16698,April 2003,Massachusetts,5022946,3426893,68.2,3231324,64.3,195569,5.7
16699,April 2003,Michigan,7655628,5027519,65.7,4663278,60.9,364241,7.2
16700,April 2003,Minnesota,3851087,2872705,74.6,2734963,71.0,137742,4.8
16701,April 2003,Mississippi,2117354,1296345,61.2,1210479,57.2,85866,6.6
16702,April 2003,Missouri,4336500,3023438,69.7,2854149,65.8,169289,5.6
16703,April 2003,Montana,706169,469810,66.5,448073,63.5,21737,4.6
16704,April 2003,Nebraska,1304918,964019,73.9,925722,70.9,38297,4.0
16705,April 2003,Nevada,1677090,1141596,68.1,1081905,64.5,59691,5.2
16706,April 2003,New Hampshire,990493,704837,71.2,674088,68.1,30749,4.4
16707,April 2003,New Jersey,6564397,4346427,66.2,4088202,62.3,258225,5.9
16708,April 2003,New Mexico,1387741,886167,63.9,834970,60.2,51197,5.8
16709,April 2003,New York,14803853,9280666,62.7,8692684,58.7,587982,6.3
16710,April 2003,North Carolina,6344047,4267491,67.3,3991752,62.9,275739,6.5
16711,April 2003,North Dakota,484847,342247,70.6,329149,67.9,13098,3.8
16712,April 2003,Ohio,8740208,5890762,67.4,5514017,63.1,376745,6.4
16713,April 2003,Oklahoma,2622439,1687808,64.4,1594356,60.8,93452,5.5
16714,April 2003,Oregon,2747730,1849429,67.3,1695506,61.7,153923,8.3
16715,April 2003,Pennsylvania,9593671,6170798,64.3,5815009,60.6,355789,5.8
16716,April 2003,Rhode Island,833197,561237,67.4,531035,63.7,30202,5.4
16717,April 2003,South Carolina,3124461,1992454,63.8,1855244,59.4,137210,6.9
16718,April 2003,South Dakota,574737,421857,73.4,407105,70.8,14752,3.5
16719,April 2003,Tennessee,4480603,2923532,65.2,2758813,61.6,164719,5.6
16720,April 2003,Texas,15988591,10908563,68.2,10165816,63.6,742747,6.8
16721,April 2003,Utah,1680654,1194659,71.1,1125743,67.0,68916,5.8
16722,April 2003,Vermont,486858,345164,70.9,330007,67.8,15157,4.4
16723,April 2003,Virginia,5499170,3752119,68.2,3594787,65.4,157332,4.2
16724,April 2003,Washington,4645066,3111485,67.0,2877199,61.9,234286,7.5
16725,April 2003,West Virginia,1430568,788278,55.1,739163,51.7,49115,6.2
16726,April 2003,Wisconsin,4200667,3058809,72.8,2881237,68.6,177572,5.8
16727,April 2003,Wyoming,381725,273183,71.6,261110,68.4,12073,4.4
16728,May 2003,Alabama,3417808,2119791,62.0,1991145,58.3,128646,6.1
16729,May 2003,Alaska,458416,331375,72.3,305309,66.6,26066,7.9
16730,May 2003,Arizona,4157421,2730641,65.7,2570767,61.8,159874,5.9
16731,May 2003,Arkansas,2065680,1266331,61.3,1190875,57.7,75456,6.0
16732,May 2003,California,26166389,17279492,66.0,16090153,61.5,1189339,6.9
16733,May 2003,Colorado,3446297,2482778,72.0,2332650,67.7,150128,6.0
16734,May 2003,Connecticut,2649006,1786375,67.4,1688997,63.8,97378,5.5
16735,May 2003,Delaware,620936,414178,66.7,395937,63.8,18241,4.4
16736,May 2003,District of Columbia,460691,307161,66.7,285923,62.1,21238,6.9
16737,May 2003,Florida,13204215,8194829,62.1,7754900,58.7,439929,5.4
16738,May 2003,Georgia,6449263,4397884,68.2,4175462,64.7,222422,5.1
16739,May 2003,Hawaii,920043,602759,65.5,577434,62.8,25325,4.2
16740,May 2003,Idaho,1003977,689685,68.7,650064,64.7,39621,5.7
16741,May 2003,Illinois,9508070,6300774,66.3,5872002,61.8,428772,6.8
16742,May 2003,Indiana,4683141,3188522,68.1,3017724,64.4,170798,5.4
16743,May 2003,Iowa,2251443,1607949,71.4,1534169,68.1,73780,4.6
16744,May 2003,Kansas,2039274,1434670,70.4,1355600,66.5,79070,5.5
16745,May 2003,Kentucky,3153011,1960829,62.2,1837287,58.3,123542,6.3
16746,May 2003,Louisiana,3323414,2018192,60.7,1883009,56.7,135183,6.7
16747,May 2003,Maine,1025280,683021,66.6,648785,63.3,34236,5.0
16748,May 2003,Maryland,4149472,2885496,69.5,2755322,66.4,130174,4.5
16749,May 2003,Massachusetts,5025332,3425589,68.2,3228105,64.2,197484,5.8
16750,May 2003,Michigan,7660435,5031626,65.7,4659505,60.8,372121,7.4
16751,May 2003,Minnesota,3854699,2875787,74.6,2734940,71.0,140847,4.9
16752,May 2003,Mississippi,2118291,1298743,61.3,1212508,57.2,86235,6.6
16753,May 2003,Missouri,4339886,3027131,69.8,2853732,65.8,173399,5.7
16754,May 2003,Montana,706947,469968,66.5,448007,63.4,21961,4.7
16755,May 2003,Nebraska,1305813,964367,73.9,925724,70.9,38643,4.0
16756,May 2003,Nevada,1681640,1142807,68.0,1083136,64.4,59671,5.2
16757,May 2003,New Hampshire,991693,705831,71.2,675038,68.1,30793,4.4
16758,May 2003,New Jersey,6567824,4347226,66.2,4087151,62.2,260075,6.0
16759,May 2003,New Mexico,1389410,887562,63.9,835756,60.2,51806,5.8
16760,May 2003,New York,14812779,9270558,62.6,8679734,58.6,590824,6.4
16761,May 2003,North Carolina,6350918,4266797,67.2,3988632,62.8,278165,6.5
16762,May 2003,North Dakota,484999,342940,70.7,329917,68.0,13023,3.8
16763,May 2003,Ohio,8744855,5890398,67.4,5510621,63.0,379777,6.4
16764,May 2003,Oklahoma,2623999,1687980,64.3,1593339,60.7,94641,5.6
16765,May 2003,Oregon,2750824,1850178,67.3,1694048,61.6,156130,8.4
16766,May 2003,Pennsylvania,9598714,6165799,64.2,5812918,60.6,352881,5.7
16767,May 2003,Rhode Island,833861,561506,67.3,531392,63.7,30114,5.4
16768,May 2003,South Carolina,3127605,1995281,63.8,1856287,59.4,138994,7.0
16769,May 2003,South Dakota,575272,422263,73.4,407362,70.8,14901,3.5
16770,May 2003,Tennessee,4485189,2922956,65.2,2754535,61.4,168421,5.8
16771,May 2003,Texas,16012098,10920925,68.2,10172696,63.5,748229,6.9
16772,May 2003,Utah,1683758,1196044,71.0,1127693,67.0,68351,5.7
16773,May 2003,Vermont,487311,345319,70.9,330266,67.8,15053,4.4
16774,May 2003,Virginia,5504445,3751647,68.2,3594486,65.3,157161,4.2
16775,May 2003,Washington,4650109,3115544,67.0,2879829,61.9,235715,7.6
16776,May 2003,West Virginia,1431022,787222,55.0,738053,51.6,49169,6.2
16777,May 2003,Wisconsin,4204541,3057988,72.7,2879437,68.5,178551,5.8
16778,May 2003,Wyoming,382030,273393,71.6,261481,68.4,11912,4.4
16779,June 2003,Alabama,3419291,2119995,62.0,1989915,58.2,130080,6.1
16780,June 2003,Alaska,459028,331390,72.2,305306,66.5,26084,7.9
16781,June 2003,Arizona,4166328,2735343,65.7,2575435,61.8,159908,5.8
16782,June 2003,Arkansas,2066999,1266588,61.3,1190192,57.6,76396,6.0
16783,June 2003,California,26194176,17275282,66.0,16081216,61.4,1194066,6.9
16784,June 2003,Colorado,3450142,2486126,72.1,2335569,67.7,150557,6.1
16785,June 2003,Connecticut,2650723,1784799,67.3,1687216,63.7,97583,5.5
16786,June 2003,Delaware,621700,414747,66.7,396520,63.8,18227,4.4
16787,June 2003,District of Columbia,460582,307468,66.8,286157,62.1,21311,6.9
16788,June 2003,Florida,13224481,8199016,62.0,7758422,58.7,440594,5.4
16789,June 2003,Georgia,6458596,4400093,68.1,4177974,64.7,222119,5.0
16790,June 2003,Hawaii,920534,603062,65.5,577261,62.7,25801,4.3
16791,June 2003,Idaho,1005541,689355,68.6,649685,64.6,39670,5.8
16792,June 2003,Illinois,9512364,6303462,66.3,5868213,61.7,435249,6.9
16793,June 2003,Indiana,4685927,3190180,68.1,3015384,64.3,174796,5.5
16794,June 2003,Iowa,2252059,1604754,71.3,1530705,68.0,74049,4.6
16795,June 2003,Kansas,2040395,1436616,70.4,1355950,66.5,80666,5.6
16796,June 2003,Kentucky,3155471,1962696,62.2,1838406,58.3,124290,6.3
16797,June 2003,Louisiana,3324821,2016488,60.6,1880670,56.6,135818,6.7
16798,June 2003,Maine,1026241,683365,66.6,649108,63.3,34257,5.0
16799,June 2003,Maryland,4153573,2886894,69.5,2757340,66.4,129554,4.5
16800,June 2003,Massachusetts,5027336,3423464,68.1,3224416,64.1,199048,5.8
16801,June 2003,Michigan,7664493,5033495,65.7,4655925,60.7,377570,7.5
16802,June 2003,Minnesota,3857860,2878188,74.6,2734622,70.9,143566,5.0
16803,June 2003,Mississippi,2118933,1301099,61.4,1215116,57.3,85983,6.6
16804,June 2003,Missouri,4342876,3028413,69.7,2851600,65.7,176813,5.8
16805,June 2003,Montana,707670,470395,66.5,448215,63.3,22180,4.7
16806,June 2003,Nebraska,1306572,964462,73.8,925664,70.8,38798,4.0
16807,June 2003,Nevada,1686175,1144375,67.9,1084786,64.3,59589,5.2
16808,June 2003,New Hampshire,992830,707029,71.2,676190,68.1,30839,4.4
16809,June 2003,New Jersey,6570999,4347355,66.2,4085923,62.2,261432,6.0
16810,June 2003,New Mexico,1391050,889058,63.9,836635,60.1,52423,5.9
16811,June 2003,New York,14820704,9259338,62.5,8664420,58.5,594918,6.4
16812,June 2003,North Carolina,6357263,4263077,67.1,3982850,62.7,280227,6.6
16813,June 2003,North Dakota,485054,343812,70.9,330893,68.2,12919,3.8
16814,June 2003,Ohio,8748623,5885246,67.3,5505579,62.9,379667,6.5
16815,June 2003,Oklahoma,2625260,1687512,64.3,1592208,60.6,95304,5.6
16816,June 2003,Oregon,2753736,1849561,67.2,1692884,61.5,156677,8.5
16817,June 2003,Pennsylvania,9603140,6161723,64.2,5811005,60.5,350718,5.7
16818,June 2003,Rhode Island,834450,561544,67.3,531532,63.7,30012,5.3
16819,June 2003,South Carolina,3130457,1997576,63.8,1857285,59.3,140291,7.0
16820,June 2003,South Dakota,575696,422703,73.4,407688,70.8,15015,3.6
16821,June 2003,Tennessee,4489233,2919695,65.0,2748670,61.2,171025,5.9
16822,June 2003,Texas,16034567,10927376,68.1,10176027,63.5,751349,6.9
16823,June 2003,Utah,1686441,1197664,71.0,1129861,67.0,67803,5.7
16824,June 2003,Vermont,487704,345549,70.9,330605,67.8,14944,4.3
16825,June 2003,Virginia,5509213,3749944,68.1,3593008,65.2,156936,4.2
16826,June 2003,Washington,4654799,3119942,67.0,2883519,61.9,236423,7.6
16827,June 2003,West Virginia,1431374,786192,54.9,737209,51.5,48983,6.2
16828,June 2003,Wisconsin,4208041,3055818,72.6,2876984,68.4,178834,5.9
16829,June 2003,Wyoming,382297,273596,71.6,261886,68.5,11710,4.3
16830,July 2003,Alabama,3421104,2120069,62.0,1989307,58.1,130762,6.2
16831,July 2003,Alaska,459663,331444,72.1,305369,66.4,26075,7.9
16832,July 2003,Arizona,4175564,2739185,65.6,2579886,61.8,159299,5.8
16833,July 2003,Arkansas,2068537,1267955,61.3,1190870,57.6,77085,6.1
16834,July 2003,California,26223362,17270200,65.9,16075435,61.3,1194765,6.9
16835,July 2003,Colorado,3454238,2488974,72.1,2338527,67.7,150447,6.0
16836,July 2003,Connecticut,2652706,1783360,67.2,1685753,63.5,97607,5.5
16837,July 2003,Delaware,622538,415326,66.7,397213,63.8,18113,4.4
16838,July 2003,District of Columbia,460525,307485,66.8,286196,62.1,21289,6.9
16839,July 2003,Florida,13245749,8203690,61.9,7765419,58.6,438271,5.3
16840,July 2003,Georgia,6468625,4400261,68.0,4180971,64.6,219290,5.0
16841,July 2003,Hawaii,921097,603338,65.5,577300,62.7,26038,4.3
16842,July 2003,Idaho,1007178,689161,68.4,649682,64.5,39479,5.7
16843,July 2003,Illinois,9517498,6304691,66.2,5865120,61.6,439571,7.0
16844,July 2003,Indiana,4689150,3190012,68.0,3013169,64.3,176843,5.5
16845,July 2003,Iowa,2252879,1602116,71.1,1528240,67.8,73876,4.6
16846,July 2003,Kansas,2041713,1438234,70.4,1356550,66.4,81684,5.7
16847,July 2003,Kentucky,3158261,1963845,62.2,1839598,58.2,124247,6.3
16848,July 2003,Louisiana,3326586,2015428,60.6,1880553,56.5,134875,6.7
16849,July 2003,Maine,1027304,683813,66.6,649549,63.2,34264,5.0
16850,July 2003,Maryland,4157985,2886767,69.4,2758316,66.3,128451,4.4
16851,July 2003,Massachusetts,5029743,3420932,68.0,3221182,64.0,199750,5.8
16852,July 2003,Michigan,7669272,5033568,65.6,4654471,60.7,379097,7.5
16853,July 2003,Minnesota,3861413,2879556,74.6,2734165,70.8,145391,5.0
16854,July 2003,Mississippi,2119791,1303338,61.5,1218581,57.5,84757,6.5
16855,July 2003,Missouri,4346246,3027432,69.7,2849182,65.6,178250,5.9
16856,July 2003,Montana,708447,471045,66.5,448671,63.3,22374,4.7
16857,July 2003,Nebraska,1307432,964497,73.8,925766,70.8,38731,4.0
16858,July 2003,Nevada,1690819,1146384,67.8,1087120,64.3,59264,5.2
16859,July 2003,New Hampshire,994050,708250,71.2,677452,68.2,30798,4.3
16860,July 2003,New Jersey,6574720,4347002,66.1,4086056,62.1,260946,6.0
16861,July 2003,New Mexico,1392778,890581,63.9,837648,60.1,52933,5.9
16862,July 2003,New York,14829815,9249134,62.4,8651128,58.3,598006,6.5
16863,July 2003,North Carolina,6364186,4258539,66.9,3978332,62.5,280207,6.6
16864,July 2003,North Dakota,485165,344812,71.1,332011,68.4,12801,3.7
16865,July 2003,Ohio,8753223,5876773,67.1,5500780,62.8,375993,6.4
16866,July 2003,Oklahoma,2626741,1686532,64.2,1591292,60.6,95240,5.6
16867,July 2003,Oregon,2756849,1847906,67.0,1692585,61.4,155321,8.4
16868,July 2003,Pennsylvania,9608391,6159270,64.1,5810829,60.5,348441,5.7
16869,July 2003,Rhode Island,835116,561403,67.2,531478,63.6,29925,5.3
16870,July 2003,South Carolina,3133584,1999864,63.8,1858697,59.3,141167,7.1
16871,July 2003,South Dakota,576199,423183,73.4,408074,70.8,15109,3.6
16872,July 2003,Tennessee,4493757,2914910,64.9,2742697,61.0,172213,5.9
16873,July 2003,Texas,16058127,10929180,68.1,10179526,63.4,749654,6.9
16874,July 2003,Utah,1689284,1199599,71.0,1132323,67.0,67276,5.6
16875,July 2003,Vermont,488147,345872,70.9,331028,67.8,14844,4.3
16876,July 2003,Virginia,5514506,3748699,68.0,3592613,65.1,156086,4.2
16877,July 2003,Washington,4659866,3125318,67.1,2889337,62.0,235981,7.6
16878,July 2003,West Virginia,1431856,785219,54.8,736763,51.5,48456,6.2
16879,July 2003,Wisconsin,4211892,3053412,72.5,2875251,68.3,178161,5.8
16880,July 2003,Wyoming,382570,273801,71.6,262292,68.6,11509,4.2
16881,August 2003,Alabama,3423238,2120356,61.9,1989749,58.1,130607,6.2
16882,August 2003,Alaska,460685,331621,72.0,305560,66.3,26061,7.9
16883,August 2003,Arizona,4186779,2742787,65.5,2584935,61.7,157852,5.8
16884,August 2003,Arkansas,2070283,1270195,61.4,1192795,57.6,77400,6.1
16885,August 2003,California,26250052,17266429,65.8,16077283,61.2,1189146,6.9
16886,August 2003,Colorado,3457413,2491681,72.1,2341808,67.7,149873,6.0
16887,August 2003,Connecticut,2654002,1782190,67.2,1684848,63.5,97342,5.5
16888,August 2003,Delaware,623435,415875,66.7,397952,63.8,17923,4.3
16889,August 2003,District of Columbia,460781,307229,66.7,286046,62.1,21183,6.9
16890,August 2003,Florida,13274309,8210648,61.9,7778726,58.6,431922,5.3
16891,August 2003,Georgia,6479064,4399081,67.9,4185343,64.6,213738,4.9
16892,August 2003,Hawaii,922997,603616,65.4,577613,62.6,26003,4.3
16893,August 2003,Idaho,1008996,689253,68.3,650156,64.4,39097,5.7
16894,August 2003,Illinois,9521732,6304389,66.2,5864487,61.6,439902,7.0
16895,August 2003,Indiana,4691592,3188102,68.0,3011488,64.2,176614,5.5
16896,August 2003,Iowa,2253922,1600295,71.0,1526925,67.7,73370,4.6
16897,August 2003,Kansas,2042694,1439694,70.5,1357605,66.5,82089,5.7
16898,August 2003,Kentucky,3159839,1964326,62.2,1841115,58.3,123211,6.3
16899,August 2003,Louisiana,3327995,2015555,60.6,1883143,56.6,132412,6.6
16900,August 2003,Maine,1028102,684314,66.6,650050,63.2,34264,5.0
16901,August 2003,Maryland,4162588,2885537,69.3,2758321,66.3,127216,4.4
16902,August 2003,Massachusetts,5031325,3418611,67.9,3219215,64.0,199396,5.8
16903,August 2003,Michigan,7673132,5032418,65.6,4656277,60.7,376141,7.5
16904,August 2003,Minnesota,3864387,2879792,74.5,2733711,70.7,146081,5.1
16905,August 2003,Mississippi,2121239,1305236,61.5,1222647,57.6,82589,6.3
16906,August 2003,Missouri,4349981,3024684,69.5,2847559,65.5,177125,5.9
16907,August 2003,Montana,709324,471825,66.5,449274,63.3,22551,4.8
16908,August 2003,Nebraska,1308155,964602,73.7,926132,70.8,38470,4.0
16909,August 2003,Nevada,1696711,1148805,67.7,1090215,64.3,58590,5.1
16910,August 2003,New Hampshire,995280,709300,71.3,678655,68.2,30645,4.3
16911,August 2003,New Jersey,6577806,4346536,66.1,4088342,62.2,258194,5.9
16912,August 2003,New Mexico,1394674,892002,64.0,838755,60.1,53247,6.0
16913,August 2003,New York,14838943,9241539,62.3,8642814,58.2,598725,6.5
16914,August 2003,North Carolina,6371972,4254726,66.8,3977455,62.4,277271,6.5
16915,August 2003,North Dakota,485599,345864,71.2,333173,68.6,12691,3.7
16916,August 2003,Ohio,8756563,5867030,67.0,5497217,62.8,369813,6.3
16917,August 2003,Oklahoma,2627866,1685163,64.1,1590778,60.5,94385,5.6
16918,August 2003,Oregon,2759073,1845741,66.9,1693156,61.4,152585,8.3
16919,August 2003,Pennsylvania,9612804,6158859,64.1,5813315,60.5,345544,5.6
16920,August 2003,Rhode Island,835417,561088,67.2,531236,63.6,29852,5.3
16921,August 2003,South Carolina,3137616,2002175,63.8,1860712,59.3,141463,7.1
16922,August 2003,South Dakota,576819,423672,73.4,408484,70.8,15188,3.6
16923,August 2003,Tennessee,4497989,2909478,64.7,2737804,60.9,171674,5.9
16924,August 2003,Texas,16081863,10928430,68.0,10186025,63.3,742405,6.8
16925,August 2003,Utah,1692910,1201861,71.0,1135066,67.0,66795,5.6
16926,August 2003,Vermont,488487,346266,70.9,331500,67.9,14766,4.3
16927,August 2003,Virginia,5523829,3749007,67.9,3594516,65.1,154491,4.1
16928,August 2003,Washington,4667040,3131806,67.1,2897394,62.1,234412,7.5
16929,August 2003,West Virginia,1432039,784381,54.8,736752,51.4,47629,6.1
16930,August 2003,Wisconsin,4215263,3051445,72.4,2875058,68.2,176387,5.8
16931,August 2003,Wyoming,382889,274004,71.6,262656,68.6,11348,4.1
16932,September 2003,Alabama,3425643,2121165,61.9,1991337,58.1,129828,6.1
16933,September 2003,Alaska,461755,331944,71.9,305897,66.2,26047,7.8
16934,September 2003,Arizona,4198248,2746888,65.4,2591254,61.7,155634,5.7
16935,September 2003,Arkansas,2072182,1272976,61.4,1195674,57.7,77302,6.1
16936,September 2003,California,26278279,17266654,65.7,16089822,61.2,1176832,6.8
16937,September 2003,Colorado,3460845,2494740,72.1,2345751,67.8,148989,6.0
16938,September 2003,Connecticut,2655410,1781226,67.1,1684497,63.4,96729,5.4
16939,September 2003,Delaware,624382,416390,66.7,398743,63.9,17647,4.2
16940,September 2003,District of Columbia,461084,306855,66.6,285820,62.0,21035,6.9
16941,September 2003,Florida,13303522,8222068,61.8,7799924,58.6,422144,5.1
16942,September 2003,Georgia,6490033,4397857,67.8,4191488,64.6,206369,4.7
16943,September 2003,Hawaii,924992,603867,65.3,578192,62.5,25675,4.3
16944,September 2003,Idaho,1010917,689674,68.2,651071,64.4,38603,5.6
16945,September 2003,Illinois,9526623,6302881,66.2,5867671,61.6,435210,6.9
16946,September 2003,Indiana,4694387,3184605,67.8,3010332,64.1,174273,5.5
16947,September 2003,Iowa,2255124,1599388,70.9,1526741,67.7,72647,4.5
16948,September 2003,Kansas,2043838,1441221,70.5,1359230,66.5,81991,5.7
16949,September 2003,Kentucky,3161670,1964224,62.1,1843047,58.3,121177,6.2
16950,September 2003,Louisiana,3329678,2016744,60.6,1887858,56.7,128886,6.4
16951,September 2003,Maine,1028984,684763,66.5,650552,63.2,34211,5.0
16952,September 2003,Maryland,4167436,2883901,69.2,2757747,66.2,126154,4.4
16953,September 2003,Massachusetts,5033162,3417109,67.9,3219119,64.0,197990,5.8
16954,September 2003,Michigan,7677527,5030998,65.5,4661812,60.7,369186,7.3
16955,September 2003,Minnesota,3867659,2878962,74.4,2733410,70.7,145552,5.1
16956,September 2003,Mississippi,2122873,1306671,61.6,1226817,57.8,79854,6.1
16957,September 2003,Missouri,4354009,3021376,69.4,2847476,65.4,173900,5.8
16958,September 2003,Montana,710264,472648,66.5,449909,63.3,22739,4.8
16959,September 2003,Nebraska,1308971,964837,73.7,926710,70.8,38127,4.0
16960,September 2003,Nevada,1702703,1151496,67.6,1093892,64.2,57604,5.0
16961,September 2003,New Hampshire,996559,710085,71.3,679646,68.2,30439,4.3
16962,September 2003,New Jersey,6581184,4346504,66.0,4093080,62.2,253424,5.8
16963,September 2003,New Mexico,1396642,893221,64.0,839924,60.1,53297,6.0
16964,September 2003,New York,14849020,9238227,62.2,8641565,58.2,596662,6.5
16965,September 2003,North Carolina,6380170,4252898,66.7,3981122,62.4,271776,6.4
16966,September 2003,North Dakota,486079,346861,71.4,334276,68.8,12585,3.6
16967,September 2003,Ohio,8760450,5858109,66.9,5495466,62.7,362643,6.2
16968,September 2003,Oklahoma,2629174,1683821,64.0,1590894,60.5,92927,5.5
16969,September 2003,Oregon,2761466,1843551,66.8,1694219,61.4,149332,8.1
16970,September 2003,Pennsylvania,9617686,6160901,64.1,5818649,60.5,342252,5.6
16971,September 2003,Rhode Island,835777,560606,67.1,530841,63.5,29765,5.3
16972,September 2003,South Carolina,3141881,2003938,63.8,1863178,59.3,140760,7.0
16973,September 2003,South Dakota,577473,424131,73.4,408902,70.8,15229,3.6
16974,September 2003,Tennessee,4502551,2904169,64.5,2734995,60.7,169174,5.8
16975,September 2003,Texas,16106743,10927537,67.8,10197642,63.3,729895,6.7
16976,September 2003,Utah,1696697,1204373,71.0,1138031,67.1,66342,5.5
16977,September 2003,Vermont,488848,346659,70.9,331960,67.9,14699,4.2
16978,September 2003,Virginia,5533516,3751599,67.8,3599230,65.0,152369,4.1
16979,September 2003,Washington,4674477,3139115,67.2,2907208,62.2,231907,7.4
16980,September 2003,West Virginia,1432316,783806,54.7,737172,51.5,46634,5.9
16981,September 2003,Wisconsin,4218887,3050177,72.3,2876652,68.2,173525,5.7
16982,September 2003,Wyoming,383278,274194,71.5,262950,68.6,11244,4.1
16983,October 2003,Alabama,3428231,2122748,61.9,1993817,58.2,128931,6.1
16984,October 2003,Alaska,462857,332377,71.8,306344,66.2,26033,7.8
16985,October 2003,Arizona,4209900,2752011,65.4,2599010,61.7,153001,5.6
16986,October 2003,Arkansas,2074201,1276052,61.5,1199113,57.8,76939,6.0
16987,October 2003,California,26307573,17273942,65.7,16112386,61.2,1161556,6.7
16988,October 2003,Colorado,3464444,2498563,72.1,2350510,67.8,148053,5.9
16989,October 2003,Connecticut,2656933,1780341,67.0,1684525,63.4,95816,5.4
16990,October 2003,Delaware,625360,416900,66.7,399623,63.9,17277,4.1
16991,October 2003,District of Columbia,461420,306560,66.4,285641,61.9,20919,6.8
16992,October 2003,Florida,13333328,8239638,61.8,7828094,58.7,411544,5.0
16993,October 2003,Georgia,6501406,4398065,67.6,4199034,64.6,199031,4.5
16994,October 2003,Hawaii,926990,604147,65.2,578984,62.5,25163,4.2
16995,October 2003,Idaho,1012861,690432,68.2,652339,64.4,38093,5.5
16996,October 2003,Illinois,9532034,6301623,66.1,5874607,61.6,427016,6.8
16997,October 2003,Indiana,4697419,3180237,67.7,3009312,64.1,170925,5.4
16998,October 2003,Iowa,2256451,1599339,70.9,1527396,67.7,71943,4.5
16999,October 2003,Kansas,2045110,1443177,70.6,1361434,66.6,81743,5.7
17000,October 2003,Kentucky,3163657,1963845,62.1,1845250,58.3,118595,6.0
17001,October 2003,Louisiana,3331606,2018740,60.6,1893630,56.8,125110,6.2
17002,October 2003,Maine,1029897,685078,66.5,650988,63.2,34090,5.0
17003,October 2003,Maryland,4172517,2882647,69.1,2757235,66.1,125412,4.4
17004,October 2003,Massachusetts,5035257,3416646,67.9,3220795,64.0,195851,5.7
17005,October 2003,Michigan,7682318,5031172,65.5,4670315,60.8,360857,7.2
17006,October 2003,Minnesota,3871115,2877796,74.3,2733303,70.6,144493,5.0
17007,October 2003,Mississippi,2124659,1307683,61.5,1230538,57.9,77145,5.9
17008,October 2003,Missouri,4358264,3018992,69.3,2849005,65.4,169987,5.6
17009,October 2003,Montana,711223,473412,66.6,450470,63.3,22942,4.8
17010,October 2003,Nebraska,1309858,965264,73.7,927414,70.8,37850,3.9
17011,October 2003,Nevada,1708723,1154237,67.5,1097776,64.2,56461,4.9
17012,October 2003,New Hampshire,997925,710643,71.2,680406,68.2,30237,4.3
17013,October 2003,New Jersey,6584855,4347632,66.0,4100087,62.3,247545,5.7
17014,October 2003,New Mexico,1398628,894283,63.9,841152,60.1,53131,5.9
17015,October 2003,New York,14859731,9241024,62.2,8647113,58.2,593911,6.4
17016,October 2003,North Carolina,6388744,4253678,66.6,3988507,62.4,265171,6.2
17017,October 2003,North Dakota,486567,347736,71.5,335244,68.9,12492,3.6
17018,October 2003,Ohio,8764783,5852437,66.8,5495800,62.7,356637,6.1
17019,October 2003,Oklahoma,2630617,1683046,64.0,1591757,60.5,91289,5.4
17020,October 2003,Oregon,2763994,1841925,66.6,1695400,61.3,146525,8.0
17021,October 2003,Pennsylvania,9623058,6165771,64.1,5826303,60.5,339468,5.5
17022,October 2003,Rhode Island,836175,560010,67.0,530372,63.4,29638,5.3
17023,October 2003,South Carolina,3146336,2005443,63.7,1865851,59.3,139592,7.0
17024,October 2003,South Dakota,578164,424549,73.4,409290,70.8,15259,3.6
17025,October 2003,Tennessee,4507358,2899868,64.3,2734523,60.7,165345,5.7
17026,October 2003,Texas,16132392,10929415,67.7,10214308,63.3,715107,6.5
17027,October 2003,Utah,1700614,1207095,71.0,1141147,67.1,65948,5.5
17028,October 2003,Vermont,489284,346979,70.9,332373,67.9,14606,4.2
17029,October 2003,Virginia,5543519,3756702,67.8,3606279,65.1,150423,4.0
17030,October 2003,Washington,4682139,3147087,67.2,2918195,62.3,228892,7.3
17031,October 2003,West Virginia,1432643,783582,54.7,737925,51.5,45657,5.8
17032,October 2003,Wisconsin,4222784,3049704,72.2,2879535,68.2,170169,5.6
17033,October 2003,Wyoming,383660,274366,71.5,263168,68.6,11198,4.1
17034,November 2003,Alabama,3430170,2125012,62.0,1996704,58.2,128308,6.0
17035,November 2003,Alaska,463911,332872,71.8,306863,66.1,26009,7.8
17036,November 2003,Arizona,4220869,2758026,65.3,2607421,61.8,150605,5.5
17037,November 2003,Arkansas,2075835,1279152,61.6,1202674,57.9,76478,6.0
17038,November 2003,California,26333470,17288156,65.7,16140095,61.3,1148061,6.6
17039,November 2003,Colorado,3467548,2503021,72.2,2355855,67.9,147166,5.9
17040,November 2003,Connecticut,2658035,1779369,66.9,1684637,63.4,94732,5.3
17041,November 2003,Delaware,626250,417437,66.7,400575,64.0,16862,4.0
17042,November 2003,District of Columbia,461683,306511,66.4,285576,61.9,20935,6.8
17043,November 2003,Florida,13360573,8262814,61.8,7859796,58.8,403018,4.9
17044,November 2003,Georgia,6511724,4400220,67.6,4206813,64.6,193407,4.4
17045,November 2003,Hawaii,928979,604518,65.1,579947,62.4,24571,4.1
17046,November 2003,Idaho,1014648,691400,68.1,653828,64.4,37572,5.4
17047,November 2003,Illinois,9535761,6301537,66.1,5883474,61.7,418063,6.6
17048,November 2003,Indiana,4699675,3175902,67.6,3007958,64.0,167944,5.3
17049,November 2003,Iowa,2257338,1599692,70.9,1528351,67.7,71341,4.5
17050,November 2003,Kansas,2045976,1445708,70.7,1364109,66.7,81599,5.6
17051,November 2003,Kentucky,3165112,1963497,62.0,1847383,58.4,116114,5.9
17052,November 2003,Louisiana,3332888,2021183,60.6,1899139,57.0,122044,6.0
17053,November 2003,Maine,1030670,685183,66.5,651312,63.2,33871,4.9
17054,November 2003,Maryland,4176911,2882180,69.0,2757137,66.0,125043,4.3
17055,November 2003,Massachusetts,5036488,3416608,67.8,3223359,64.0,193249,5.7
17056,November 2003,Michigan,7685770,5033577,65.5,4680059,60.9,353518,7.0
17057,November 2003,Minnesota,3873956,2876833,74.3,2733535,70.6,143298,5.0
17058,November 2003,Mississippi,2126027,1308311,61.5,1233368,58.0,74943,5.7
17059,November 2003,Missouri,4361784,3017926,69.2,2851100,65.4,166826,5.5
17060,November 2003,Montana,712076,474108,66.6,450986,63.3,23122,4.9
17061,November 2003,Nebraska,1310533,965811,73.7,928126,70.8,37685,3.9
17062,November 2003,Nevada,1714576,1156918,67.5,1101585,64.2,55333,4.8
17063,November 2003,New Hampshire,999106,711071,71.2,681060,68.2,30011,4.2
17064,November 2003,New Jersey,6587425,4350045,66.0,4108209,62.4,241836,5.6
17065,November 2003,New Mexico,1400456,895281,63.9,842444,60.2,52837,5.9
17066,November 2003,New York,14867953,9249302,62.2,8656815,58.2,592487,6.4
17067,November 2003,North Carolina,6396279,4256145,66.5,3997214,62.5,258931,6.1
17068,November 2003,North Dakota,486950,348453,71.6,336054,69.0,12399,3.6
17069,November 2003,Ohio,8767557,5851069,66.7,5497368,62.7,353701,6.0
17070,November 2003,Oklahoma,2631551,1683118,64.0,1593250,60.5,89868,5.3
17071,November 2003,Oregon,2766049,1841081,66.6,1696494,61.3,144587,7.9
17072,November 2003,Pennsylvania,9626595,6172730,64.1,5834804,60.6,337926,5.5
17073,November 2003,Rhode Island,836406,559399,66.9,529867,63.4,29532,5.3
17074,November 2003,South Carolina,3150256,2007179,63.7,1868608,59.3,138571,6.9
17075,November 2003,South Dakota,578780,424927,73.4,409639,70.8,15288,3.6
17076,November 2003,Tennessee,4511411,2896642,64.2,2735493,60.6,161149,5.6
17077,November 2003,Texas,16155874,10935047,67.7,10233481,63.3,701566,6.4
17078,November 2003,Utah,1704232,1209932,71.0,1144316,67.1,65616,5.4
17079,November 2003,Vermont,489616,347200,70.9,332749,68.0,14451,4.2
17080,November 2003,Virginia,5552661,3763255,67.8,3614066,65.1,149189,4.0
17081,November 2003,Washington,4689061,3155406,67.3,2929714,62.5,225692,7.2
17082,November 2003,West Virginia,1432738,783674,54.7,738795,51.6,44879,5.7
17083,November 2003,Wisconsin,4225924,3049523,72.2,2882645,68.2,166878,5.5
17084,November 2003,Wyoming,383993,274515,71.5,263340,68.6,11175,4.1
17085,December 2003,Alabama,3431807,2127526,62.0,1999528,58.3,127998,6.0
17086,December 2003,Alaska,464858,333334,71.7,307391,66.1,25943,7.8
17087,December 2003,Arizona,4231303,2764152,65.3,2615350,61.8,148802,5.4
17088,December 2003,Arkansas,2077275,1282026,61.7,1205994,58.1,76032,5.9
17089,December 2003,California,26356013,17305161,65.7,16166912,61.3,1138249,6.6
17090,December 2003,Colorado,3470280,2507691,72.3,2361417,68.0,146274,5.8
17091,December 2003,Connecticut,2658866,1778195,66.9,1684571,63.4,93624,5.3
17092,December 2003,Delaware,627048,418002,66.7,401502,64.0,16500,3.9
17093,December 2003,District of Columbia,461880,306767,66.4,285626,61.8,21141,6.9
17094,December 2003,Florida,13386234,8288783,61.9,7890962,58.9,397821,4.8
17095,December 2003,Georgia,6521486,4403876,67.5,4213511,64.6,190365,4.3
17096,December 2003,Hawaii,930848,605037,65.0,581071,62.4,23966,4.0
17097,December 2003,Idaho,1016340,692442,68.1,655442,64.5,37000,5.3
17098,December 2003,Illinois,9538602,6302761,66.1,5892125,61.8,410636,6.5
17099,December 2003,Indiana,4701502,3172180,67.5,3005983,63.9,166197,5.2
17100,December 2003,Iowa,2258018,1599882,70.9,1529016,67.7,70866,4.4
17101,December 2003,Kansas,2046639,1448737,70.8,1367078,66.8,81659,5.6
17102,December 2003,Kentucky,3166269,1963181,62.0,1849124,58.4,114057,5.8
17103,December 2003,Louisiana,3333925,2023461,60.7,1903167,57.1,120294,5.9
17104,December 2003,Maine,1031313,685052,66.4,651548,63.2,33504,4.9
17105,December 2003,Maryland,4180924,2882415,68.9,2757498,66.0,124917,4.3
17106,December 2003,Massachusetts,5037233,3415940,67.8,3225628,64.0,190312,5.6
17107,December 2003,Michigan,7688514,5037226,65.5,4689115,61.0,348111,6.9
17108,December 2003,Minnesota,3876409,2876224,74.2,2734333,70.5,141891,4.9
17109,December 2003,Mississippi,2127213,1308677,61.5,1235108,58.1,73569,5.6
17110,December 2003,Missouri,4364893,3017361,69.1,2852266,65.3,165095,5.5
17111,December 2003,Montana,712868,474797,66.6,451549,63.3,23248,4.9
17112,December 2003,Nebraska,1311049,966352,73.7,928747,70.8,37605,3.9
17113,December 2003,Nevada,1720218,1159493,67.4,1105163,64.2,54330,4.7
17114,December 2003,New Hampshire,1000208,711527,71.1,681793,68.2,29734,4.2
17115,December 2003,New Jersey,6589269,4352819,66.1,4115943,62.5,236876,5.4
17116,December 2003,New Mexico,1402078,896274,63.9,843796,60.2,52478,5.9
17117,December 2003,New York,14874654,9258922,62.2,8667235,58.3,591687,6.4
17118,December 2003,North Carolina,6403189,4258027,66.5,4004406,62.5,253621,6.0
17119,December 2003,North Dakota,487309,349035,71.6,336743,69.1,12292,3.5
17120,December 2003,Ohio,8769517,5852948,66.7,5498770,62.7,354178,6.1
17121,December 2003,Oklahoma,2632214,1683709,64.0,1595096,60.6,88613,5.3
17122,December 2003,Oregon,2767811,1840807,66.5,1697498,61.3,143309,7.8
17123,December 2003,Pennsylvania,9629193,6179886,64.2,5842472,60.7,337414,5.5
17124,December 2003,Rhode Island,836582,558887,66.8,529371,63.3,29516,5.3
17125,December 2003,South Carolina,3153880,2009350,63.7,1871428,59.3,137922,6.9
17126,December 2003,South Dakota,579294,425291,73.4,409985,70.8,15306,3.6
17127,December 2003,Tennessee,4515018,2893575,64.1,2736564,60.6,157011,5.4
17128,December 2003,Texas,16177465,10943081,67.6,10252239,63.4,690842,6.3
17129,December 2003,Utah,1707689,1212795,71.0,1147489,67.2,65306,5.4
17130,December 2003,Vermont,489876,347334,70.9,333111,68.0,14223,4.1
17131,December 2003,Virginia,5561272,3769524,67.8,3620788,65.1,148736,3.9
17132,December 2003,Washington,4695514,3163439,67.4,2941117,62.6,222322,7.0
17133,December 2003,West Virginia,1432701,783990,54.7,739632,51.6,44358,5.7
17134,December 2003,Wisconsin,4228696,3048933,72.1,2884905,68.2,164028,5.4
17135,December 2003,Wyoming,384284,274618,71.5,263491,68.6,11127,4.1
17136,January 2004,Alabama,3433085,2129625,62.0,2001919,58.3,127706,6.0
17137,January 2004,Alaska,465863,333696,71.6,307855,66.1,25841,7.7
17138,January 2004,Arizona,4241467,2769453,65.3,2621906,61.8,147547,5.3
17139,January 2004,Arkansas,2078485,1284503,61.8,1208819,58.2,75684,5.9
17140,January 2004,California,26377278,17319513,65.7,16187910,61.4,1131603,6.5
17141,January 2004,Colorado,3472675,2512112,72.3,2366858,68.2,145254,5.8
17142,January 2004,Connecticut,2659392,1776744,66.8,1684167,63.3,92577,5.2
17143,January 2004,Delaware,627838,418565,66.7,402299,64.1,16266,3.9
17144,January 2004,District of Columbia,462058,307268,66.5,285731,61.8,21537,7.0
17145,January 2004,Florida,13410688,8313878,62.0,7918181,59.0,395697,4.8
17146,January 2004,Georgia,6530444,4408195,67.5,4218080,64.6,190115,4.3
17147,January 2004,Hawaii,932670,605696,64.9,582339,62.4,23357,3.9
17148,January 2004,Idaho,1017947,693480,68.1,657072,64.5,36408,5.3
17149,January 2004,Illinois,9540419,6304014,66.1,5898884,61.8,405130,6.4
17150,January 2004,Indiana,4702738,3168939,67.4,3003260,63.9,165679,5.2
17151,January 2004,Iowa,2258410,1599527,70.8,1528941,67.7,70586,4.4
17152,January 2004,Kansas,2047136,1451920,70.9,1370093,66.9,81827,5.6
17153,January 2004,Kentucky,3167008,1962620,62.0,1850209,58.4,112411,5.7
17154,January 2004,Louisiana,3334560,2024945,60.7,1905078,57.1,119867,5.9
17155,January 2004,Maine,1031825,684777,66.4,651769,63.2,33008,4.8
17156,January 2004,Maryland,4184452,2882808,68.9,2758113,65.9,124695,4.3
17157,January 2004,Massachusetts,5037389,3413878,67.8,3226627,64.1,187251,5.5
17158,January 2004,Michigan,7690309,5040628,65.5,4695510,61.1,345118,6.8
17159,January 2004,Minnesota,3878373,2876103,74.2,2735760,70.5,140343,4.9
17160,January 2004,Mississippi,2128150,1308848,61.5,1235780,58.1,73068,5.6
17161,January 2004,Missouri,4367411,3016161,69.1,2851363,65.3,164798,5.5
17162,January 2004,Montana,713535,475622,66.7,452309,63.4,23313,4.9
17163,January 2004,Nebraska,1311438,966815,73.7,929255,70.9,37560,3.9
17164,January 2004,Nevada,1725746,1161915,67.3,1108416,64.2,53499,4.6
17165,January 2004,New Hampshire,1001162,712113,71.1,682717,68.2,29396,4.1
17166,January 2004,New Jersey,6590483,4354721,66.1,4122215,62.5,232506,5.3
17167,January 2004,New Mexico,1403653,897210,63.9,845141,60.2,52069,5.8
17168,January 2004,New York,14879992,9265169,62.3,8675101,58.3,590068,6.4
17169,January 2004,North Carolina,6409345,4257391,66.4,4007892,62.5,249499,5.9
17170,January 2004,North Dakota,487597,349528,71.7,337355,69.2,12173,3.5
17171,January 2004,Ohio,8770391,5855677,66.8,5498972,62.7,356705,6.1
17172,January 2004,Oklahoma,2632625,1684353,64.0,1596953,60.7,87400,5.2
17173,January 2004,Oregon,2769240,1840722,66.5,1698415,61.3,142307,7.7
17174,January 2004,Pennsylvania,9630651,6185537,64.2,5847896,60.7,337641,5.5
17175,January 2004,Rhode Island,836662,558505,66.8,528935,63.2,29570,5.3
17176,January 2004,South Carolina,3157110,2012030,63.7,1874377,59.4,137653,6.8
17177,January 2004,South Dakota,579745,425695,73.4,410362,70.8,15333,3.6
17178,January 2004,Tennessee,4518034,2889585,64.0,2736564,60.6,153021,5.3
17179,January 2004,Texas,16197933,10950759,67.6,10268166,63.4,682593,6.2
17180,January 2004,Utah,1710973,1215641,71.0,1150676,67.3,64965,5.3
17181,January 2004,Vermont,490092,347409,70.9,333462,68.0,13947,4.0
17182,January 2004,Virginia,5569244,3773898,67.8,3625113,65.1,148785,3.9
17183,January 2004,Washington,4701428,3170613,67.4,2951918,62.8,218695,6.9
17184,January 2004,West Virginia,1432410,784374,54.8,740319,51.7,44055,5.6
17185,January 2004,Wisconsin,4230892,3047380,72.0,2885631,68.2,161749,5.3
17186,January 2004,Wyoming,384501,274667,71.4,263639,68.6,11028,4.0
17187,February 2004,Alabama,3434233,2131120,62.1,2003968,58.4,127152,6.0
17188,February 2004,Alaska,466768,333984,71.6,308281,66.0,25703,7.7
17189,February 2004,Arizona,4251399,2773830,65.2,2627080,61.8,146750,5.3
17190,February 2004,Arkansas,2079612,1286687,61.9,1211220,58.2,75467,5.9
17191,February 2004,California,26397491,17329769,65.6,16203029,61.4,1126740,6.5
17192,February 2004,Colorado,3475004,2516021,72.4,2372053,68.3,143968,5.7
17193,February 2004,Connecticut,2659831,1775160,66.7,1683538,63.3,91622,5.2
17194,February 2004,Delaware,628564,419090,66.7,402910,64.1,16180,3.9
17195,February 2004,District of Columbia,462206,307862,66.6,285787,61.8,22075,7.2
17196,February 2004,Florida,13434633,8336963,62.1,7941115,59.1,395848,4.7
17197,February 2004,Georgia,6539377,4412858,67.5,4220651,64.5,192207,4.4
17198,February 2004,Hawaii,934399,606451,64.9,583735,62.5,22716,3.7
17199,February 2004,Idaho,1019480,694528,68.1,658704,64.6,35824,5.2
17200,February 2004,Illinois,9542153,6304636,66.1,5903488,61.9,401148,6.4
17201,February 2004,Indiana,4703907,3166416,67.3,3000488,63.8,165928,5.2
17202,February 2004,Iowa,2258753,1598650,70.8,1528182,67.7,70468,4.4
17203,February 2004,Kansas,2047513,1454846,71.1,1373050,67.1,81796,5.6
17204,February 2004,Kentucky,3167748,1961822,61.9,1850734,58.4,111088,5.7
17205,February 2004,Louisiana,3335103,2025792,60.7,1905386,57.1,120406,5.9
17206,February 2004,Maine,1032322,684474,66.3,652072,63.2,32402,4.7
17207,February 2004,Maryland,4187889,2882912,68.8,2758714,65.9,124198,4.3
17208,February 2004,Massachusetts,5037486,3410511,67.7,3226114,64.0,184397,5.4
17209,February 2004,Michigan,7691969,5043354,65.6,4698603,61.1,344751,6.8
17210,February 2004,Minnesota,3880315,2876495,74.1,2737735,70.6,138760,4.8
17211,February 2004,Mississippi,2129087,1308977,61.5,1235624,58.0,73353,5.6
17212,February 2004,Missouri,4369873,3014413,69.0,2848329,65.2,166084,5.5
17213,February 2004,Montana,714239,476694,66.7,453384,63.5,23310,4.9
17214,February 2004,Nebraska,1311808,967206,73.7,929732,70.9,37474,3.9
17215,February 2004,Nevada,1731208,1164273,67.3,1111447,64.2,52826,4.5
17216,February 2004,New Hampshire,1002156,712823,71.1,683852,68.2,28971,4.1
17217,February 2004,New Jersey,6591547,4355270,66.1,4126794,62.6,228476,5.2
17218,February 2004,New Mexico,1405164,897987,63.9,846430,60.2,51557,5.7
17219,February 2004,New York,14884942,9266727,62.3,8680024,58.3,586703,6.3
17220,February 2004,North Carolina,6415409,4254295,66.3,4008079,62.5,246216,5.8
17221,February 2004,North Dakota,487884,350021,71.7,337971,69.3,12050,3.4
17222,February 2004,Ohio,8771140,5857797,66.8,5498166,62.7,359631,6.1
17223,February 2004,Oklahoma,2632965,1685009,64.0,1598751,60.7,86258,5.1
17224,February 2004,Oregon,2770623,1840477,66.4,1699336,61.3,141141,7.7
17225,February 2004,Pennsylvania,9631959,6189628,64.3,5851363,60.7,338265,5.5
17226,February 2004,Rhode Island,836738,558268,66.7,528628,63.2,29640,5.3
17227,February 2004,South Carolina,3160345,2015284,63.8,1877626,59.4,137658,6.8
17228,February 2004,South Dakota,580227,426136,73.4,410752,70.8,15384,3.6
17229,February 2004,Tennessee,4521058,2884568,63.8,2735166,60.5,149402,5.2
17230,February 2004,Texas,16218019,10956841,67.6,10280897,63.4,675944,6.2
17231,February 2004,Utah,1714254,1218505,71.1,1153970,67.3,64535,5.3
17232,February 2004,Vermont,490317,347463,70.9,333814,68.1,13649,3.9
17233,February 2004,Virginia,5577107,3776127,67.7,3627246,65.0,148881,3.9
17234,February 2004,Washington,4707256,3176643,67.5,2961872,62.9,214771,6.8
17235,February 2004,West Virginia,1432212,784621,54.8,740804,51.7,43817,5.6
17236,February 2004,Wisconsin,4233063,3044894,71.9,2885035,68.2,159859,5.3
17237,February 2004,Wyoming,384777,274680,71.4,263807,68.6,10873,4.0
17238,March 2004,Alabama,3435850,2132602,62.1,2006189,58.4,126413,5.9
17239,March 2004,Alaska,467758,334264,71.5,308736,66.0,25528,7.6
17240,March 2004,Arizona,4261812,2778150,65.2,2631906,61.8,146244,5.3
17241,March 2004,Arkansas,2081054,1288975,61.9,1213612,58.3,75363,5.8
17242,March 2004,California,26419460,17340226,65.6,16217583,61.4,1122643,6.5
17243,March 2004,Colorado,3477768,2519769,72.5,2377329,68.4,142440,5.7
17244,March 2004,Connecticut,2660629,1773913,66.7,1683092,63.3,90821,5.1
17245,March 2004,Delaware,629366,419552,66.7,403334,64.1,16218,3.9
17246,March 2004,District of Columbia,462410,308490,66.7,285781,61.8,22709,7.4
17247,March 2004,Florida,13459929,8359733,62.1,7962806,59.2,396927,4.7
17248,March 2004,Georgia,6549133,4419149,67.5,4222682,64.5,196467,4.4
17249,March 2004,Hawaii,936221,607309,64.9,585242,62.5,22067,3.6
17250,March 2004,Idaho,1021205,695712,68.1,660443,64.7,35269,5.1
17251,March 2004,Illinois,9544949,6306165,66.1,5907621,61.9,398544,6.3
17252,March 2004,Indiana,4705775,3165167,67.3,2998676,63.7,166491,5.3
17253,March 2004,Iowa,2259439,1597848,70.7,1527314,67.6,70534,4.4
17254,March 2004,Kansas,2048199,1457541,71.2,1376043,67.2,81498,5.6
17255,March 2004,Kentucky,3168939,1961388,61.9,1851217,58.4,110171,5.6
17256,March 2004,Louisiana,3336134,2026582,60.7,1905322,57.1,121260,6.0
17257,March 2004,Maine,1032983,684286,66.2,652511,63.2,31775,4.6
17258,March 2004,Maryland,4191851,2882968,68.8,2759339,65.8,123629,4.3
17259,March 2004,Massachusetts,5038294,3406829,67.6,3224744,64.0,182085,5.3
17260,March 2004,Michigan,7694720,5046704,65.6,4699794,61.1,346910,6.9
17261,March 2004,Minnesota,3882829,2877616,74.1,2740027,70.6,137589,4.8
17262,March 2004,Mississippi,2130299,1309523,61.5,1235042,58.0,74481,5.7
17263,March 2004,Missouri,4373001,3013464,68.9,2844442,65.0,169022,5.6
17264,March 2004,Montana,715014,477930,66.8,454682,63.6,23248,4.9
17265,March 2004,Nebraska,1312336,967635,73.7,930319,70.9,37316,3.9
17266,March 2004,Nevada,1736796,1166711,67.2,1114443,64.2,52268,4.5
17267,March 2004,New Hampshire,1003256,713609,71.1,685149,68.3,28460,4.0
17268,March 2004,New Jersey,6593331,4355081,66.1,4130310,62.6,224771,5.2
17269,March 2004,New Mexico,1406749,898642,63.9,847689,60.3,50953,5.7
17270,March 2004,New York,14891508,9300272,62.5,8718791,58.5,581481,6.3
17271,March 2004,North Carolina,6422329,4251116,66.2,4007676,62.4,243440,5.7
17272,March 2004,North Dakota,488277,350585,71.8,338650,69.4,11935,3.4
17273,March 2004,Ohio,8773158,5859871,66.8,5497601,62.7,362270,6.2
17274,March 2004,Oklahoma,2633657,1685869,64.0,1600735,60.8,85134,5.0
17275,March 2004,Oregon,2772385,1840126,66.4,1700408,61.3,139718,7.6
17276,March 2004,Pennsylvania,9634546,6193880,64.3,5854656,60.8,339224,5.5
17277,March 2004,Rhode Island,836899,558201,66.7,528524,63.2,29677,5.3
17278,March 2004,South Carolina,3163948,2019359,63.8,1881314,59.5,138045,6.8
17279,March 2004,South Dakota,580762,426554,73.4,411086,70.8,15468,3.6
17280,March 2004,Tennessee,4524708,2880058,63.7,2733190,60.4,146868,5.1
17281,March 2004,Texas,16239300,10963502,67.5,10293104,63.4,670398,6.1
17282,March 2004,Utah,1717784,1221480,71.1,1157443,67.4,64037,5.2
17283,March 2004,Vermont,490608,347547,70.8,334188,68.1,13359,3.8
17284,March 2004,Virginia,5585695,3777894,67.6,3628971,65.0,148923,3.9
17285,March 2004,Washington,4713701,3181869,67.5,2971118,63.0,210751,6.6
17286,March 2004,West Virginia,1432187,784708,54.8,741189,51.8,43519,5.5
17287,March 2004,Wisconsin,4235849,3042478,71.8,2884266,68.1,158212,5.2
17288,March 2004,Wyoming,385078,274692,71.3,264013,68.6,10679,3.9
17289,April 2004,Alabama,3437710,2134257,62.1,2008779,58.4,125478,5.9
17290,April 2004,Alaska,468813,334612,71.4,309271,66.0,25341,7.6
17291,April 2004,Arizona,4272474,2782704,65.1,2637249,61.7,145455,5.2
17292,April 2004,Arkansas,2082594,1291543,62.0,1216328,58.4,75215,5.8
17293,April 2004,California,26443652,17351609,65.6,16235525,61.4,1116084,6.4
17294,April 2004,Colorado,3480753,2523730,72.5,2382989,68.5,140741,5.6
17295,April 2004,Connecticut,2661640,1773222,66.6,1683146,63.2,90076,5.1
17296,April 2004,Delaware,630222,419943,66.6,403589,64.0,16354,3.9
17297,April 2004,District of Columbia,462669,309151,66.8,285770,61.8,23381,7.6
17298,April 2004,Florida,13486273,8382022,62.2,7985075,59.2,396947,4.7
17299,April 2004,Georgia,6559211,4427119,67.5,4225202,64.4,201917,4.6
17300,April 2004,Hawaii,938135,608217,64.8,586795,62.5,21422,3.5
17301,April 2004,Idaho,1022949,697137,68.1,662301,64.7,34836,5.0
17302,April 2004,Illinois,9548361,6308393,66.1,5912566,61.9,395827,6.3
17303,April 2004,Indiana,4707896,3164871,67.2,2998069,63.7,166802,5.3
17304,April 2004,Iowa,2260263,1597615,70.7,1526791,67.5,70824,4.4
17305,April 2004,Kansas,2048978,1460154,71.3,1379127,67.3,81027,5.5
17306,April 2004,Kentucky,3170338,1961428,61.9,1852045,58.4,109383,5.6
17307,April 2004,Louisiana,3337310,2027412,60.7,1905767,57.1,121645,6.0
17308,April 2004,Maine,1033682,684313,66.2,653061,63.2,31252,4.6
17309,April 2004,Maryland,4196057,2883319,68.7,2760251,65.8,123068,4.3
17310,April 2004,Massachusetts,5039418,3403225,67.5,3223084,64.0,180141,5.3
17311,April 2004,Michigan,7697912,5050503,65.6,4700593,61.1,349910,6.9
17312,April 2004,Minnesota,3885547,2879285,74.1,2742219,70.6,137066,4.8
17313,April 2004,Mississippi,2131602,1310693,61.5,1234402,57.9,76291,5.8
17314,April 2004,Missouri,4376314,3013728,68.9,2840895,64.9,172833,5.7
17315,April 2004,Montana,715828,479150,66.9,455996,63.7,23154,4.8
17316,April 2004,Nebraska,1312946,968220,73.7,931086,70.9,37134,3.8
17317,April 2004,Nevada,1742523,1169253,67.1,1117518,64.1,51735,4.4
17318,April 2004,New Hampshire,1004434,714409,71.1,686519,68.3,27890,3.9
17319,April 2004,New Jersey,6595619,4354340,66.0,4133357,62.7,220983,5.1
17320,April 2004,New Mexico,1408466,899209,63.8,848882,60.3,50327,5.6
17321,April 2004,New York,14899208,9326798,62.6,8753347,58.8,573451,6.1
17322,April 2004,North Carolina,6429598,4248981,66.1,4008767,62.3,240214,5.7
17323,April 2004,North Dakota,488649,351211,71.9,339357,69.4,11854,3.4
17324,April 2004,Ohio,8775765,5861725,66.8,5497962,62.6,363763,6.2
17325,April 2004,Oklahoma,2634528,1686847,64.0,1602965,60.8,83882,5.0
17326,April 2004,Oregon,2774282,1839668,66.3,1701600,61.3,138068,7.5
17327,April 2004,Pennsylvania,9637810,6198772,64.3,5858899,60.8,339873,5.5
17328,April 2004,Rhode Island,837134,558260,66.7,528636,63.1,29624,5.3
17329,April 2004,South Carolina,3167741,2024051,63.9,1885358,59.5,138693,6.9
17330,April 2004,South Dakota,581297,426930,73.4,411348,70.8,15582,3.6
17331,April 2004,Tennessee,4528589,2877062,63.5,2731196,60.3,145866,5.1
17332,April 2004,Texas,16261719,10970651,67.5,10306589,63.4,664062,6.1
17333,April 2004,Utah,1721363,1224487,71.1,1161029,67.4,63458,5.2
17334,April 2004,Vermont,490939,347677,70.8,334587,68.2,13090,3.8
17335,April 2004,Virginia,5594632,3780248,67.6,3631701,64.9,148547,3.9
17336,April 2004,Washington,4720436,3186388,67.5,2979770,63.1,206618,6.5
17337,April 2004,West Virginia,1432210,784598,54.8,741554,51.8,43044,5.5
17338,April 2004,Wisconsin,4238868,3040553,71.7,2884057,68.0,156496,5.1
17339,April 2004,Wyoming,385368,274718,71.3,264225,68.6,10493,3.8
17340,May 2004,Alabama,3439685,2136041,62.1,2011549,58.5,124492,5.8
17341,May 2004,Alaska,469843,335111,71.3,309933,66.0,25178,7.5
17342,May 2004,Arizona,4283321,2787519,65.1,2643477,61.7,144042,5.2
17343,May 2004,Arkansas,2084280,1294356,62.1,1219465,58.5,74891,5.8
17344,May 2004,California,26467780,17363161,65.6,16258110,61.4,1105051,6.4
17345,May 2004,Colorado,3483817,2527941,72.6,2388897,68.6,139044,5.5
17346,May 2004,Connecticut,2662777,1772961,66.6,1683717,63.2,89244,5.0
17347,May 2004,Delaware,631130,420270,66.6,403708,64.0,16562,3.9
17348,May 2004,District of Columbia,462896,309857,66.9,285809,61.7,24048,7.8
17349,May 2004,Florida,13513490,8403495,62.2,8008005,59.3,395490,4.7
17350,May 2004,Georgia,6569512,4435924,67.5,4228692,64.4,207232,4.7
17351,May 2004,Hawaii,940006,609115,64.8,588293,62.6,20822,3.4
17352,May 2004,Idaho,1024783,698840,68.2,664233,64.8,34607,5.0
17353,May 2004,Illinois,9552159,6311094,66.1,5918546,62.0,392548,6.2
17354,May 2004,Indiana,4710339,3165030,67.2,2998256,63.7,166774,5.3
17355,May 2004,Iowa,2261286,1598044,70.7,1526718,67.5,71326,4.5
17356,May 2004,Kansas,2049973,1462691,71.4,1382211,67.4,80480,5.5
17357,May 2004,Kentucky,3171919,1961756,61.8,1853412,58.4,108344,5.5
17358,May 2004,Louisiana,3338628,2028459,60.8,1907175,57.1,121284,6.0
17359,May 2004,Maine,1034531,684555,66.2,653632,63.2,30923,4.5
17360,May 2004,Maryland,4200421,2884234,68.7,2761741,65.7,122493,4.2
17361,May 2004,Massachusetts,5040822,3399734,67.4,3221451,63.9,178283,5.2
17362,May 2004,Michigan,7701567,5054199,65.6,4701967,61.1,352232,7.0
17363,May 2004,Minnesota,3888600,2881116,74.1,2744084,70.6,137032,4.8
17364,May 2004,Mississippi,2132985,1312274,61.5,1233777,57.8,78497,6.0
17365,May 2004,Missouri,4380004,3014844,68.8,2838238,64.8,176606,5.9
17366,May 2004,Montana,716704,480202,67.0,457123,63.8,23079,4.8
17367,May 2004,Nebraska,1313691,968978,73.8,931977,70.9,37001,3.8
17368,May 2004,Nevada,1748307,1171940,67.0,1120794,64.1,51146,4.4
17369,May 2004,New Hampshire,1005683,715206,71.1,687897,68.4,27309,3.8
17370,May 2004,New Jersey,6598180,4352853,66.0,4135977,62.7,216876,5.0
17371,May 2004,New Mexico,1410153,899758,63.8,850029,60.3,49729,5.5
17372,May 2004,New York,14907325,9347739,62.7,8785278,58.9,562461,6.0
17373,May 2004,North Carolina,6437190,4247776,66.0,4011835,62.3,235941,5.6
17374,May 2004,North Dakota,489089,351874,71.9,340031,69.5,11843,3.4
17375,May 2004,Ohio,8778817,5863606,66.8,5499224,62.6,364382,6.2
17376,May 2004,Oklahoma,2635506,1687835,64.0,1605309,60.9,82526,4.9
17377,May 2004,Oregon,2776406,1839064,66.2,1702683,61.3,136381,7.4
17378,May 2004,Pennsylvania,9641784,6204156,64.3,5864412,60.8,339744,5.5
17379,May 2004,Rhode Island,837437,558372,66.7,528937,63.2,29435,5.3
17380,May 2004,South Carolina,3171656,2028750,64.0,1889526,59.6,139224,6.9
17381,May 2004,South Dakota,581963,427303,73.4,411580,70.7,15723,3.7
17382,May 2004,Tennessee,4532727,2875786,63.4,2729307,60.2,146479,5.1
17383,May 2004,Texas,16284426,10977679,67.4,10321473,63.4,656206,6.0
17384,May 2004,Utah,1725073,1227403,71.2,1164603,67.5,62800,5.1
17385,May 2004,Vermont,491303,347828,70.8,334988,68.2,12840,3.7
17386,May 2004,Virginia,5603790,3783514,67.5,3636081,64.9,147433,3.9
17387,May 2004,Washington,4727430,3190326,67.5,2987740,63.2,202586,6.4
17388,May 2004,West Virginia,1432387,784293,54.8,741918,51.8,42375,5.4
17389,May 2004,Wisconsin,4242228,3038981,71.6,2884298,68.0,154683,5.1
17390,May 2004,Wyoming,385715,274754,71.2,264384,68.5,10370,3.8
17391,June 2004,Alabama,3441786,2137625,62.1,2014209,58.5,123416,5.8
17392,June 2004,Alaska,470883,335789,71.3,310734,66.0,25055,7.5
17393,June 2004,Arizona,4294298,2792608,65.0,2650540,61.7,142068,5.1
17394,June 2004,Arkansas,2086030,1297320,62.2,1222953,58.6,74367,5.7
17395,June 2004,California,26492860,17374274,65.6,16284558,61.5,1089716,6.3
17396,June 2004,Colorado,3487031,2532150,72.6,2394597,68.7,137553,5.4
17397,June 2004,Connecticut,2663930,1772845,66.5,1684619,63.2,88226,5.0
17398,June 2004,Delaware,632012,420531,66.5,403738,63.9,16793,4.0
17399,June 2004,District of Columbia,463124,310711,67.1,286047,61.8,24664,7.9
17400,June 2004,Florida,13540882,8424546,62.2,8031532,59.3,393014,4.7
17401,June 2004,Georgia,6579965,4444805,67.6,4233261,64.3,211544,4.8
17402,June 2004,Hawaii,941951,610046,64.8,589692,62.6,20354,3.3
17403,June 2004,Idaho,1026647,700795,68.3,666236,64.9,34559,4.9
17404,June 2004,Illinois,9556128,6314871,66.1,5925329,62.0,389542,6.2
17405,June 2004,Indiana,4712898,3165341,67.2,2998500,63.6,166841,5.3
17406,June 2004,Iowa,2262389,1599039,70.7,1527030,67.5,72009,4.5
17407,June 2004,Kansas,2050940,1465020,71.4,1385056,67.5,79964,5.5
17408,June 2004,Kentucky,3173568,1962208,61.8,1855351,58.5,106857,5.4
17409,June 2004,Louisiana,3340023,2030498,60.8,1909920,57.2,120578,5.9
17410,June 2004,Maine,1035353,684992,66.2,654152,63.2,30840,4.5
17411,June 2004,Maryland,4204763,2885801,68.6,2763821,65.7,121980,4.2
17412,June 2004,Massachusetts,5042398,3396303,67.4,3220075,63.9,176228,5.2
17413,June 2004,Michigan,7705357,5058178,65.6,4704218,61.1,353960,7.0
17414,June 2004,Minnesota,3891730,2882707,74.1,2745591,70.5,137116,4.8
17415,June 2004,Mississippi,2134430,1313807,61.6,1233026,57.8,80781,6.1
17416,June 2004,Missouri,4383735,3016228,68.8,2836545,64.7,179683,6.0
17417,June 2004,Montana,717613,480975,67.0,457943,63.8,23032,4.8
17418,June 2004,Nebraska,1314476,969816,73.8,932846,71.0,36970,3.8
17419,June 2004,Nevada,1754092,1174855,67.0,1124342,64.1,50513,4.3
17420,June 2004,New Hampshire,1006948,715945,71.1,689171,68.4,26774,3.7
17421,June 2004,New Jersey,6600783,4350727,65.9,4138128,62.7,212599,4.9
17422,June 2004,New Mexico,1411967,900409,63.8,851215,60.3,49194,5.5
17423,June 2004,New York,14915696,9363865,62.8,8814864,59.1,549001,5.9
17424,June 2004,North Carolina,6444911,4246815,65.9,4016012,62.3,230803,5.4
17425,June 2004,North Dakota,489541,352515,72.0,340628,69.6,11887,3.4
17426,June 2004,Ohio,8782026,5866416,66.8,5501001,62.6,365415,6.2
17427,June 2004,Oklahoma,2636585,1688873,64.1,1607544,61.0,81329,4.8
17428,June 2004,Oregon,2778594,1838295,66.2,1703377,61.3,134918,7.3
17429,June 2004,Pennsylvania,9645900,6209833,64.4,5870893,60.9,338940,5.5
17430,June 2004,Rhode Island,837738,558487,66.7,529370,63.2,29117,5.2
17431,June 2004,South Carolina,3175611,2033029,64.0,1893597,59.6,139432,6.9
17432,June 2004,South Dakota,582589,427681,73.4,411799,70.7,15882,3.7
17433,June 2004,Tennessee,4536945,2875783,63.4,2727380,60.1,148403,5.2
17434,June 2004,Texas,16307728,10984363,67.4,10336438,63.4,647925,5.9
17435,June 2004,Utah,1728855,1230132,71.2,1168068,67.6,62064,5.0
17436,June 2004,Vermont,491680,347970,70.8,335334,68.2,12636,3.6
17437,June 2004,Virginia,5613034,3787662,67.5,3641958,64.9,145704,3.8
17438,June 2004,Washington,4734536,3193790,67.5,2994908,63.3,198882,6.2
17439,June 2004,West Virginia,1432595,783840,54.7,742249,51.8,41591,5.3
17440,June 2004,Wisconsin,4245720,3037489,71.5,2884565,67.9,152924,5.0
17441,June 2004,Wyoming,386088,274798,71.2,264467,68.5,10331,3.8
17442,July 2004,Alabama,3443779,2138850,62.1,2016648,58.6,122202,5.7
17443,July 2004,Alaska,471914,336618,71.3,311650,66.0,24968,7.4
17444,July 2004,Arizona,4305236,2797903,65.0,2658095,61.7,139808,5.0
17445,July 2004,Arkansas,2087718,1300561,62.3,1226778,58.8,73783,5.7
17446,July 2004,California,26517866,17386330,65.6,16313380,61.5,1072950,6.2
17447,July 2004,Colorado,3490155,2536181,72.7,2399614,68.8,136567,5.4
17448,July 2004,Connecticut,2665072,1772808,66.5,1685739,63.3,87069,4.9
17449,July 2004,Delaware,632901,420719,66.5,403726,63.8,16993,4.0
17450,July 2004,District of Columbia,463364,311822,67.3,286611,61.9,25211,8.1
17451,July 2004,Florida,13568246,8446753,62.3,8056339,59.4,390414,4.6
17452,July 2004,Georgia,6590261,4453760,67.6,4238673,64.3,215087,4.8
17453,July 2004,Hawaii,943836,611058,64.7,591012,62.6,20046,3.3
17454,July 2004,Idaho,1028503,702963,68.3,668340,65.0,34623,4.9
17455,July 2004,Illinois,9559957,6320495,66.1,5932774,62.1,387721,6.1
17456,July 2004,Indiana,4715326,3165795,67.1,2998333,63.6,167462,5.3
17457,July 2004,Iowa,2263438,1600417,70.7,1527729,67.5,72688,4.5
17458,July 2004,Kansas,2051917,1466920,71.5,1387446,67.6,79474,5.4
17459,July 2004,Kentucky,3175141,1962668,61.8,1857724,58.5,104944,5.3
17460,July 2004,Louisiana,3341331,2034225,60.9,1914163,57.3,120062,5.9
17461,July 2004,Maine,1036156,685601,66.2,654604,63.2,30997,4.5
17462,July 2004,Maryland,4209075,2887986,68.6,2766377,65.7,121609,4.2
17463,July 2004,Massachusetts,5043821,3392919,67.3,3219089,63.8,173830,5.1
17464,July 2004,Michigan,7708983,5063486,65.7,4707116,61.1,356370,7.0
17465,July 2004,Minnesota,3894760,2883868,74.0,2746966,70.5,136902,4.7
17466,July 2004,Mississippi,2135811,1314959,61.6,1232081,57.7,82878,6.3
17467,July 2004,Missouri,4387385,3017381,68.8,2835598,64.6,181783,6.0
17468,July 2004,Montana,718478,481471,67.0,458514,63.8,22957,4.8
17469,July 2004,Nebraska,1315209,970609,73.8,933575,71.0,37034,3.8
17470,July 2004,Nevada,1759901,1178076,66.9,1128164,64.1,49912,4.2
17471,July 2004,New Hampshire,1008188,716600,71.1,690252,68.5,26348,3.7
17472,July 2004,New Jersey,6603391,4348396,65.9,4140092,62.7,208304,4.8
17473,July 2004,New Mexico,1413780,901326,63.8,852572,60.3,48754,5.4
17474,July 2004,New York,14923880,9377242,62.8,8841888,59.2,535354,5.7
17475,July 2004,North Carolina,6452489,4246487,65.8,4020464,62.3,226023,5.3
17476,July 2004,North Dakota,489992,353096,72.1,341131,69.6,11965,3.4
17477,July 2004,Ohio,8785028,5870740,66.8,5503116,62.6,367624,6.3
17478,July 2004,Oklahoma,2637604,1690010,64.1,1609567,61.0,80443,4.8
17479,July 2004,Oregon,2780722,1837518,66.1,1703725,61.3,133793,7.3
17480,July 2004,Pennsylvania,9649782,6216155,64.4,5878147,60.9,338008,5.4
17481,July 2004,Rhode Island,838032,558593,66.7,529864,63.2,28729,5.1
17482,July 2004,South Carolina,3179510,2036822,64.1,1897404,59.7,139418,6.8
17483,July 2004,South Dakota,583235,428019,73.4,412006,70.6,16013,3.7
17484,July 2004,Tennessee,4541057,2876508,63.3,2725224,60.0,151284,5.3
17485,July 2004,Texas,16331058,10991710,67.3,10350156,63.4,641554,5.8
17486,July 2004,Utah,1732590,1232699,71.1,1171424,67.6,61275,5.0
17487,July 2004,Vermont,492034,348034,70.7,335550,68.2,12484,3.6
17488,July 2004,Virginia,5622191,3792869,67.5,3649059,64.9,143810,3.8
17489,July 2004,Washington,4741529,3197319,67.4,3001552,63.3,195767,6.1
17490,July 2004,West Virginia,1432739,783345,54.7,742497,51.8,40848,5.2
17491,July 2004,Wisconsin,4249079,3035618,71.4,2884396,67.9,151222,5.0
17492,July 2004,Wyoming,386429,274849,71.1,264495,68.4,10354,3.8
17493,August 2004,Alabama,3446834,2139614,62.1,2018841,58.6,120773,5.6
17494,August 2004,Alaska,472628,337535,71.4,312639,66.1,24896,7.4
17495,August 2004,Arizona,4319535,2803148,64.9,2665625,61.7,137523,4.9
17496,August 2004,Arkansas,2089956,1304051,62.4,1230760,58.9,73291,5.6
17497,August 2004,California,26540808,17398727,65.6,16341739,61.6,1056988,6.1
17498,August 2004,Colorado,3495242,2539637,72.7,2403594,68.8,136043,5.4
17499,August 2004,Connecticut,2666291,1772904,66.5,1686937,63.3,85967,4.8
17500,August 2004,Delaware,633994,420835,66.4,403694,63.7,17141,4.1
17501,August 2004,District of Columbia,463684,313201,67.5,287556,62.0,25645,8.2
17502,August 2004,Florida,13598789,8470464,62.3,8082449,59.4,388015,4.6
17503,August 2004,Georgia,6604308,4462590,67.6,4244505,64.3,218085,4.9
17504,August 2004,Hawaii,944472,612139,64.8,592265,62.7,19874,3.2
17505,August 2004,Idaho,1030964,705340,68.4,670671,65.1,34669,4.9
17506,August 2004,Illinois,9564987,6327663,66.2,5940901,62.1,386762,6.1
17507,August 2004,Indiana,4718862,3166201,67.1,2997474,63.5,168727,5.3
17508,August 2004,Iowa,2264596,1601980,70.7,1528798,67.5,73182,4.6
17509,August 2004,Kansas,2053427,1468241,71.5,1389216,67.7,79025,5.4
17510,August 2004,Kentucky,3178077,1963277,61.8,1860226,58.5,103051,5.2
17511,August 2004,Louisiana,3342934,2039372,61.0,1919556,57.4,119816,5.9
17512,August 2004,Maine,1036856,686320,66.2,654984,63.2,31336,4.6
17513,August 2004,Maryland,4213352,2890465,68.6,2769080,65.7,121385,4.2
17514,August 2004,Massachusetts,5045874,3389403,67.2,3218349,63.8,171054,5.0
17515,August 2004,Michigan,7712018,5069021,65.7,4709773,61.1,359248,7.1
17516,August 2004,Minnesota,3897847,2884171,74.0,2748355,70.5,135816,4.7
17517,August 2004,Mississippi,2137314,1315500,61.5,1231018,57.6,84482,6.4
17518,August 2004,Missouri,4391827,3017707,68.7,2835041,64.6,182666,6.1
17519,August 2004,Montana,719343,481756,67.0,458925,63.8,22831,4.7
17520,August 2004,Nebraska,1316060,971255,73.8,934054,71.0,37201,3.8
17521,August 2004,Nevada,1765131,1181552,66.9,1132089,64.1,49463,4.2
17522,August 2004,New Hampshire,1009190,717259,71.1,691207,68.5,26052,3.6
17523,August 2004,New Jersey,6606346,4345724,65.8,4142063,62.7,203661,4.7
17524,August 2004,New Mexico,1415861,902637,63.8,854176,60.3,48461,5.4
17525,August 2004,New York,14932326,9388436,62.9,8865420,59.4,523016,5.6
17526,August 2004,North Carolina,6462915,4247168,65.7,4024493,62.3,222675,5.2
17527,August 2004,North Dakota,490157,353596,72.1,341535,69.7,12061,3.4
17528,August 2004,Ohio,8788758,5875020,66.8,5504991,62.6,370029,6.3
17529,August 2004,Oklahoma,2639439,1691112,64.1,1611230,61.0,79882,4.7
17530,August 2004,Oregon,2784563,1836747,66.0,1704109,61.2,132638,7.2
17531,August 2004,Pennsylvania,9655149,6222393,64.4,5885674,61.0,336719,5.4
17532,August 2004,Rhode Island,838002,558687,66.7,530340,63.3,28347,5.1
17533,August 2004,South Carolina,3184317,2040059,64.1,1900783,59.7,139276,6.8
17534,August 2004,South Dakota,583804,428302,73.4,412193,70.6,16109,3.8
17535,August 2004,Tennessee,4547265,2877210,63.3,2722536,59.9,154674,5.4
17536,August 2004,Texas,16356646,10999691,67.2,10361739,63.3,637952,5.8
17537,August 2004,Utah,1736464,1235157,71.1,1174741,67.7,60416,4.9
17538,August 2004,Vermont,492352,347986,70.7,335611,68.2,12375,3.6
17539,August 2004,Virginia,5629892,3798891,67.5,3656820,65.0,142071,3.7
17540,August 2004,Washington,4748214,3201511,67.4,3008241,63.4,193270,6.0
17541,August 2004,West Virginia,1433036,782891,54.6,742595,51.8,40296,5.1
17542,August 2004,Wisconsin,4252495,3032990,71.3,2883415,67.8,149575,4.9
17543,August 2004,Wyoming,386726,274893,71.1,264497,68.4,10396,3.8
17544,September 2004,Alabama,3449856,2139879,62.0,2020730,58.6,119149,5.6
17545,September 2004,Alaska,473333,338483,71.5,313658,66.3,24825,7.3
17546,September 2004,Arizona,4333748,2808061,64.8,2672425,61.7,135636,4.8
17547,September 2004,Arkansas,2092188,1307712,62.5,1234730,59.0,72982,5.6
17548,September 2004,California,26563611,17409509,65.5,16365928,61.6,1043581,6.0
17549,September 2004,Colorado,3500274,2542010,72.6,2406277,68.7,135733,5.3
17550,September 2004,Connecticut,2667497,1773178,66.5,1688034,63.3,85144,4.8
17551,September 2004,Delaware,635071,420898,66.3,403661,63.6,17237,4.1
17552,September 2004,District of Columbia,463963,314716,67.8,288830,62.3,25886,8.2
17553,September 2004,Florida,13629175,8494058,62.3,8108360,59.5,385698,4.5
17554,September 2004,Georgia,6618221,4471238,67.6,4250026,64.2,221212,4.9
17555,September 2004,Hawaii,945118,613307,64.9,593495,62.8,19812,3.2
17556,September 2004,Idaho,1033418,707975,68.5,673432,65.2,34543,4.9
17557,September 2004,Illinois,9569964,6335450,66.2,5949067,62.2,386383,6.1
17558,September 2004,Indiana,4722340,3166907,67.1,2996056,63.4,170851,5.4
17559,September 2004,Iowa,2265799,1603607,70.8,1530184,67.5,73423,4.6
17560,September 2004,Kansas,2054915,1468940,71.5,1390243,67.7,78697,5.4
17561,September 2004,Kentucky,3180947,1964337,61.8,1862552,58.6,101785,5.2
17562,September 2004,Louisiana,3344535,2044932,61.1,1925089,57.6,119843,5.9
17563,September 2004,Maine,1037513,687078,66.2,655292,63.2,31786,4.6
17564,September 2004,Maryland,4217571,2892914,68.6,2771484,65.7,121430,4.2
17565,September 2004,Massachusetts,5047836,3385666,67.1,3217418,63.7,168248,5.0
17566,September 2004,Michigan,7714892,5072960,65.8,4710997,61.1,361963,7.1
17567,September 2004,Minnesota,3900940,2883214,73.9,2749624,70.5,133590,4.6
17568,September 2004,Mississippi,2138807,1315497,61.5,1229936,57.5,85561,6.5
17569,September 2004,Missouri,4396196,3016752,68.6,2834285,64.5,182467,6.0
17570,September 2004,Montana,720237,481958,66.9,459291,63.8,22667,4.7
17571,September 2004,Nebraska,1316936,971711,73.8,934270,70.9,37441,3.9
17572,September 2004,Nevada,1770335,1185136,66.9,1135889,64.2,49247,4.2
17573,September 2004,New Hampshire,1010203,718024,71.1,692160,68.5,25864,3.6
17574,September 2004,New Jersey,6609244,4342729,65.7,4143879,62.7,198850,4.6
17575,September 2004,New Mexico,1417923,904353,63.8,855970,60.4,48383,5.4
17576,September 2004,New York,14940591,9396011,62.9,8883320,59.5,512691,5.5
17577,September 2004,North Carolina,6473256,4248989,65.6,4027456,62.2,221533,5.2
17578,September 2004,North Dakota,490337,353979,72.2,341839,69.7,12140,3.4
17579,September 2004,Ohio,8792357,5877621,66.8,5505598,62.6,372023,6.3
17580,September 2004,Oklahoma,2641207,1691903,64.1,1612307,61.0,79596,4.7
17581,September 2004,Oregon,2788374,1835975,65.8,1704944,61.1,131031,7.1
17582,September 2004,Pennsylvania,9660361,6227253,64.5,5892720,61.0,334533,5.4
17583,September 2004,Rhode Island,837961,558812,66.7,530759,63.3,28053,5.0
17584,September 2004,South Carolina,3189058,2042908,64.1,1903695,59.7,139213,6.8
17585,September 2004,South Dakota,584362,428543,73.3,412342,70.6,16201,3.8
17586,September 2004,Tennessee,4553381,2877165,63.2,2718846,59.7,158319,5.5
17587,September 2004,Texas,16382090,11007490,67.2,10370374,63.3,637116,5.8
17588,September 2004,Utah,1740320,1237613,71.1,1178153,67.7,59460,4.8
17589,September 2004,Vermont,492644,347866,70.6,335561,68.1,12305,3.5
17590,September 2004,Virginia,5637496,3804876,67.5,3664166,65.0,140710,3.7
17591,September 2004,Washington,4754811,3206479,67.4,3015103,63.4,191376,6.0
17592,September 2004,West Virginia,1433293,782498,54.6,742489,51.8,40009,5.1
17593,September 2004,Wisconsin,4255875,3029401,71.2,2881301,67.7,148100,4.9
17594,September 2004,Wyoming,387024,274906,71.0,264501,68.3,10405,3.8
17595,October 2004,Alabama,3452951,2139644,62.0,2022353,58.6,117291,5.5
17596,October 2004,Alaska,474064,339410,71.6,314672,66.4,24738,7.3
17597,October 2004,Arizona,4348147,2812645,64.7,2678079,61.6,134566,4.8
17598,October 2004,Arkansas,2094464,1311451,62.6,1238632,59.1,72819,5.6
17599,October 2004,California,26587015,17417684,65.5,16384328,61.6,1033356,5.9
17600,October 2004,Colorado,3505410,2543364,72.6,2407869,68.7,135495,5.3
17601,October 2004,Connecticut,2668743,1773757,66.5,1689007,63.3,84750,4.8
17602,October 2004,Delaware,636204,420954,66.2,403693,63.5,17261,4.1
17603,October 2004,District of Columbia,464285,316122,68.1,290265,62.5,25857,8.2
17604,October 2004,Florida,13660059,8516037,62.3,8132995,59.5,383042,4.5
17605,October 2004,Georgia,6632340,4480019,67.5,4254698,64.2,225321,5.0
17606,October 2004,Hawaii,945789,614534,65.0,594765,62.9,19769,3.2
17607,October 2004,Idaho,1035876,710803,68.6,676721,65.3,34082,4.8
17608,October 2004,Illinois,9575124,6342646,66.2,5956622,62.2,386024,6.1
17609,October 2004,Indiana,4725924,3168297,67.0,2994573,63.4,173724,5.5
17610,October 2004,Iowa,2266982,1605416,70.8,1532009,67.6,73407,4.6
17611,October 2004,Kansas,2056435,1469074,71.4,1390620,67.6,78454,5.3
17612,October 2004,Kentucky,3183913,1966031,61.7,1864450,58.6,101581,5.2
17613,October 2004,Louisiana,3346145,2049589,61.3,1929498,57.7,120091,5.9
17614,October 2004,Maine,1038218,687801,66.2,655535,63.1,32266,4.7
17615,October 2004,Maryland,4221895,2895250,68.6,2773278,65.7,121972,4.2
17616,October 2004,Massachusetts,5049924,3382134,67.0,3216144,63.7,165990,4.9
17617,October 2004,Michigan,7718019,5074247,65.7,4710455,61.0,363792,7.2
17618,October 2004,Minnesota,3904112,2880983,73.8,2750503,70.5,130480,4.5
17619,October 2004,Mississippi,2140328,1315311,61.5,1228993,57.4,86318,6.6
17620,October 2004,Missouri,4400691,3014457,68.5,2832887,64.4,181570,6.0
17621,October 2004,Montana,721107,482219,66.9,459726,63.8,22493,4.7
17622,October 2004,Nebraska,1317804,972060,73.8,934335,70.9,37725,3.9
17623,October 2004,Nevada,1775557,1188672,66.9,1139436,64.2,49236,4.1
17624,October 2004,New Hampshire,1011237,718874,71.1,693090,68.5,25784,3.6
17625,October 2004,New Jersey,6612297,4340253,65.6,4145345,62.7,194908,4.5
17626,October 2004,New Mexico,1420034,906284,63.8,857743,60.4,48541,5.4
17627,October 2004,New York,14949242,9398541,62.9,8894802,59.5,503739,5.4
17628,October 2004,North Carolina,6483763,4252296,65.6,4029397,62.1,222899,5.2
17629,October 2004,North Dakota,490501,354225,72.2,342041,69.7,12184,3.4
17630,October 2004,Ohio,8796157,5877828,66.8,5504296,62.6,373532,6.4
17631,October 2004,Oklahoma,2643012,1692351,64.0,1612766,61.0,79585,4.7
17632,October 2004,Oregon,2792241,1835218,65.7,1706460,61.1,128758,7.0
17633,October 2004,Pennsylvania,9665811,6230399,64.5,5898434,61.0,331965,5.3
17634,October 2004,Rhode Island,837929,559021,66.7,531127,63.4,27894,5.0
17635,October 2004,South Carolina,3193896,2045379,64.0,1906075,59.7,139304,6.8
17636,October 2004,South Dakota,584947,428777,73.3,412457,70.5,16320,3.8
17637,October 2004,Tennessee,4559601,2875988,63.1,2714213,59.5,161775,5.6
17638,October 2004,Texas,16407952,11014707,67.1,10376614,63.2,638093,5.8
17639,October 2004,Utah,1744191,1240199,71.1,1181765,67.8,58434,4.7
17640,October 2004,Vermont,493024,347717,70.5,335450,68.0,12267,3.5
17641,October 2004,Virginia,5645219,3810444,67.5,3670507,65.0,139937,3.7
17642,October 2004,Washington,4761572,3211823,67.5,3021877,63.5,189946,5.9
17643,October 2004,West Virginia,1433605,782253,54.6,742222,51.8,40031,5.1
17644,October 2004,Wisconsin,4259357,3024829,71.0,2878072,67.6,146757,4.9
17645,October 2004,Wyoming,387319,274873,71.0,264534,68.3,10339,3.8
17646,November 2004,Alabama,3455389,2138854,61.9,2023985,58.6,114869,5.4
17647,November 2004,Alaska,474732,340255,71.7,315640,66.5,24615,7.2
17648,November 2004,Arizona,4361732,2817364,64.6,2683006,61.5,134358,4.8
17649,November 2004,Arkansas,2096365,1315208,62.7,1242563,59.3,72645,5.5
17650,November 2004,California,26606532,17423380,65.5,16399053,61.6,1024327,5.9
17651,November 2004,Colorado,3510005,2544144,72.5,2408870,68.6,135274,5.3
17652,November 2004,Connecticut,2669573,1774882,66.5,1690028,63.3,84854,4.8
17653,November 2004,Delaware,637179,421125,66.1,403931,63.4,17194,4.1
17654,November 2004,District of Columbia,464512,317176,68.3,291661,62.8,25515,8.0
17655,November 2004,Florida,13688136,8536214,62.4,8156963,59.6,379251,4.4
17656,November 2004,Georgia,6645274,4489283,67.6,4258968,64.1,230315,5.1
17657,November 2004,Hawaii,946406,615778,65.1,596123,63.0,19655,3.2
17658,November 2004,Idaho,1038176,713744,68.7,680481,65.5,33263,4.7
17659,November 2004,Illinois,9578688,6348510,66.3,5963704,62.3,384806,6.1
17660,November 2004,Indiana,4728736,3170421,67.0,2993770,63.3,176651,5.6
17661,November 2004,Iowa,2267796,1607668,70.9,1534526,67.7,73142,4.5
17662,November 2004,Kansas,2057633,1468837,71.4,1390583,67.6,78254,5.3
17663,November 2004,Kentucky,3186350,1968432,61.8,1865896,58.6,102536,5.2
17664,November 2004,Louisiana,3347153,2052424,61.3,1932242,57.7,120182,5.9
17665,November 2004,Maine,1038776,688506,66.3,655782,63.1,32724,4.8
17666,November 2004,Maryland,4225446,2897572,68.6,2774573,65.7,122999,4.2
17667,November 2004,Massachusetts,5051159,3379344,66.9,3214697,63.6,164647,4.9
17668,November 2004,Michigan,7719740,5073210,65.7,4708856,61.0,364354,7.2
17669,November 2004,Minnesota,3906683,2877921,73.7,2750890,70.4,127031,4.4
17670,November 2004,Mississippi,2141445,1315284,61.4,1228377,57.4,86907,6.6
17671,November 2004,Missouri,4404412,3011421,68.4,2831079,64.3,180342,6.0
17672,November 2004,Montana,721908,482560,66.8,460226,63.8,22334,4.6
17673,November 2004,Nebraska,1318498,972412,73.8,934367,70.9,38045,3.9
17674,November 2004,Nevada,1780588,1192098,66.9,1142799,64.2,49299,4.1
17675,November 2004,New Hampshire,1012112,719751,71.1,693954,68.6,25797,3.6
17676,November 2004,New Jersey,6614131,4339074,65.6,4146929,62.7,192145,4.4
17677,November 2004,New Mexico,1421921,908224,63.9,859369,60.4,48855,5.4
17678,November 2004,New York,14955205,9396294,62.8,8901578,59.5,494716,5.3
17679,November 2004,North Carolina,6493178,4257370,65.6,4031375,62.1,225995,5.3
17680,November 2004,North Dakota,490623,354335,72.2,342148,69.7,12187,3.4
17681,November 2004,Ohio,8798349,5875682,66.8,5501804,62.5,373878,6.4
17682,November 2004,Oklahoma,2644429,1692593,64.0,1612872,61.0,79721,4.7
17683,November 2004,Oregon,2795684,1834584,65.6,1708718,61.1,125866,6.9
17684,November 2004,Pennsylvania,9669418,6232137,64.5,5902671,61.0,329466,5.3
17685,November 2004,Rhode Island,837781,559341,66.8,531513,63.4,27828,5.0
17686,November 2004,South Carolina,3198135,2047363,64.0,1907952,59.7,139411,6.8
17687,November 2004,South Dakota,585445,429034,73.3,412556,70.5,16478,3.8
17688,November 2004,Tennessee,4565066,2873888,63.0,2709477,59.4,164411,5.7
17689,November 2004,Texas,16431310,11020879,67.1,10382423,63.2,638456,5.8
17690,November 2004,Utah,1747839,1243005,71.1,1185640,67.8,57365,4.6
17691,November 2004,Vermont,493261,347593,70.5,335356,68.0,12237,3.5
17692,November 2004,Virginia,5652057,3816184,67.5,3676396,65.0,139788,3.7
17693,November 2004,Washington,4767571,3217081,67.5,3028346,63.5,188735,5.9
17694,November 2004,West Virginia,1433688,782267,54.6,741970,51.8,40297,5.2
17695,November 2004,Wisconsin,4262165,3019632,70.8,2874330,67.4,145302,4.8
17696,November 2004,Wyoming,387592,274804,70.9,264610,68.3,10194,3.7
17697,December 2004,Alabama,3457864,2138018,61.8,2026186,58.6,111832,5.2
17698,December 2004,Alaska,475388,341024,71.7,316577,66.6,24447,7.2
17699,December 2004,Arizona,4375260,2823278,64.5,2688351,61.4,134927,4.8
17700,December 2004,Arkansas,2098297,1319152,62.9,1246763,59.4,72389,5.5
17701,December 2004,California,26625485,17431266,65.5,16415179,61.7,1016087,5.8
17702,December 2004,Colorado,3514580,2545095,72.4,2409978,68.6,135117,5.3
17703,December 2004,Connecticut,2670352,1776896,66.5,1691380,63.3,85516,4.8
17704,December 2004,Delaware,638163,421596,66.1,404535,63.4,17061,4.0
17705,December 2004,District of Columbia,464743,317753,68.4,292840,63.0,24913,7.8
17706,December 2004,Florida,13716053,8556921,62.4,8182617,59.7,374304,4.4
17707,December 2004,Georgia,6658325,4500422,67.6,4264361,64.0,236061,5.2
17708,December 2004,Hawaii,947015,617036,65.2,597590,63.1,19446,3.2
17709,December 2004,Idaho,1040488,716759,68.9,684500,65.8,32259,4.5
17710,December 2004,Illinois,9582205,6354427,66.3,5971205,62.3,383222,6.0
17711,December 2004,Indiana,4731573,3173825,67.1,2994692,63.3,179133,5.6
17712,December 2004,Iowa,2268621,1610621,71.0,1537894,67.8,72727,4.5
17713,December 2004,Kansas,2058823,1468517,71.3,1390460,67.5,78057,5.3
17714,December 2004,Kentucky,3188808,1971876,61.8,1867232,58.6,104644,5.3
17715,December 2004,Louisiana,3348219,2053816,61.3,1933867,57.8,119949,5.8
17716,December 2004,Maine,1039312,689347,66.3,656166,63.1,33181,4.8
17717,December 2004,Maryland,4229035,2900380,68.6,2776010,65.6,124370,4.3
17718,December 2004,Massachusetts,5052390,3377964,66.9,3213624,63.6,164340,4.9
17719,December 2004,Michigan,7721554,5072249,65.7,4707997,61.0,364252,7.2
17720,December 2004,Minnesota,3909235,2875306,73.6,2751072,70.4,124234,4.3
17721,December 2004,Mississippi,2142612,1315830,61.4,1228321,57.3,87509,6.7
17722,December 2004,Missouri,4408140,3009143,68.3,2829799,64.2,179344,6.0
17723,December 2004,Montana,722675,482910,66.8,460707,63.8,22203,4.6
17724,December 2004,Nebraska,1319186,972840,73.7,934461,70.8,38379,3.9
17725,December 2004,Nevada,1785562,1195564,67.0,1146192,64.2,49372,4.1
17726,December 2004,New Hampshire,1013003,720659,71.1,694798,68.6,25861,3.6
17727,December 2004,New Jersey,6615934,4340406,65.6,4149802,62.7,190604,4.4
17728,December 2004,New Mexico,1423778,910094,63.9,860875,60.5,49219,5.4
17729,December 2004,New York,14961196,9394413,62.8,8907475,59.5,486938,5.2
17730,December 2004,North Carolina,6502600,4264900,65.6,4035066,62.1,229834,5.4
17731,December 2004,North Dakota,490708,354364,72.2,342196,69.7,12168,3.4
17732,December 2004,Ohio,8800590,5873366,66.7,5500220,62.5,373146,6.4
17733,December 2004,Oklahoma,2645828,1692985,64.0,1613159,61.0,79826,4.7
17734,December 2004,Oregon,2799092,1834547,65.5,1711650,61.2,122897,6.7
17735,December 2004,Pennsylvania,9673014,6234050,64.4,5906563,61.1,327487,5.3
17736,December 2004,Rhode Island,837617,559777,66.8,531980,63.5,27797,5.0
17737,December 2004,South Carolina,3202414,2049210,64.0,1909673,59.6,139537,6.8
17738,December 2004,South Dakota,585936,429319,73.3,412626,70.4,16693,3.9
17739,December 2004,Tennessee,4570542,2872450,62.8,2705983,59.2,166467,5.8
17740,December 2004,Texas,16454361,11028247,67.0,10390753,63.1,637494,5.8
17741,December 2004,Utah,1751435,1246200,71.2,1189844,67.9,56356,4.5
17742,December 2004,Vermont,493498,347555,70.4,335369,68.0,12186,3.5
17743,December 2004,Virginia,5658923,3823748,67.6,3683335,65.1,140413,3.7
17744,December 2004,Washington,4773559,3222494,67.5,3034710,63.6,187784,5.8
17745,December 2004,West Virginia,1433761,782554,54.6,741938,51.7,40616,5.2
17746,December 2004,Wisconsin,4264967,3014917,70.7,2871041,67.3,143876,4.8
17747,December 2004,Wyoming,387828,274748,70.8,264741,68.3,10007,3.6
17748,January 2005,Alabama,3460380,2137724,61.8,2029283,58.6,108441,5.1
17749,January 2005,Alaska,476092,341699,71.8,317476,66.7,24223,7.1
17750,January 2005,Arizona,4388833,2830958,64.5,2695075,61.4,135883,4.8
17751,January 2005,Arkansas,2100215,1323353,63.0,1251399,59.6,71954,5.4
17752,January 2005,California,26644965,17443049,65.5,16436374,61.7,1006675,5.8
17753,January 2005,Colorado,3519168,2546701,72.4,2411798,68.5,134903,5.3
17754,January 2005,Connecticut,2671146,1779873,66.6,1693271,63.4,86602,4.9
17755,January 2005,Delaware,639183,422512,66.1,405567,63.5,16945,4.0
17756,January 2005,District of Columbia,465017,317860,68.4,293699,63.2,24161,7.6
17757,January 2005,Florida,13744074,8579371,62.4,8211674,59.7,367697,4.3
17758,January 2005,Georgia,6671455,4513524,67.7,4272139,64.0,241385,5.3
17759,January 2005,Hawaii,947670,618291,65.2,599159,63.2,19132,3.1
17760,January 2005,Idaho,1042808,719723,69.0,688441,66.0,31282,4.3
17761,January 2005,Illinois,9585780,6360665,66.4,5979321,62.4,381344,6.0
17762,January 2005,Indiana,4734369,3178412,67.1,2997944,63.3,180468,5.7
17763,January 2005,Iowa,2269436,1614081,71.1,1541929,67.9,72152,4.5
17764,January 2005,Kansas,2060008,1468305,71.3,1390532,67.5,77773,5.3
17765,January 2005,Kentucky,3191213,1976456,61.9,1868883,58.6,107573,5.4
17766,January 2005,Louisiana,3349336,2054488,61.3,1935247,57.8,119241,5.8
17767,January 2005,Maine,1039810,690412,66.4,656787,63.2,33625,4.9
17768,January 2005,Maryland,4232709,2903886,68.6,2778211,65.6,125675,4.3
17769,January 2005,Massachusetts,5053578,3377919,66.8,3213387,63.6,164532,4.9
17770,January 2005,Michigan,7723279,5072440,65.7,4709573,61.0,362867,7.2
17771,January 2005,Minnesota,3911758,2873921,73.5,2751548,70.3,122373,4.3
17772,January 2005,Mississippi,2143800,1317164,61.4,1228909,57.3,88255,6.7
17773,January 2005,Missouri,4411851,3008277,68.2,2829722,64.1,178555,5.9
17774,January 2005,Montana,723461,483216,66.8,461130,63.7,22086,4.6
17775,January 2005,Nebraska,1319812,973270,73.7,934650,70.8,38620,4.0
17776,January 2005,Nevada,1790521,1199243,67.0,1149817,64.2,49426,4.1
17777,January 2005,New Hampshire,1013859,721575,71.2,695652,68.6,25923,3.6
17778,January 2005,New Jersey,6617768,4344720,65.7,4154820,62.8,189900,4.4
17779,January 2005,New Mexico,1425635,911819,64.0,862317,60.5,49502,5.4
17780,January 2005,New York,14967391,9396085,62.8,8915505,59.6,480580,5.1
17781,January 2005,North Carolina,6512057,4274109,65.6,4041279,62.1,232830,5.4
17782,January 2005,North Dakota,490814,354362,72.2,342214,69.7,12148,3.4
17783,January 2005,Ohio,8802792,5872390,66.7,5501281,62.5,371109,6.3
17784,January 2005,Oklahoma,2647195,1693715,64.0,1614023,61.0,79692,4.7
17785,January 2005,Oregon,2802431,1835301,65.5,1715069,61.2,120232,6.6
17786,January 2005,Pennsylvania,9676572,6236573,64.5,5910927,61.1,325646,5.2
17787,January 2005,Rhode Island,837441,560351,66.9,532546,63.6,27805,5.0
17788,January 2005,South Carolina,3206689,2050791,64.0,1911357,59.6,139434,6.8
17789,January 2005,South Dakota,586410,429600,73.3,412675,70.4,16925,3.9
17790,January 2005,Tennessee,4576008,2872844,62.8,2704708,59.1,168136,5.9
17791,January 2005,Texas,16477714,11037100,67.0,10403406,63.1,633694,5.7
17792,January 2005,Utah,1755023,1249758,71.2,1194307,68.1,55451,4.4
17793,January 2005,Vermont,493748,347634,70.4,335525,68.0,12109,3.5
17794,January 2005,Virginia,5665801,3833916,67.7,3692480,65.2,141436,3.7
17795,January 2005,Washington,4779499,3228163,67.5,3041286,63.6,186877,5.8
17796,January 2005,West Virginia,1433771,783056,54.6,742288,51.8,40768,5.2
17797,January 2005,Wisconsin,4267697,3011465,70.6,2868935,67.2,142530,4.7
17798,January 2005,Wyoming,388071,274759,70.8,264927,68.3,9832,3.6
17799,February 2005,Alabama,3462717,2138143,61.7,2033021,58.7,105122,4.9
17800,February 2005,Alaska,476716,342265,71.8,318303,66.8,23962,7.0
17801,February 2005,Arizona,4402003,2840084,64.5,2703444,61.4,136640,4.8
17802,February 2005,Arkansas,2101950,1327774,63.2,1256419,59.8,71355,5.4
17803,February 2005,California,26662446,17457294,65.5,16462727,61.7,994567,5.7
17804,February 2005,Colorado,3523573,2548979,72.3,2414478,68.5,134501,5.3
17805,February 2005,Connecticut,2671679,1783510,66.8,1695666,63.5,87844,4.9
17806,February 2005,Delaware,640133,423909,66.2,406974,63.6,16935,4.0
17807,February 2005,District of Columbia,465223,317598,68.3,294256,63.3,23342,7.3
17808,February 2005,Florida,13770467,8603022,62.5,8243788,59.9,359234,4.2
17809,February 2005,Georgia,6684496,4527534,67.7,4282400,64.1,245134,5.4
17810,February 2005,Hawaii,948189,619544,65.3,600800,63.4,18744,3.0
17811,February 2005,Idaho,1045018,722552,69.1,691989,66.2,30563,4.2
17812,February 2005,Illinois,9588823,6366666,66.4,5987352,62.4,379314,6.0
17813,February 2005,Indiana,4736904,3183374,67.2,3003185,63.4,180189,5.7
17814,February 2005,Iowa,2269999,1617648,71.3,1546143,68.1,71505,4.4
17815,February 2005,Kansas,2061041,1468113,71.2,1390796,67.5,77317,5.3
17816,February 2005,Kentucky,3193509,1981735,62.1,1870966,58.6,110769,5.6
17817,February 2005,Louisiana,3350321,2055257,61.3,1937066,57.8,118191,5.8
17818,February 2005,Maine,1040231,691709,66.5,657693,63.2,34016,4.9
17819,February 2005,Maryland,4236127,2907876,68.6,2781449,65.7,126427,4.3
17820,February 2005,Massachusetts,5054419,3378521,66.8,3213901,63.6,164620,4.9
17821,February 2005,Michigan,7724621,5073837,65.7,4714126,61.0,359711,7.1
17822,February 2005,Minnesota,3914076,2873789,73.4,2752631,70.3,121158,4.2
17823,February 2005,Mississippi,2144960,1319071,61.5,1230024,57.3,89047,6.8
17824,February 2005,Missouri,4415325,3008489,68.1,2830973,64.1,177516,5.9
17825,February 2005,Montana,724169,483447,66.8,461465,63.7,21982,4.5
17826,February 2005,Nebraska,1320408,973600,73.7,934917,70.8,38683,4.0
17827,February 2005,Nevada,1795391,1203254,67.0,1153768,64.3,49486,4.1
17828,February 2005,New Hampshire,1014695,722468,71.2,696525,68.6,25943,3.6
17829,February 2005,New Jersey,6619095,4351286,65.7,4162015,62.9,189271,4.3
17830,February 2005,New Mexico,1427392,913319,64.0,863734,60.5,49585,5.4
17831,February 2005,New York,14972486,9401262,62.8,8925944,59.6,475318,5.1
17832,February 2005,North Carolina,6521208,4283334,65.7,4049317,62.1,234017,5.5
17833,February 2005,North Dakota,490871,354346,72.2,342207,69.7,12139,3.4
17834,February 2005,Ohio,8804440,5872629,66.7,5505351,62.5,367278,6.3
17835,February 2005,Oklahoma,2648385,1694647,64.0,1615436,61.0,79211,4.7
17836,February 2005,Oregon,2805596,1836728,65.5,1718590,61.3,118138,6.4
17837,February 2005,Pennsylvania,9679271,6239234,64.5,5915808,61.1,323426,5.2
17838,February 2005,Rhode Island,837198,561082,67.0,533244,63.7,27838,5.0
17839,February 2005,South Carolina,3210871,2051942,63.9,1913101,59.6,138841,6.8
17840,February 2005,South Dakota,586862,429872,73.2,412747,70.3,17125,4.0
17841,February 2005,Tennessee,4581243,2875087,62.8,2705908,59.1,169179,5.9
17842,February 2005,Texas,16500347,11045648,66.9,10419649,63.1,625999,5.7
17843,February 2005,Utah,1758684,1253526,71.3,1198878,68.2,54648,4.4
17844,February 2005,Vermont,493996,347837,70.4,335814,68.0,12023,3.5
17845,February 2005,Virginia,5672429,3846117,67.8,3703824,65.3,142293,3.7
17846,February 2005,Washington,4785133,3234013,67.6,3048221,63.7,185792,5.7
17847,February 2005,West Virginia,1433725,783762,54.7,743089,51.8,40673,5.2
17848,February 2005,Wisconsin,4270211,3009574,70.5,2868111,67.2,141463,4.7
17849,February 2005,Wyoming,388301,274861,70.8,265143,68.3,9718,3.5
17850,March 2005,Alabama,3465050,2139056,61.7,2037082,58.8,101974,4.8
17851,March 2005,Alaska,477365,342776,71.8,319060,66.8,23716,6.9
17852,March 2005,Arizona,4415083,2850253,64.6,2713482,61.5,136771,4.8
17853,March 2005,Arkansas,2103753,1332312,63.3,1261519,60.0,70793,5.3
17854,March 2005,California,26678872,17473007,65.5,16493906,61.8,979101,5.6
17855,March 2005,Colorado,3527977,2551744,72.3,2417976,68.5,133768,5.2
17856,March 2005,Connecticut,2672291,1787346,66.9,1698453,63.6,88893,5.0
17857,March 2005,Delaware,641082,425728,66.4,408661,63.7,17067,4.0
17858,March 2005,District of Columbia,465451,317124,68.1,294625,63.3,22499,7.1
17859,March 2005,Florida,13796773,8628448,62.5,8279298,60.0,349150,4.0
17860,March 2005,Georgia,6697423,4541339,67.8,4295026,64.1,246313,5.4
17861,March 2005,Hawaii,948653,620871,65.4,602533,63.5,18338,3.0
17862,March 2005,Idaho,1047271,725194,69.2,694985,66.4,30209,4.2
17863,March 2005,Illinois,9591812,6372136,66.4,5995822,62.5,376314,5.9
17864,March 2005,Indiana,4739527,3188035,67.3,3009890,63.5,178145,5.6
17865,March 2005,Iowa,2270656,1620980,71.4,1550131,68.3,70849,4.4
17866,March 2005,Kansas,2062079,1467679,71.2,1391102,67.5,76577,5.2
17867,March 2005,Kentucky,3195814,1987202,62.2,1873517,58.6,113685,5.7
17868,March 2005,Louisiana,3351321,2058628,61.4,1940858,57.9,117770,5.7
17869,March 2005,Maine,1040705,693205,66.6,658894,63.3,34311,4.9
17870,March 2005,Maryland,4239551,2911986,68.7,2785767,65.7,126219,4.3
17871,March 2005,Massachusetts,5055380,3379303,66.8,3215264,63.6,164039,4.9
17872,March 2005,Michigan,7726034,5076269,65.7,4721611,61.1,354658,7.0
17873,March 2005,Minnesota,3916435,2874411,73.4,2754552,70.3,119859,4.2
17874,March 2005,Mississippi,2146056,1321114,61.6,1231657,57.4,89457,6.8
17875,March 2005,Missouri,4418842,3009086,68.1,2833864,64.1,175222,5.8
17876,March 2005,Montana,724891,483640,66.7,461764,63.7,21876,4.5
17877,March 2005,Nebraska,1320998,973729,73.7,935209,70.8,38520,4.0
17878,March 2005,Nevada,1800253,1207669,67.1,1158081,64.3,49588,4.1
17879,March 2005,New Hampshire,1015536,723275,71.2,697375,68.7,25900,3.6
17880,March 2005,New Jersey,6620383,4359408,65.8,4171297,63.0,188111,4.3
17881,March 2005,New Mexico,1429046,914602,64.0,865227,60.5,49375,5.4
17882,March 2005,New York,14977409,9409839,62.8,8939247,59.7,470592,5.0
17883,March 2005,North Carolina,6530360,4291732,65.7,4058491,62.1,233241,5.4
17884,March 2005,North Dakota,490930,354342,72.2,342212,69.7,12130,3.4
17885,March 2005,Ohio,8806322,5873758,66.7,5512548,62.6,361210,6.1
17886,March 2005,Oklahoma,2649591,1695980,64.0,1617264,61.0,78716,4.6
17887,March 2005,Oregon,2808757,1838672,65.5,1721969,61.3,116703,6.3
17888,March 2005,Pennsylvania,9682205,6241999,64.5,5921684,61.2,320315,5.1
17889,March 2005,Rhode Island,836982,561995,67.1,534105,63.8,27890,5.0
17890,March 2005,South Carolina,3215032,2053206,63.9,1915452,59.6,137754,6.7
17891,March 2005,South Dakota,587282,430124,73.2,412887,70.3,17237,4.0
17892,March 2005,Tennessee,4586532,2879063,62.8,2709737,59.1,169326,5.9
17893,March 2005,Texas,16522317,11053577,66.9,10438205,63.2,615372,5.6
17894,March 2005,Utah,1762308,1257385,71.3,1203574,68.3,53811,4.3
17895,March 2005,Vermont,494236,348167,70.4,336210,68.0,11957,3.4
17896,March 2005,Virginia,5679045,3859630,68.0,3717207,65.5,142423,3.7
17897,March 2005,Washington,4790818,3240349,67.6,3055911,63.8,184438,5.7
17898,March 2005,West Virginia,1433705,784738,54.7,744350,51.9,40388,5.1
17899,March 2005,Wisconsin,4272766,3009254,70.4,2868611,67.1,140643,4.7
17900,March 2005,Wyoming,388553,275070,70.8,265378,68.3,9692,3.5
17901,April 2005,Alabama,3467687,2140454,61.7,2041410,58.9,99044,4.6
17902,April 2005,Alaska,478096,343279,71.8,319766,66.9,23513,6.8
17903,April 2005,Arizona,4428692,2861235,64.6,2724927,61.5,136308,4.8
17904,April 2005,Arkansas,2105716,1337015,63.5,1266537,60.1,70478,5.3
17905,April 2005,California,26698527,17492262,65.5,16529980,61.9,962282,5.5
17906,April 2005,Colorado,3532733,2554710,72.3,2422041,68.6,132669,5.2
17907,April 2005,Connecticut,2673108,1791090,67.0,1701561,63.7,89529,5.0
17908,April 2005,Delaware,642098,427824,66.6,410506,63.9,17318,4.0
17909,April 2005,District of Columbia,465712,316580,68.0,294926,63.3,21654,6.8
17910,April 2005,Florida,13824542,8657368,62.6,8319078,60.2,338290,3.9
17911,April 2005,Georgia,6710913,4555444,67.9,4309862,64.2,245582,5.4
17912,April 2005,Hawaii,949295,622409,65.6,604430,63.7,17979,2.9
17913,April 2005,Idaho,1049612,727665,69.3,697501,66.5,30164,4.1
17914,April 2005,Illinois,9595765,6378227,66.5,6005800,62.6,372427,5.8
17915,April 2005,Indiana,4742556,3192780,67.3,3017533,63.6,175247,5.5
17916,April 2005,Iowa,2271492,1623973,71.5,1553802,68.4,70171,4.3
17917,April 2005,Kansas,2063305,1466892,71.1,1391369,67.4,75523,5.1
17918,April 2005,Kentucky,3198405,1992476,62.3,1876581,58.7,115895,5.8
17919,April 2005,Louisiana,3352612,2064717,61.6,1946445,58.1,118272,5.7
17920,April 2005,Maine,1041236,694842,66.7,660357,63.4,34485,5.0
17921,April 2005,Maryland,4243365,2916192,68.7,2791125,65.8,125067,4.3
17922,April 2005,Massachusetts,5056753,3380316,66.8,3217477,63.6,162839,4.8
17923,April 2005,Michigan,7728136,5080167,65.7,4731265,61.2,348902,6.9
17924,April 2005,Minnesota,3919150,2875367,73.4,2757321,70.4,118046,4.1
17925,April 2005,Mississippi,2147354,1322796,61.6,1233403,57.4,89393,6.8
17926,April 2005,Missouri,4422729,3009823,68.1,2838606,64.2,171217,5.7
17927,April 2005,Montana,725667,483902,66.7,462157,63.7,21745,4.5
17928,April 2005,Nebraska,1321677,973600,73.7,935488,70.8,38112,3.9
17929,April 2005,Nevada,1805236,1212490,67.2,1162727,64.4,49763,4.1
17930,April 2005,New Hampshire,1016449,724032,71.2,698206,68.7,25826,3.6
17931,April 2005,New Jersey,6622390,4368983,66.0,4182298,63.2,186685,4.3
17932,April 2005,New Mexico,1430923,915811,64.0,866948,60.6,48863,5.3
17933,April 2005,New York,14983913,9423325,62.9,8956211,59.8,467114,5.0
17934,April 2005,North Carolina,6540087,4299859,65.7,4068638,62.2,231221,5.4
17935,April 2005,North Dakota,491032,354427,72.2,342313,69.7,12114,3.4
17936,April 2005,Ohio,8808940,5876658,66.7,5522758,62.7,353900,6.0
17937,April 2005,Oklahoma,2651053,1697959,64.0,1619561,61.1,78398,4.6
17938,April 2005,Oregon,2812208,1841007,65.5,1725152,61.3,115855,6.3
17939,April 2005,Pennsylvania,9685990,6245627,64.5,5929162,61.2,316465,5.1
17940,April 2005,Rhode Island,836837,563115,67.3,535137,63.9,27978,5.0
17941,April 2005,South Carolina,3219471,2055424,63.8,1918807,59.6,136617,6.6
17942,April 2005,South Dakota,587776,430330,73.2,413109,70.3,17221,4.0
17943,April 2005,Tennessee,4592237,2884388,62.8,2716394,59.2,167994,5.8
17944,April 2005,Texas,16546090,11063579,66.9,10459086,63.2,604493,5.5
17945,April 2005,Utah,1766020,1261428,71.4,1208488,68.4,52940,4.2
17946,April 2005,Vermont,494509,348627,70.5,336700,68.1,11927,3.4
17947,April 2005,Virginia,5686120,3874382,68.1,3732427,65.6,141955,3.7
17948,April 2005,Washington,4796941,3247499,67.7,3064425,63.9,183074,5.6
17949,April 2005,West Virginia,1433764,786141,54.8,746033,52.0,40108,5.1
17950,April 2005,Wisconsin,4275662,3010685,70.4,2870555,67.1,140130,4.7
17951,April 2005,Wyoming,388789,275393,70.8,265649,68.3,9744,3.5
17952,May 2005,Alabama,3470456,2142465,61.7,2045970,59.0,96495,4.5
17953,May 2005,Alaska,478798,343788,71.8,320409,66.9,23379,6.8
17954,May 2005,Arizona,4442405,2872494,64.7,2737094,61.6,135400,4.7
17955,May 2005,Arkansas,2107819,1341906,63.7,1271442,60.3,70464,5.3
17956,May 2005,California,26718033,17515764,65.6,16569012,62.0,946752,5.4
17957,May 2005,Colorado,3537599,2557733,72.3,2426554,68.6,131179,5.1
17958,May 2005,Connecticut,2674080,1794597,67.1,1704928,63.8,89669,5.0
17959,May 2005,Delaware,643156,430020,66.9,412377,64.1,17643,4.1
17960,May 2005,District of Columbia,465982,316057,67.8,295245,63.4,20812,6.6
17961,May 2005,Florida,13853110,8689618,62.7,8362493,60.4,327125,3.8
17962,May 2005,Georgia,6724569,4570674,68.0,4326070,64.3,244604,5.4
17963,May 2005,Hawaii,949852,624246,65.7,606511,63.9,17735,2.8
17964,May 2005,Idaho,1052070,730002,69.4,699724,66.5,30278,4.1
17965,May 2005,Illinois,9599964,6385844,66.5,6017800,62.7,368044,5.8
17966,May 2005,Indiana,4745870,3198004,67.4,3025423,63.7,172581,5.4
17967,May 2005,Iowa,2272565,1626722,71.6,1557231,68.5,69491,4.3
17968,May 2005,Kansas,2064686,1465872,71.0,1391604,67.4,74268,5.1
17969,May 2005,Kentucky,3201197,1997275,62.4,1880054,58.7,117221,5.9
17970,May 2005,Louisiana,3353983,2069290,61.7,1950569,58.2,118721,5.7
17971,May 2005,Maine,1041902,696537,66.9,661978,63.5,34559,5.0
17972,May 2005,Maryland,4247232,2920572,68.8,2797210,65.9,123362,4.2
17973,May 2005,Massachusetts,5058419,3381815,66.9,3220299,63.7,161516,4.8
17974,May 2005,Michigan,7730645,5084921,65.8,4741734,61.3,343187,6.7
17975,May 2005,Minnesota,3922141,2876514,73.3,2760640,70.4,115874,4.0
17976,May 2005,Mississippi,2148711,1323712,61.6,1234609,57.5,89103,6.7
17977,May 2005,Missouri,4426897,3010528,68.0,2844793,64.3,165735,5.5
17978,May 2005,Montana,726519,484338,66.7,462760,63.7,21578,4.5
17979,May 2005,Nebraska,1322532,973270,73.6,935737,70.8,37533,3.9
17980,May 2005,Nevada,1810303,1217552,67.3,1167483,64.5,50069,4.1
17981,May 2005,New Hampshire,1017428,724795,71.2,699009,68.7,25786,3.6
17982,May 2005,New Jersey,6624552,4379679,66.1,4194121,63.3,185558,4.2
17983,May 2005,New Mexico,1432830,917038,64.0,868875,60.6,48163,5.3
17984,May 2005,New York,14990705,9442291,63.0,8976408,59.9,465883,4.9
17985,May 2005,North Carolina,6550103,4308724,65.8,4079626,62.3,229098,5.3
17986,May 2005,North Dakota,491189,354663,72.2,342558,69.7,12105,3.4
17987,May 2005,Ohio,8812021,5881530,66.7,5534841,62.8,346689,5.9
17988,May 2005,Oklahoma,2652663,1700503,64.1,1622435,61.2,78068,4.6
17989,May 2005,Oregon,2815829,1843557,65.5,1728180,61.4,115377,6.3
17990,May 2005,Pennsylvania,9690477,6250226,64.5,5937962,61.3,312264,5.0
17991,May 2005,Rhode Island,836766,564382,67.4,536253,64.1,28129,5.0
17992,May 2005,South Carolina,3223995,2059159,63.9,1923108,59.6,136051,6.6
17993,May 2005,South Dakota,588346,430470,73.2,413393,70.3,17077,4.0
17994,May 2005,Tennessee,4598137,2890729,62.9,2725777,59.3,164952,5.7
17995,May 2005,Texas,16570063,11078994,66.9,10483667,63.3,595327,5.4
17996,May 2005,Utah,1769922,1265797,71.5,1213626,68.6,52171,4.1
17997,May 2005,Vermont,494820,349220,70.6,337258,68.2,11962,3.4
17998,May 2005,Virginia,5693461,3889902,68.3,3748596,65.8,141306,3.6
17999,May 2005,Washington,4803272,3255582,67.8,3073548,64.0,182034,5.6
18000,May 2005,West Virginia,1434004,788016,55.0,747998,52.2,40018,5.1
18001,May 2005,Wisconsin,4278932,3013801,70.4,2873829,67.2,139972,4.6
18002,May 2005,Wyoming,389093,275826,70.9,265979,68.4,9847,3.6
18003,June 2005,Alabama,3473470,2144888,61.8,2050306,59.0,94582,4.4
18004,June 2005,Alaska,479556,344327,71.8,320986,66.9,23341,6.8
18005,June 2005,Arizona,4456434,2883042,64.7,2748627,61.7,134415,4.7
18006,June 2005,Arkansas,2110026,1346646,63.8,1276022,60.5,70624,5.2
18007,June 2005,California,26739187,17540210,65.6,16604725,62.1,935485,5.3
18008,June 2005,Colorado,3542670,2560668,72.3,2431252,68.6,129416,5.1
18009,June 2005,Connecticut,2675160,1797654,67.2,1708283,63.9,89371,5.0
18010,June 2005,Delaware,644233,432167,67.1,414168,64.3,17999,4.2
18011,June 2005,District of Columbia,466240,315576,67.7,295586,63.4,19990,6.3
18012,June 2005,Florida,13882354,8722052,62.8,8404767,60.5,317285,3.6
18013,June 2005,Georgia,6738611,4586274,68.1,4341637,64.4,244637,5.3
18014,June 2005,Hawaii,950463,626274,65.9,608636,64.0,17638,2.8
18015,June 2005,Idaho,1054536,732176,69.4,701796,66.6,30380,4.1
18016,June 2005,Illinois,9604737,6394147,66.6,6030415,62.8,363732,5.7
18017,June 2005,Indiana,4749491,3203640,67.5,3032446,63.8,171194,5.3
18018,June 2005,Iowa,2273770,1629173,71.7,1560325,68.6,68848,4.2
18019,June 2005,Kansas,2066217,1464871,70.9,1391771,67.4,73100,5.0
18020,June 2005,Kentucky,3204189,2001391,62.5,1883373,58.8,118018,5.9
18021,June 2005,Louisiana,3355571,2066629,61.6,1949152,58.1,117477,5.7
18022,June 2005,Maine,1042612,698109,67.0,663545,63.6,34564,5.0
18023,June 2005,Maryland,4251294,2924870,68.8,2803241,65.9,121629,4.2
18024,June 2005,Massachusetts,5060407,3383599,66.9,3222863,63.7,160736,4.8
18025,June 2005,Michigan,7733585,5088831,65.8,4750574,61.4,338257,6.6
18026,June 2005,Minnesota,3925387,2877789,73.3,2763859,70.4,113930,4.0
18027,June 2005,Mississippi,2150204,1323938,61.6,1234878,57.4,89060,6.7
18028,June 2005,Missouri,4431358,3010986,67.9,2850854,64.3,160132,5.3
18029,June 2005,Montana,727426,485027,66.7,463655,63.7,21372,4.4
18030,June 2005,Nebraska,1323452,972860,73.5,935952,70.7,36908,3.8
18031,June 2005,Nevada,1815436,1222554,67.3,1172024,64.6,50530,4.1
18032,June 2005,New Hampshire,1018484,725592,71.2,699763,68.7,25829,3.6
18033,June 2005,New Jersey,6627035,4390571,66.3,4204676,63.4,185895,4.2
18034,June 2005,New Mexico,1434814,918229,64.0,870801,60.7,47428,5.2
18035,June 2005,New York,14998300,9463924,63.1,8995850,60.0,468074,4.9
18036,June 2005,North Carolina,6560453,4318066,65.8,4090345,62.3,227721,5.3
18037,June 2005,North Dakota,491414,355041,72.2,342931,69.8,12110,3.4
18038,June 2005,Ohio,8815566,5887338,66.8,5546187,62.9,341151,5.8
18039,June 2005,Oklahoma,2654453,1703103,64.2,1625651,61.2,77452,4.5
18040,June 2005,Oregon,2819622,1845977,65.5,1730974,61.4,115003,6.2
18041,June 2005,Pennsylvania,9695414,6254784,64.5,5946247,61.3,308537,4.9
18042,June 2005,Rhode Island,836718,565671,67.6,537325,64.2,28346,5.0
18043,June 2005,South Carolina,3228722,2064409,63.9,1927938,59.7,136471,6.6
18044,June 2005,South Dakota,588961,430533,73.1,413714,70.2,16819,3.9
18045,June 2005,Tennessee,4604267,2897585,62.9,2736485,59.4,161100,5.6
18046,June 2005,Texas,16595241,11100075,66.9,10510835,63.3,589240,5.3
18047,June 2005,Utah,1774015,1270397,71.6,1218800,68.7,51597,4.1
18048,June 2005,Vermont,495183,349929,70.7,337858,68.2,12071,3.4
18049,June 2005,Virginia,5701112,3904202,68.5,3763447,66.0,140755,3.6
18050,June 2005,Washington,4809877,3264078,67.9,3082470,64.1,181608,5.6
18051,June 2005,West Virginia,1434264,790166,55.1,749977,52.3,40189,5.1
18052,June 2005,Wisconsin,4282435,3017810,70.5,2877497,67.2,140313,4.6
18053,June 2005,Wyoming,389407,276312,71.0,266351,68.4,9961,3.6
18054,July 2005,Alabama,3476528,2147465,61.8,2053965,59.1,93500,4.4
18055,July 2005,Alaska,480302,344890,71.8,321482,66.9,23408,6.8
18056,July 2005,Arizona,4470636,2892165,64.7,2758349,61.7,133816,4.6
18057,July 2005,Arkansas,2112310,1350816,63.9,1279994,60.6,70822,5.2
18058,July 2005,California,26761285,17561560,65.6,16630952,62.1,930608,5.3
18059,July 2005,Colorado,3547868,2563627,72.3,2435902,68.7,127725,5.0
18060,July 2005,Connecticut,2676356,1800098,67.3,1711312,63.9,88786,4.9
18061,July 2005,Delaware,645335,434173,67.3,415829,64.4,18344,4.2
18062,July 2005,District of Columbia,466557,315159,67.5,295929,63.4,19230,6.1
18063,July 2005,Florida,13912144,8750988,62.9,8440635,60.7,310353,3.5
18064,July 2005,Georgia,6752872,4600984,68.1,4354877,64.5,246107,5.3
18065,July 2005,Hawaii,951120,628344,66.1,610661,64.2,17683,2.8
18066,July 2005,Idaho,1057079,734006,69.4,703818,66.6,30188,4.1
18067,July 2005,Illinois,9609780,6402445,66.6,6041549,62.9,360896,5.6
18068,July 2005,Indiana,4753203,3209557,67.5,3037643,63.9,171914,5.4
18069,July 2005,Iowa,2275021,1631498,71.7,1562964,68.7,68534,4.2
18070,July 2005,Kansas,2067785,1464166,70.8,1391861,67.3,72305,4.9
18071,July 2005,Kentucky,3207234,2004820,62.5,1885865,58.8,118955,5.9
18072,July 2005,Louisiana,3357249,2054176,61.2,1940112,57.8,114064,5.6
18073,July 2005,Maine,1043312,699369,67.0,664850,63.7,34519,4.9
18074,July 2005,Maryland,4255488,2928758,68.8,2808488,66.0,120270,4.1
18075,July 2005,Massachusetts,5062501,3385328,66.9,3224220,63.7,161108,4.8
18076,July 2005,Michigan,7736738,5090770,65.8,4755602,61.5,335168,6.6
18077,July 2005,Minnesota,3928695,2879213,73.3,2766329,70.4,112884,3.9
18078,July 2005,Mississippi,2151754,1323800,61.5,1234135,57.4,89665,6.8
18079,July 2005,Missouri,4435880,3010963,67.9,2855153,64.4,155810,5.2
18080,July 2005,Montana,728315,485943,66.7,464773,63.8,21170,4.4
18081,July 2005,Nebraska,1324378,972608,73.4,936131,70.7,36477,3.8
18082,July 2005,Nevada,1820663,1227234,67.4,1176238,64.6,50996,4.2
18083,July 2005,New Hampshire,1019558,726481,71.3,700529,68.7,25952,3.6
18084,July 2005,New Jersey,6629791,4400906,66.4,4211674,63.5,189232,4.3
18085,July 2005,New Mexico,1436873,919348,64.0,872550,60.7,46798,5.1
18086,July 2005,New York,15006382,9483995,63.2,9010415,60.0,473580,5.0
18087,July 2005,North Carolina,6571003,4326594,65.8,4099272,62.4,227322,5.3
18088,July 2005,North Dakota,491617,355508,72.3,343393,69.8,12115,3.4
18089,July 2005,Ohio,8819325,5893551,66.8,5554446,63.0,339105,5.8
18090,July 2005,Oklahoma,2656290,1705454,64.2,1628840,61.3,76614,4.5
18091,July 2005,Oregon,2823483,1847975,65.5,1733417,61.4,114558,6.2
18092,July 2005,Pennsylvania,9700613,6258317,64.5,5951927,61.4,306390,4.9
18093,July 2005,Rhode Island,836702,566873,67.8,538269,64.3,28604,5.0
18094,July 2005,South Carolina,3233510,2070540,64.0,1932552,59.8,137988,6.7
18095,July 2005,South Dakota,589563,430596,73.0,414081,70.2,16515,3.8
18096,July 2005,Tennessee,4610566,2904679,63.0,2746907,59.6,157772,5.4
18097,July 2005,Texas,16621056,11125453,66.9,10537929,63.4,587524,5.3
18098,July 2005,Utah,1778097,1275042,71.7,1223769,68.8,51273,4.0
18099,July 2005,Vermont,495527,350734,70.8,338514,68.3,12220,3.5
18100,July 2005,Virginia,5708868,3915450,68.6,3774915,66.1,140535,3.6
18101,July 2005,Washington,4816608,3271882,67.9,3090131,64.2,181751,5.6
18102,July 2005,West Virginia,1434589,792336,55.2,751763,52.4,40573,5.1
18103,July 2005,Wisconsin,4286049,3022078,70.5,2880569,67.2,141509,4.7
18104,July 2005,Wyoming,389729,276797,71.0,266732,68.4,10065,3.6
18105,August 2005,Alabama,3480482,2149816,61.8,2056864,59.1,92952,4.3
18106,August 2005,Alaska,481163,345435,71.8,321872,66.9,23563,6.8
18107,August 2005,Arizona,4484551,2899721,64.7,2766145,61.7,133576,4.6
18108,August 2005,Arkansas,2114958,1354200,64.0,1283403,60.7,70797,5.2
18109,August 2005,California,26779322,17575912,65.6,16646161,62.2,929751,5.3
18110,August 2005,Colorado,3554004,2567051,72.2,2440650,68.7,126401,4.9
18111,August 2005,Connecticut,2677768,1802042,67.3,1714060,64.0,87982,4.9
18112,August 2005,Delaware,646369,435976,67.5,417363,64.6,18613,4.3
18113,August 2005,District of Columbia,466814,314808,67.4,296217,63.5,18591,5.9
18114,August 2005,Florida,13934021,8774258,63.0,8468400,60.8,305858,3.5
18115,August 2005,Georgia,6766443,4613436,68.2,4365474,64.5,247962,5.4
18116,August 2005,Hawaii,951794,630269,66.2,612494,64.4,17775,2.8
18117,August 2005,Idaho,1059593,735471,69.4,705844,66.6,29627,4.0
18118,August 2005,Illinois,9614723,6410083,66.7,6050646,62.9,359437,5.6
18119,August 2005,Indiana,4756761,3215056,67.6,3041156,63.9,173900,5.4
18120,August 2005,Iowa,2276379,1633815,71.8,1565232,68.8,68583,4.2
18121,August 2005,Kansas,2068690,1463835,70.8,1391978,67.3,71857,4.9
18122,August 2005,Kentucky,3210624,2007504,62.5,1887362,58.8,120142,6.0
18123,August 2005,Louisiana,3361183,2034100,60.5,1924460,57.3,109640,5.4
18124,August 2005,Maine,1043947,700223,67.1,665822,63.8,34401,4.9
18125,August 2005,Maryland,4258621,2931920,68.8,2812727,66.0,119193,4.1
18126,August 2005,Massachusetts,5064723,3386638,66.9,3224228,63.7,162410,4.8
18127,August 2005,Michigan,7738967,5090710,65.8,4756549,61.5,334161,6.6
18128,August 2005,Minnesota,3932287,2880941,73.3,2767972,70.4,112969,3.9
18129,August 2005,Mississippi,2155428,1323503,61.4,1232648,57.2,90855,6.9
18130,August 2005,Missouri,4440311,3010191,67.8,2857025,64.3,153166,5.1
18131,August 2005,Montana,729287,486967,66.8,466016,63.9,20951,4.3
18132,August 2005,Nebraska,1325114,972535,73.4,936276,70.7,36259,3.7
18133,August 2005,Nevada,1826077,1231465,67.4,1180260,64.6,51205,4.2
18134,August 2005,New Hampshire,1020651,727357,71.3,701271,68.7,26086,3.6
18135,August 2005,New Jersey,6631734,4409885,66.5,4214483,63.6,195402,4.4
18136,August 2005,New Mexico,1438868,920272,64.0,874069,60.7,46203,5.0
18137,August 2005,New York,15013158,9498246,63.3,9019218,60.1,479028,5.0
18138,August 2005,North Carolina,6583633,4333159,65.8,4106415,62.4,226744,5.2
18139,August 2005,North Dakota,491791,355993,72.4,343904,69.9,12089,3.4
18140,August 2005,Ohio,8822454,5899422,66.9,5559204,63.0,340218,5.8
18141,August 2005,Oklahoma,2659280,1707400,64.2,1631805,61.4,75595,4.4
18142,August 2005,Oregon,2828040,1849499,65.4,1735673,61.4,113826,6.2
18143,August 2005,Pennsylvania,9706213,6260117,64.5,5954398,61.3,305719,4.9
18144,August 2005,Rhode Island,836709,567903,67.9,539026,64.4,28877,5.1
18145,August 2005,South Carolina,3239610,2076433,64.1,1936392,59.8,140041,6.7
18146,August 2005,South Dakota,590216,430720,73.0,414516,70.2,16204,3.8
18147,August 2005,Tennessee,4617670,2912219,63.1,2756577,59.7,155642,5.3
18148,August 2005,Texas,16656333,11152336,67.0,10563342,63.4,588994,5.3
18149,August 2005,Utah,1782993,1279527,71.8,1228439,68.9,51088,4.0
18150,August 2005,Vermont,495840,351626,70.9,339254,68.4,12372,3.5
18151,August 2005,Virginia,5715542,3922921,68.6,3782705,66.2,140216,3.6
18152,August 2005,Washington,4825124,3278049,67.9,3096323,64.2,181726,5.5
18153,August 2005,West Virginia,1435056,794278,55.3,753342,52.5,40936,5.2
18154,August 2005,Wisconsin,4289172,3025959,70.5,2882778,67.2,143181,4.7
18155,August 2005,Wyoming,390245,277242,71.0,267111,68.4,10131,3.7
18156,September 2005,Alabama,3484482,2151648,61.7,2059203,59.1,92445,4.3
18157,September 2005,Alaska,482067,345921,71.8,322167,66.8,23754,6.9
18158,September 2005,Arizona,4498643,2906315,64.6,2772821,61.6,133494,4.6
18159,September 2005,Arkansas,2122332,1356821,63.9,1286450,60.6,70371,5.2
18160,September 2005,California,26798546,17581593,65.6,16652686,62.1,928907,5.3
18161,September 2005,Colorado,3560313,2571162,72.2,2445724,68.7,125438,4.9
18162,September 2005,Connecticut,2679281,1803819,67.3,1716835,64.1,86984,4.8
18163,September 2005,Delaware,647424,437521,67.6,418784,64.7,18737,4.3
18164,September 2005,District of Columbia,467067,314487,67.3,296356,63.5,18131,5.8
18165,September 2005,Florida,13956379,8792094,63.0,8489557,60.8,302537,3.4
18166,September 2005,Georgia,6780106,4622999,68.2,4374251,64.5,248748,5.4
18167,September 2005,Hawaii,952539,631847,66.3,614058,64.5,17789,2.8
18168,September 2005,Idaho,1062135,736753,69.4,707829,66.6,28924,3.9
18169,September 2005,Illinois,9619947,6416563,66.7,6058871,63.0,357692,5.6
18170,September 2005,Indiana,4760357,3219388,67.6,3043851,63.9,175537,5.5
18171,September 2005,Iowa,2277783,1635994,71.8,1567347,68.8,68647,4.2
18172,September 2005,Kansas,2069677,1463768,70.7,1392266,67.3,71502,4.9
18173,September 2005,Kentucky,3214075,2009458,62.5,1888154,58.7,121304,6.0
18174,September 2005,Louisiana,3162488,2147999,67.9,1905672,60.3,242327,11.3
18175,September 2005,Maine,1044621,700637,67.1,666479,63.8,34158,4.9
18176,September 2005,Maryland,4261842,2934284,68.9,2816234,66.1,118050,4.0
18177,September 2005,Massachusetts,5067045,3387457,66.9,3223430,63.6,164027,4.8
18178,September 2005,Michigan,7741284,5089332,65.7,4754220,61.4,335112,6.6
18179,September 2005,Minnesota,3935944,2883421,73.3,2769184,70.4,114237,4.0
18180,September 2005,Mississippi,2159130,1321041,61.2,1192086,55.2,128955,9.8
18181,September 2005,Missouri,4444835,3008871,67.7,2856782,64.3,152089,5.1
18182,September 2005,Montana,730293,487942,66.8,467299,64.0,20643,4.2
18183,September 2005,Nebraska,1325871,972447,73.3,936413,70.6,36034,3.7
18184,September 2005,Nevada,1831478,1235365,67.5,1184383,64.7,50982,4.1
18185,September 2005,New Hampshire,1021754,728020,71.3,701890,68.7,26130,3.6
18186,September 2005,New Jersey,6633923,4416958,66.6,4214091,63.5,202867,4.6
18187,September 2005,New Mexico,1440960,920961,63.9,875483,60.8,45478,4.9
18188,September 2005,New York,15020395,9505190,63.3,9023777,60.1,481413,5.1
18189,September 2005,North Carolina,6596369,4337720,65.8,4112969,62.4,224751,5.2
18190,September 2005,North Dakota,492004,356457,72.5,344430,70.0,12027,3.4
18191,September 2005,Ohio,8825781,5903799,66.9,5561662,63.0,342137,5.8
18192,September 2005,Oklahoma,2667366,1708771,64.1,1634489,61.3,74282,4.3
18193,September 2005,Oregon,2832682,1850744,65.3,1738105,61.4,112639,6.1
18194,September 2005,Pennsylvania,9711995,6260240,64.5,5954715,61.3,305525,4.9
18195,September 2005,Rhode Island,836767,568679,68.0,539553,64.5,29126,5.1
18196,September 2005,South Carolina,3245788,2081189,64.1,1939447,59.8,141742,6.8
18197,September 2005,South Dakota,590882,430889,72.9,415027,70.2,15862,3.7
18198,September 2005,Tennessee,4624873,2920522,63.1,2765803,59.8,154719,5.3
18199,September 2005,Texas,16739709,11177729,66.8,10586350,63.2,591379,5.3
18200,September 2005,Utah,1787954,1283692,71.8,1232859,69.0,50833,4.0
18201,September 2005,Vermont,496157,352577,71.1,340077,68.5,12500,3.5
18202,September 2005,Virginia,5722306,3927170,68.6,3787938,66.2,139232,3.5
18203,September 2005,Washington,4833784,3282487,67.9,3101633,64.2,180854,5.5
18204,September 2005,West Virginia,1435554,795845,55.4,754826,52.6,41019,5.2
18205,September 2005,Wisconsin,4292397,3028879,70.6,2884325,67.2,144554,4.8
18206,September 2005,Wyoming,390750,277625,71.0,267494,68.5,10131,3.6
18207,October 2005,Alabama,3491829,2153032,61.7,2061454,59.0,91578,4.3
18208,October 2005,Alaska,483268,346346,71.7,322426,66.7,23920,6.9
18209,October 2005,Arizona,4518189,2913070,64.5,2779796,61.5,133274,4.6
18210,October 2005,Arkansas,2122332,1358842,64.0,1289245,60.7,69597,5.1
18211,October 2005,California,26862414,17579571,65.4,16655732,62.0,923839,5.3
18212,October 2005,Colorado,3570629,2575937,72.1,2451484,68.7,124453,4.8
18213,October 2005,Connecticut,2683889,1805787,67.3,1719961,64.1,85826,4.8
18214,October 2005,Delaware,649203,438769,67.6,420089,64.7,18680,4.3
18215,October 2005,District of Columbia,468133,314209,67.1,296338,63.3,17871,5.7
18216,October 2005,Florida,13997572,8806801,62.9,8508014,60.8,298787,3.4
18217,October 2005,Georgia,6801551,4629890,68.1,4382902,64.4,246988,5.3
18218,October 2005,Hawaii,954631,632984,66.3,615308,64.5,17676,2.8
18219,October 2005,Idaho,1065643,738052,69.3,709721,66.6,28331,3.8
18220,October 2005,Illinois,9636489,6422142,66.6,6068506,63.0,353636,5.5
18221,October 2005,Indiana,4768332,3222419,67.6,3047022,63.9,175397,5.4
18222,October 2005,Iowa,2281089,1637915,71.8,1569561,68.8,68354,4.2
18223,October 2005,Kansas,2072575,1463818,70.6,1392818,67.2,71000,4.9
18224,October 2005,Kentucky,3219936,2011013,62.5,1888954,58.7,122059,6.1
18225,October 2005,Louisiana,3162488,2127220,67.3,1888518,59.7,238702,11.2
18226,October 2005,Maine,1046097,700687,67.0,666926,63.8,33761,4.8
18227,October 2005,Maryland,4270149,2936040,68.8,2819665,66.0,116375,4.0
18228,October 2005,Massachusetts,5074742,3388048,66.8,3222749,63.5,165299,4.9
18229,October 2005,Michigan,7751012,5087238,65.6,4750137,61.3,337101,6.6
18230,October 2005,Minnesota,3943026,2886643,73.2,2770439,70.3,116204,4.0
18231,October 2005,Mississippi,2123380,1309774,61.7,1190899,56.1,118875,9.1
18232,October 2005,Missouri,4453081,3007525,67.5,2855742,64.1,151783,5.0
18233,October 2005,Montana,731782,488727,66.8,468484,64.0,20243,4.1
18234,October 2005,Nebraska,1327891,972170,73.2,936574,70.5,35596,3.7
18235,October 2005,Nevada,1839147,1239289,67.4,1188899,64.6,50390,4.1
18236,October 2005,New Hampshire,1023799,728395,71.1,702413,68.6,25982,3.6
18237,October 2005,New Jersey,6644593,4421945,66.5,4212665,63.4,209280,4.7
18238,October 2005,New Mexico,1445508,921498,63.7,877016,60.7,44482,4.8
18239,October 2005,New York,15047970,9506360,63.2,9027025,60.0,479335,5.0
18240,October 2005,North Carolina,6615988,4341010,65.6,4120325,62.3,220685,5.1
18241,October 2005,North Dakota,492578,356888,72.5,344961,70.0,11927,3.3
18242,October 2005,Ohio,8836887,5905655,66.8,5563968,63.0,341687,5.8
18243,October 2005,Oklahoma,2667366,1709657,64.1,1636954,61.4,72703,4.3
18244,October 2005,Oregon,2839870,1851942,65.2,1741082,61.3,110860,6.0
18245,October 2005,Pennsylvania,9727342,6258921,64.3,5955095,61.2,303826,4.9
18246,October 2005,Rhode Island,837799,569173,67.9,539883,64.4,29290,5.1
18247,October 2005,South Carolina,3255386,2084476,64.0,1942199,59.7,142277,6.8
18248,October 2005,South Dakota,591942,431072,72.8,415608,70.2,15464,3.6
18249,October 2005,Tennessee,4636094,2929787,63.2,2775263,59.9,154524,5.3
18250,October 2005,Texas,16739709,11199663,66.9,10607524,63.4,592139,5.3
18251,October 2005,Utah,1794442,1287468,71.7,1237195,68.9,50273,3.9
18252,October 2005,Vermont,496958,353563,71.1,340969,68.6,12594,3.6
18253,October 2005,Virginia,5735305,3929641,68.5,3792574,66.1,137067,3.5
18254,October 2005,Washington,4846818,3285704,67.8,3107025,64.1,178679,5.4
18255,October 2005,West Virginia,1437071,797010,55.5,756398,52.6,40612,5.1
18256,October 2005,Wisconsin,4299451,3031085,70.5,2885814,67.1,145271,4.8
18257,October 2005,Wyoming,391594,277957,71.0,267897,68.4,10060,3.6
18258,November 2005,Alabama,3495703,2154321,61.6,2063787,59.0,90534,4.2
18259,November 2005,Alaska,484146,346737,71.6,322714,66.7,24023,6.9
18260,November 2005,Arizona,4532715,2920757,64.4,2787983,61.5,132774,4.5
18261,November 2005,Arkansas,2124968,1360553,64.0,1291767,60.8,68786,5.1
18262,November 2005,California,26886799,17572946,65.4,16659018,62.0,913928,5.2
18263,November 2005,Colorado,3577167,2581320,72.2,2458096,68.7,123224,4.8
18264,November 2005,Connecticut,2685408,1808090,67.3,1723561,64.2,84529,4.7
18265,November 2005,Delaware,650249,439663,67.6,421234,64.8,18429,4.2
18266,November 2005,District of Columbia,468403,313962,67.0,296167,63.2,17795,5.7
18267,November 2005,Florida,14020653,8820710,62.9,8526523,60.8,294187,3.3
18268,November 2005,Georgia,6815405,4635061,68.0,4392442,64.4,242619,5.2
18269,November 2005,Hawaii,955583,633728,66.3,616227,64.5,17501,2.8
18270,November 2005,Idaho,1068173,739524,69.2,711507,66.6,28017,3.8
18271,November 2005,Illinois,9642026,6427836,66.7,6080747,63.1,347089,5.4
18272,November 2005,Indiana,4771850,3224519,67.6,3051236,63.9,173283,5.4
18273,November 2005,Iowa,2282350,1639578,71.8,1572098,68.9,67480,4.1
18274,November 2005,Kansas,2073513,1463839,70.6,1393575,67.2,70264,4.8
18275,November 2005,Kentucky,3223221,2012576,62.4,1890365,58.6,122211,6.1
18276,November 2005,Louisiana,3163098,2112977,66.8,1876711,59.3,236266,11.2
18277,November 2005,Maine,1046684,700509,66.9,667305,63.8,33204,4.7
18278,November 2005,Maryland,4273424,2937660,68.7,2823477,66.1,114183,3.9
18279,November 2005,Massachusetts,5077035,3388752,66.7,3222650,63.5,166102,4.9
18280,November 2005,Michigan,7753142,5085552,65.6,4745559,61.2,339993,6.7
18281,November 2005,Minnesota,3946572,2889921,73.2,2771757,70.2,118164,4.1
18282,November 2005,Mississippi,2123831,1306981,61.5,1190681,56.1,116300,8.9
18283,November 2005,Missouri,4457379,3006793,67.5,2855154,64.1,151639,5.0
18284,November 2005,Montana,732721,489304,66.8,469521,64.1,19783,4.0
18285,November 2005,Nebraska,1328595,971620,73.1,936774,70.5,34846,3.6
18286,November 2005,Nevada,1844820,1243573,67.4,1193843,64.7,49730,4.0
18287,November 2005,New Hampshire,1024878,728529,71.1,702920,68.6,25609,3.5
18288,November 2005,New Jersey,6647022,4425361,66.6,4211802,63.4,213559,4.8
18289,November 2005,New Mexico,1447908,921896,63.7,878713,60.7,43183,4.7
18290,November 2005,New York,15056080,9504409,63.1,9030508,60.0,473901,5.0
18291,November 2005,North Carolina,6628743,4344399,65.5,4129258,62.3,215141,5.0
18292,November 2005,North Dakota,492735,357295,72.5,345492,70.1,11803,3.3
18293,November 2005,Ohio,8839733,5905582,66.8,5567599,63.0,337983,5.7
18294,November 2005,Oklahoma,2670374,1710149,64.0,1639045,61.4,71104,4.2
18295,November 2005,Oregon,2844462,1853367,65.2,1744788,61.3,108579,5.9
18296,November 2005,Pennsylvania,9732648,6257315,64.3,5957167,61.2,300148,4.8
18297,November 2005,Rhode Island,837848,569491,68.0,540165,64.5,29326,5.1
18298,November 2005,South Carolina,3261545,2086755,64.0,1945206,59.6,141549,6.8
18299,November 2005,South Dakota,592604,431219,72.8,416219,70.2,15000,3.5
18300,November 2005,Tennessee,4643173,2940303,63.3,2785361,60.0,154942,5.3
18301,November 2005,Texas,16746390,11217536,67.0,10626919,63.5,590617,5.3
18302,November 2005,Utah,1799404,1290896,71.7,1241636,69.0,49260,3.8
18303,November 2005,Vermont,497275,354502,71.3,341863,68.7,12639,3.6
18304,November 2005,Virginia,5742125,3931532,68.5,3797763,66.1,133769,3.4
18305,November 2005,Washington,4855511,3288337,67.7,3113055,64.1,175282,5.3
18306,November 2005,West Virginia,1437451,797826,55.5,758099,52.7,39727,5.0
18307,November 2005,Wisconsin,4302495,3033045,70.5,2887733,67.1,145312,4.8
18308,November 2005,Wyoming,392128,278248,71.0,268336,68.4,9912,3.6
18309,December 2005,Alabama,3499904,2155457,61.6,2065979,59.0,89478,4.2
18310,December 2005,Alaska,485094,347121,71.6,323068,66.6,24053,6.9
18311,December 2005,Arizona,4547225,2929493,64.4,2797474,61.5,132019,4.5
18312,December 2005,Arkansas,2127798,1362062,64.0,1293826,60.8,68236,5.0
18313,December 2005,California,26910607,17565004,65.3,16664323,61.9,900681,5.1
18314,December 2005,Colorado,3583738,2587078,72.2,2465346,68.8,121732,4.7
18315,December 2005,Connecticut,2687028,1810621,67.4,1727536,64.3,83085,4.6
18316,December 2005,Delaware,651324,440190,67.6,422177,64.8,18013,4.1
18317,December 2005,District of Columbia,468752,313718,66.9,295872,63.1,17846,5.7
18318,December 2005,Florida,14044122,8835349,62.9,8546237,60.9,289112,3.3
18319,December 2005,Georgia,6829755,4639473,67.9,4402961,64.5,236512,5.1
18320,December 2005,Hawaii,956608,634192,66.3,616834,64.5,17358,2.7
18321,December 2005,Idaho,1070764,741136,69.2,713192,66.6,27944,3.8
18322,December 2005,Illinois,9648009,6433912,66.7,6095642,63.2,338270,5.3
18323,December 2005,Indiana,4775674,3226016,67.6,3056016,64.0,170000,5.3
18324,December 2005,Iowa,2283791,1641217,71.9,1575196,69.0,66021,4.0
18325,December 2005,Kansas,2074556,1463686,70.6,1394437,67.2,69249,4.7
18326,December 2005,Kentucky,3226778,2014172,62.4,1892537,58.7,121635,6.0
18327,December 2005,Louisiana,3164830,2000436,63.2,1871772,59.1,128664,6.4
18328,December 2005,Maine,1047375,700196,66.9,667677,63.7,32519,4.6
18329,December 2005,Maryland,4277029,2939622,68.7,2827630,66.1,111992,3.8
18330,December 2005,Massachusetts,5079565,3389812,66.7,3223202,63.5,166610,4.9
18331,December 2005,Michigan,7755832,5084546,65.6,4741118,61.1,343428,6.8
18332,December 2005,Minnesota,3950331,2891905,73.2,2772670,70.2,119235,4.1
18333,December 2005,Mississippi,2125280,1294641,60.9,1191533,56.1,103108,8.0
18334,December 2005,Missouri,4462051,3006784,67.4,2855836,64.0,150948,5.0
18335,December 2005,Montana,733738,489764,66.7,470448,64.1,19316,3.9
18336,December 2005,Nebraska,1329407,970820,73.0,937001,70.5,33819,3.5
18337,December 2005,Nevada,1850497,1248389,67.5,1199088,64.8,49301,3.9
18338,December 2005,New Hampshire,1026045,728492,71.0,703425,68.6,25067,3.4
18339,December 2005,New Jersey,6649738,4427912,66.6,4212013,63.3,215899,4.9
18340,December 2005,New Mexico,1450277,922189,63.6,880470,60.7,41719,4.5
18341,December 2005,New York,15064730,9500990,63.1,9034673,60.0,466317,4.9
18342,December 2005,North Carolina,6641991,4349449,65.5,4140105,62.3,209344,4.8
18343,December 2005,North Dakota,492928,357696,72.6,346022,70.2,11674,3.3
18344,December 2005,Ohio,8843248,5904428,66.8,5572827,63.0,331601,5.6
18345,December 2005,Oklahoma,2673539,1710348,64.0,1640496,61.4,69852,4.1
18346,December 2005,Oregon,2849175,1855220,65.1,1749274,61.4,105946,5.7
18347,December 2005,Pennsylvania,9738584,6256848,64.2,5961237,61.2,295611,4.7
18348,December 2005,Rhode Island,837949,569789,68.0,540554,64.5,29235,5.1
18349,December 2005,South Carolina,3267963,2088840,63.9,1948878,59.6,139962,6.7
18350,December 2005,South Dakota,593279,431305,72.7,416833,70.3,14472,3.4
18351,December 2005,Tennessee,4650602,2951826,63.5,2796181,60.1,155645,5.3
18352,December 2005,Texas,16761096,11231225,67.0,10644156,63.5,587069,5.2
18353,December 2005,Utah,1804466,1294101,71.7,1246305,69.1,47796,3.7
18354,December 2005,Vermont,497626,355289,71.4,342665,68.9,12624,3.6
18355,December 2005,Virginia,5749362,3933528,68.4,3803760,66.2,129768,3.3
18356,December 2005,Washington,4864388,3290871,67.7,3119645,64.1,171226,5.2
18357,December 2005,West Virginia,1437956,798566,55.5,759866,52.8,38700,4.8
18358,December 2005,Wisconsin,4305860,3034989,70.5,2890289,67.1,144700,4.8
18359,December 2005,Wyoming,392682,278517,70.9,268825,68.5,9692,3.5
18360,January 2006,Alabama,3503666,2156619,61.6,2068193,59.0,88426,4.1
18361,January 2006,Alaska,485968,347570,71.5,323577,66.6,23993,6.9
18362,January 2006,Arizona,4561185,2939280,64.4,2808150,61.6,131130,4.5
18363,January 2006,Arkansas,2130322,1363542,64.0,1295400,60.8,68142,5.0
18364,January 2006,California,26930839,17561146,65.2,16674718,61.9,886428,5.0
18365,January 2006,Colorado,3589857,2593076,72.2,2472957,68.9,120119,4.6
18366,January 2006,Connecticut,2688340,1813299,67.5,1731745,64.4,81554,4.5
18367,January 2006,Delaware,652379,440411,67.5,422937,64.8,17474,4.0
18368,January 2006,District of Columbia,469028,313570,66.9,295622,63.0,17948,5.7
18369,January 2006,Florida,14065590,8853722,62.9,8569326,60.9,284396,3.2
18370,January 2006,Georgia,6843197,4645079,67.9,4414893,64.5,230186,5.0
18371,January 2006,Hawaii,957451,634584,66.3,617244,64.5,17340,2.7
18372,January 2006,Idaho,1073261,742772,69.2,714822,66.6,27950,3.8
18373,January 2006,Illinois,9652716,6441382,66.7,6113695,63.3,327687,5.1
18374,January 2006,Indiana,4778850,3227663,67.5,3061006,64.1,166657,5.2
18375,January 2006,Iowa,2284916,1643212,71.9,1579074,69.1,64138,3.9
18376,January 2006,Kansas,2075320,1463409,70.5,1395415,67.2,67994,4.6
18377,January 2006,Kentucky,3229869,2015812,62.4,1895547,58.7,120265,6.0
18378,January 2006,Louisiana,3166964,1970870,62.2,1873393,59.2,97477,4.9
18379,January 2006,Maine,1047909,699919,66.8,668084,63.8,31835,4.5
18380,January 2006,Maryland,4280040,2942501,68.7,2832115,66.2,110386,3.8
18381,January 2006,Massachusetts,5081434,3391733,66.7,3224753,63.5,166980,4.9
18382,January 2006,Michigan,7757479,5084510,65.5,4737934,61.1,346576,6.8
18383,January 2006,Minnesota,3953580,2891833,73.1,2773083,70.1,118750,4.1
18384,January 2006,Mississippi,2127247,1288543,60.6,1193451,56.1,95092,7.4
18385,January 2006,Missouri,4466089,3007652,67.3,2858395,64.0,149257,5.0
18386,January 2006,Montana,734619,490268,66.7,471379,64.2,18889,3.9
18387,January 2006,Nebraska,1330057,969913,72.9,937279,70.5,32634,3.4
18388,January 2006,Nevada,1855912,1253883,67.6,1204617,64.9,49266,3.9
18389,January 2006,New Hampshire,1027051,728449,70.9,703970,68.5,24479,3.4
18390,January 2006,New Jersey,6651518,4430373,66.6,4213782,63.4,216591,4.9
18391,January 2006,New Mexico,1452381,922673,63.5,882331,60.8,40342,4.4
18392,January 2006,New York,15071428,9499541,63.0,9041288,60.0,458253,4.8
18393,January 2006,North Carolina,6654329,4358009,65.5,4153422,62.4,204587,4.7
18394,January 2006,North Dakota,493054,358126,72.6,346574,70.3,11552,3.2
18395,January 2006,Ohio,8845558,5903730,66.7,5580139,63.1,323591,5.5
18396,January 2006,Oklahoma,2676326,1710576,63.9,1641554,61.3,69022,4.0
18397,January 2006,Oregon,2853540,1857859,65.1,1754562,61.5,103297,5.6
18398,January 2006,Pennsylvania,9743262,6259101,64.2,5967749,61.3,291352,4.7
18399,January 2006,Rhode Island,837917,570195,68.0,541149,64.6,29046,5.1
18400,January 2006,South Carolina,3273927,2091581,63.9,1953362,59.7,138219,6.6
18401,January 2006,South Dakota,593857,431391,72.6,417472,70.3,13919,3.2
18402,January 2006,Tennessee,4657345,2964423,63.7,2808107,60.3,156316,5.3
18403,January 2006,Texas,16781676,11243681,67.0,10660955,63.5,582726,5.2
18404,January 2006,Utah,1809287,1297394,71.7,1251363,69.2,46031,3.5
18405,January 2006,Vermont,497880,355891,71.5,343325,69.0,12566,3.5
18406,January 2006,Virginia,5755845,3936945,68.4,3811208,66.2,125737,3.2
18407,January 2006,Washington,4872643,3294087,67.6,3126598,64.2,167489,5.1
18408,January 2006,West Virginia,1438237,799559,55.6,761664,53.0,37895,4.7
18409,January 2006,Wisconsin,4308593,3037389,70.5,2893753,67.2,143636,4.7
18410,January 2006,Wyoming,393128,278812,70.9,269389,68.5,9423,3.4
18411,February 2006,Alabama,3507068,2158218,61.5,2070573,59.0,87645,4.1
18412,February 2006,Alaska,486740,348126,71.5,324279,66.6,23847,6.9
18413,February 2006,Arizona,4574548,2949623,64.5,2819292,61.6,130331,4.4
18414,February 2006,Arkansas,2132647,1364932,64.0,1296413,60.8,68519,5.0
18415,February 2006,California,26947217,17565016,65.2,16690636,61.9,874380,5.0
18416,February 2006,Colorado,3595664,2599087,72.3,2480468,69.0,118619,4.6
18417,February 2006,Connecticut,2689362,1816031,67.5,1735885,64.5,80146,4.4
18418,February 2006,Delaware,653305,440431,67.4,423547,64.8,16884,3.8
18419,February 2006,District of Columbia,469249,313649,66.8,295585,63.0,18064,5.8
18420,February 2006,Florida,14085252,8877120,63.0,8596033,61.0,281087,3.2
18421,February 2006,Georgia,6856084,4653418,67.9,4428047,64.6,225371,4.8
18422,February 2006,Hawaii,958135,635058,66.3,617569,64.5,17489,2.8
18423,February 2006,Idaho,1075601,744226,69.2,716360,66.6,27866,3.7
18424,February 2006,Illinois,9656519,6451005,66.8,6134401,63.5,316604,4.9
18425,February 2006,Indiana,4781693,3229879,67.5,3065503,64.1,164376,5.1
18426,February 2006,Iowa,2285822,1645764,72.0,1583589,69.3,62175,3.8
18427,February 2006,Kansas,2075909,1463157,70.5,1396486,67.3,66671,4.6
18428,February 2006,Kentucky,3232798,2017547,62.4,1899105,58.7,118442,5.9
18429,February 2006,Louisiana,3169757,1975302,62.3,1878894,59.3,96408,4.9
18430,February 2006,Maine,1048355,699784,66.8,668457,63.8,31327,4.5
18431,February 2006,Maryland,4282638,2946596,68.8,2836642,66.2,109954,3.7
18432,February 2006,Massachusetts,5082903,3394702,66.8,3227416,63.5,167286,4.9
18433,February 2006,Michigan,7758526,5085158,65.5,4736004,61.0,349154,6.9
18434,February 2006,Minnesota,3956568,2890024,73.0,2773084,70.1,116940,4.0
18435,February 2006,Mississippi,2129927,1286946,60.4,1195987,56.2,90959,7.1
18436,February 2006,Missouri,4469775,3009391,67.3,2862614,64.0,146777,4.9
18437,February 2006,Montana,735491,491041,66.8,472510,64.2,18531,3.8
18438,February 2006,Nebraska,1330588,969094,72.8,937614,70.5,31480,3.2
18439,February 2006,Nevada,1861136,1259969,67.7,1210300,65.0,49669,3.9
18440,February 2006,New Hampshire,1028027,728603,70.9,704591,68.5,24012,3.3
18441,February 2006,New Jersey,6652616,4433166,66.6,4216824,63.4,216342,4.9
18442,February 2006,New Mexico,1454313,923526,63.5,884251,60.8,39275,4.3
18443,February 2006,New York,15076445,9502227,63.0,9050364,60.0,451863,4.8
18444,February 2006,North Carolina,6666109,4370845,65.6,4168895,62.5,201950,4.6
18445,February 2006,North Dakota,493192,358598,72.7,347130,70.4,11468,3.2
18446,February 2006,Ohio,8847270,5905344,66.7,5588997,63.2,316347,5.4
18447,February 2006,Oklahoma,2678907,1710961,63.9,1642510,61.3,68451,4.0
18448,February 2006,Oregon,2857633,1861515,65.1,1760467,61.6,101048,5.4
18449,February 2006,Pennsylvania,9747075,6264415,64.3,5975891,61.3,288524,4.6
18450,February 2006,Rhode Island,837807,570721,68.1,541898,64.7,28823,5.1
18451,February 2006,South Carolina,3279623,2095040,63.9,1958087,59.7,136953,6.5
18452,February 2006,South Dakota,594424,431569,72.6,418136,70.3,13433,3.1
18453,February 2006,Tennessee,4663797,2978405,63.9,2821108,60.5,157297,5.3
18454,February 2006,Texas,16808414,11258185,67.0,10678976,63.5,579209,5.1
18455,February 2006,Utah,1814025,1301064,71.7,1256815,69.3,44249,3.4
18456,February 2006,Vermont,498164,356312,71.5,343805,69.0,12507,3.5
18457,February 2006,Virginia,5761823,3942457,68.4,3819918,66.3,122539,3.1
18458,February 2006,Washington,4880489,3298432,67.6,3133419,64.2,165013,5.0
18459,February 2006,West Virginia,1438480,800876,55.7,763311,53.1,37565,4.7
18460,February 2006,Wisconsin,4311099,3040532,70.5,2897965,67.2,142567,4.7
18461,February 2006,Wyoming,393646,279172,70.9,270022,68.6,9150,3.3
18462,March 2006,Alabama,3510348,2160541,61.5,2072993,59.1,87548,4.1
18463,March 2006,Alaska,487558,348739,71.5,325088,66.7,23651,6.8
18464,March 2006,Arizona,4587109,2959737,64.5,2829981,61.7,129756,4.4
18465,March 2006,Arkansas,2134861,1365983,64.0,1296777,60.7,69206,5.1
18466,March 2006,California,26956842,17576896,65.2,16709255,62.0,867641,4.9
18467,March 2006,Colorado,3601065,2604902,72.3,2487438,69.1,117464,4.5
18468,March 2006,Connecticut,2690127,1818754,67.6,1739630,64.7,79124,4.4
18469,March 2006,Delaware,654229,440389,67.3,424031,64.8,16358,3.7
18470,March 2006,District of Columbia,469395,313980,66.9,295794,63.0,18186,5.8
18471,March 2006,Florida,14102496,8904294,63.1,8624006,61.2,280288,3.1
18472,March 2006,Georgia,6868440,4664682,67.9,4441382,64.7,223300,4.8
18473,March 2006,Hawaii,958572,635644,66.3,617908,64.5,17736,2.8
18474,March 2006,Idaho,1077916,745345,69.1,717733,66.6,27612,3.7
18475,March 2006,Illinois,9659302,6463362,66.9,6156184,63.7,307178,4.8
18476,March 2006,Indiana,4784419,3232615,67.6,3068590,64.1,164025,5.1
18477,March 2006,Iowa,2286724,1648831,72.1,1588259,69.5,60572,3.7
18478,March 2006,Kansas,2076427,1463113,70.5,1397574,67.3,65539,4.5
18479,March 2006,Kentucky,3235660,2019369,62.4,1902674,58.8,116695,5.8
18480,March 2006,Louisiana,3174981,1977843,62.3,1884164,59.3,93679,4.7
18481,March 2006,Maine,1048785,699813,66.7,668692,63.8,31121,4.4
18482,March 2006,Maryland,4284856,2951704,68.9,2840644,66.3,111060,3.8
18483,March 2006,Massachusetts,5084043,3398484,66.8,3230833,63.5,167651,4.9
18484,March 2006,Michigan,7759212,5085590,65.5,4733980,61.0,351610,6.9
18485,March 2006,Minnesota,3959476,2887173,72.9,2772660,70.0,114513,4.0
18486,March 2006,Mississippi,2134966,1284559,60.2,1198470,56.1,86089,6.7
18487,March 2006,Missouri,4473367,3012023,67.3,2867493,64.1,144530,4.8
18488,March 2006,Montana,736318,492154,66.8,473899,64.4,18255,3.7
18489,March 2006,Nebraska,1331045,968545,72.8,937971,70.5,30574,3.2
18490,March 2006,Nevada,1866056,1266412,67.9,1215970,65.2,50442,4.0
18491,March 2006,New Hampshire,1028953,729045,70.9,705245,68.5,23800,3.3
18492,March 2006,New Jersey,6652747,4436522,66.7,4220327,63.4,216195,4.9
18493,March 2006,New Mexico,1455737,924679,63.5,886002,60.9,38677,4.2
18494,March 2006,New York,15079345,9508146,63.1,9059283,60.1,448863,4.7
18495,March 2006,North Carolina,6677429,4387360,65.7,4185233,62.7,202127,4.6
18496,March 2006,North Dakota,493276,359095,72.8,347641,70.5,11454,3.2
18497,March 2006,Ohio,8848684,5910571,66.8,5597940,63.3,312631,5.3
18498,March 2006,Oklahoma,2681324,1711493,63.8,1643505,61.3,67988,4.0
18499,March 2006,Oregon,2861501,1866141,65.2,1766594,61.7,99547,5.3
18500,March 2006,Pennsylvania,9750419,6271841,64.3,5983704,61.4,288137,4.6
18501,March 2006,Rhode Island,837636,571275,68.2,542645,64.8,28630,5.0
18502,March 2006,South Carolina,3285071,2098644,63.9,1962044,59.7,136600,6.5
18503,March 2006,South Dakota,594965,431934,72.6,418827,70.4,13107,3.0
18504,March 2006,Tennessee,4670063,2993679,64.1,2834566,60.7,159113,5.3
18505,March 2006,Texas,16856023,11275668,66.9,10698620,63.5,577048,5.1
18506,March 2006,Utah,1818717,1305187,71.8,1262412,69.4,42775,3.3
18507,March 2006,Vermont,498398,356569,71.5,344067,69.0,12502,3.5
18508,March 2006,Virginia,5767386,3949684,68.5,3828751,66.4,120933,3.1
18509,March 2006,Washington,4888004,3303711,67.6,3139335,64.2,164376,5.0
18510,March 2006,West Virginia,1438683,802425,55.8,764567,53.1,37858,4.7
18511,March 2006,Wisconsin,4313453,3044307,70.6,2902335,67.3,141972,4.7
18512,March 2006,Wyoming,394067,279595,71.0,270671,68.7,8924,3.2
18513,April 2006,Alabama,3513803,2163401,61.6,2075248,59.1,88153,4.1
18514,April 2006,Alaska,488418,349356,71.5,325904,66.7,23452,6.7
18515,April 2006,Arizona,4599748,2969004,64.5,2839639,61.7,129365,4.4
18516,April 2006,Arkansas,2137212,1366445,63.9,1296429,60.7,70016,5.1
18517,April 2006,California,26966975,17594446,65.2,16727583,62.0,866863,4.9
18518,April 2006,Colorado,3606595,2610429,72.4,2493685,69.1,116744,4.5
18519,April 2006,Connecticut,2690984,1821409,67.7,1742733,64.8,78676,4.3
18520,April 2006,Delaware,655160,440409,67.2,424410,64.8,15999,3.6
18521,April 2006,District of Columbia,469569,314507,67.0,296191,63.1,18316,5.8
18522,April 2006,Florida,14120197,8933122,63.3,8650813,61.3,282309,3.2
18523,April 2006,Georgia,6881073,4677681,68.0,4454027,64.7,223654,4.8
18524,April 2006,Hawaii,959152,636333,66.3,618399,64.5,17934,2.8
18525,April 2006,Idaho,1080272,746086,69.1,718909,66.5,27177,3.6
18526,April 2006,Illinois,9662467,6478443,67.0,6177693,63.9,300750,4.6
18527,April 2006,Indiana,4787349,3235137,67.6,3069699,64.1,165438,5.1
18528,April 2006,Iowa,2287744,1652343,72.2,1592593,69.6,59750,3.6
18529,April 2006,Kansas,2076998,1463377,70.5,1398637,67.3,64740,4.4
18530,April 2006,Kentucky,3238700,2021371,62.4,1905725,58.8,115646,5.7
18531,April 2006,Louisiana,3180290,1976914,62.2,1887383,59.3,89531,4.5
18532,April 2006,Maine,1049273,700001,66.7,668766,63.7,31235,4.5
18533,April 2006,Maryland,4287265,2957212,69.0,2843732,66.3,113480,3.8
18534,April 2006,Massachusetts,5085460,3402686,66.9,3234583,63.6,168103,4.9
18535,April 2006,Michigan,7760312,5084860,65.5,4730557,61.0,354303,7.0
18536,April 2006,Minnesota,3962617,2884084,72.8,2771919,70.0,112165,3.9
18537,April 2006,Mississippi,2140074,1285124,60.1,1200712,56.1,84412,6.6
18538,April 2006,Missouri,4477206,3015514,67.4,2871997,64.1,143517,4.8
18539,April 2006,Montana,737179,493417,66.9,475372,64.5,18045,3.7
18540,April 2006,Nebraska,1331622,968390,72.7,938339,70.5,30051,3.1
18541,April 2006,Nevada,1871057,1272915,68.0,1221527,65.3,51388,4.0
18542,April 2006,New Hampshire,1029936,729737,70.9,705862,68.5,23875,3.3
18543,April 2006,New Jersey,6653203,4440268,66.7,4223517,63.5,216751,4.9
18544,April 2006,New Mexico,1457199,926021,63.5,887443,60.9,38578,4.2
18545,April 2006,New York,15082831,9513981,63.1,9065340,60.1,448641,4.7
18546,April 2006,North Carolina,6689030,4405948,65.9,4200959,62.8,204989,4.7
18547,April 2006,North Dakota,493406,359588,72.9,348103,70.6,11485,3.2
18548,April 2006,Ohio,8850579,5919107,66.9,5605756,63.3,313351,5.3
18549,April 2006,Oklahoma,2683861,1712150,63.8,1644496,61.3,67654,4.0
18550,April 2006,Oregon,2865540,1871463,65.3,1772508,61.9,98955,5.3
18551,April 2006,Pennsylvania,9754252,6280125,64.4,5989895,61.4,290230,4.6
18552,April 2006,Rhode Island,837492,571773,68.3,543275,64.9,28498,5.0
18553,April 2006,South Carolina,3290670,2101750,63.9,1964648,59.7,137102,6.5
18554,April 2006,South Dakota,595529,432537,72.6,419540,70.4,12997,3.0
18555,April 2006,Tennessee,4676556,3009543,64.4,2847608,60.9,161935,5.4
18556,April 2006,Texas,16903616,11294545,66.8,10718758,63.4,575787,5.1
18557,April 2006,Utah,1823477,1309543,71.8,1267867,69.5,41676,3.2
18558,April 2006,Vermont,498663,356729,71.5,344135,69.0,12594,3.5
18559,April 2006,Virginia,5773199,3957762,68.6,3836685,66.5,121077,3.1
18560,April 2006,Washington,4895740,3309480,67.6,3143972,64.2,165508,5.0
18561,April 2006,West Virginia,1438942,804064,55.9,765321,53.2,38743,4.8
18562,April 2006,Wisconsin,4316003,3048460,70.6,2906232,67.3,142228,4.7
18563,April 2006,Wyoming,394526,280073,71.0,271282,68.8,8791,3.1
18564,May 2006,Alabama,3517270,2166179,61.6,2077289,59.1,88890,4.1
18565,May 2006,Alaska,489223,349888,71.5,326612,66.8,23276,6.7
18566,May 2006,Arizona,4612292,2977575,64.6,2848714,61.8,128861,4.3
18567,May 2006,Arkansas,2139601,1366148,63.9,1295426,60.5,70722,5.2
18568,May 2006,California,26975501,17613866,65.3,16745410,62.1,868456,4.9
18569,May 2006,Colorado,3612117,2615748,72.4,2499528,69.2,116220,4.4
18570,May 2006,Connecticut,2691896,1823953,67.8,1745232,64.8,78721,4.3
18571,May 2006,Delaware,656124,440551,67.1,424730,64.7,15821,3.6
18572,May 2006,District of Columbia,469711,315172,67.1,296731,63.2,18441,5.9
18573,May 2006,Florida,14138018,8961699,63.4,8675890,61.4,285809,3.2
18574,May 2006,Georgia,6893679,4690836,68.0,4466158,64.8,224678,4.8
18575,May 2006,Hawaii,959626,637075,66.4,619140,64.5,17935,2.8
18576,May 2006,Idaho,1082700,746498,68.9,719924,66.5,26574,3.6
18577,May 2006,Illinois,9665568,6495465,67.2,6199195,64.1,296270,4.6
18578,May 2006,Indiana,4790472,3236605,67.6,3069259,64.1,167346,5.2
18579,May 2006,Iowa,2288903,1656081,72.4,1596291,69.7,59790,3.6
18580,May 2006,Kansas,2077663,1463985,70.5,1399755,67.4,64230,4.4
18581,May 2006,Kentucky,3241908,2023695,62.4,1908254,58.9,115441,5.7
18582,May 2006,Louisiana,3185670,1975582,62.0,1890039,59.3,85543,4.3
18583,May 2006,Maine,1049820,700322,66.7,668737,63.7,31585,4.5
18584,May 2006,Maryland,4289562,2962281,69.1,2845977,66.3,116304,3.9
18585,May 2006,Massachusetts,5086934,3406936,67.0,3238660,63.7,168276,4.9
18586,May 2006,Michigan,7761618,5082566,65.5,4725614,60.9,356952,7.0
18587,May 2006,Minnesota,3965924,2881531,72.7,2771090,69.9,110441,3.8
18588,May 2006,Mississippi,2145215,1286336,60.0,1202929,56.1,83407,6.5
18589,May 2006,Missouri,4481216,3019700,67.4,2875895,64.2,143805,4.8
18590,May 2006,Montana,738094,494503,67.0,476642,64.6,17861,3.6
18591,May 2006,Nebraska,1332250,968635,72.7,938714,70.5,29921,3.1
18592,May 2006,Nevada,1875961,1279144,68.2,1226923,65.4,52221,4.1
18593,May 2006,New Hampshire,1030955,730575,70.9,706396,68.5,24179,3.3
18594,May 2006,New Jersey,6653548,4443827,66.8,4226416,63.5,217411,4.9
18595,May 2006,New Mexico,1458612,927394,63.6,888560,60.9,38834,4.2
18596,May 2006,New York,15085944,9516161,63.1,9068445,60.1,447716,4.7
18597,May 2006,North Carolina,6700727,4424459,66.0,4215455,62.9,209004,4.7
18598,May 2006,North Dakota,493588,360068,72.9,348553,70.6,11515,3.2
18599,May 2006,Ohio,8852737,5929368,67.0,5612471,63.4,316897,5.3
18600,May 2006,Oklahoma,2686494,1712967,63.8,1645401,61.2,67566,3.9
18601,May 2006,Oregon,2869684,1877083,65.4,1778011,62.0,99072,5.3
18602,May 2006,Pennsylvania,9758456,6287729,64.4,5994630,61.4,293099,4.7
18603,May 2006,Rhode Island,837393,572187,68.3,543769,64.9,28418,5.0
18604,May 2006,South Carolina,3296309,2104076,63.8,1966230,59.6,137846,6.6
18605,May 2006,South Dakota,596155,433362,72.7,420263,70.5,13099,3.0
18606,May 2006,Tennessee,4683186,3024960,64.6,2860071,61.1,164889,5.5
18607,May 2006,Texas,16950545,11312321,66.7,10738395,63.4,573926,5.1
18608,May 2006,Utah,1828395,1313723,71.9,1272979,69.6,40744,3.1
18609,May 2006,Vermont,498974,356878,71.5,344101,69.0,12777,3.6
18610,May 2006,Virginia,5779056,3965965,68.6,3843632,66.5,122333,3.1
18611,May 2006,Washington,4903582,3315122,67.6,3147671,64.2,167451,5.1
18612,May 2006,West Virginia,1439305,805623,56.0,765683,53.2,39940,5.0
18613,May 2006,Wisconsin,4318785,3052688,70.7,2909578,67.4,143110,4.7
18614,May 2006,Wyoming,395045,280579,71.0,271811,68.8,8768,3.1
18615,June 2006,Alabama,3520846,2168311,61.6,2079075,59.1,89236,4.1
18616,June 2006,Alaska,490098,350239,71.5,327117,66.7,23122,6.6
18617,June 2006,Arizona,4625438,2985775,64.6,2857800,61.8,127975,4.3
18618,June 2006,Arkansas,2142069,1365314,63.7,1294071,60.4,71243,5.2
18619,June 2006,California,26988015,17632466,65.3,16763634,62.1,868832,4.9
18620,June 2006,Colorado,3617894,2620825,72.4,2505297,69.2,115528,4.4
18621,June 2006,Connecticut,2692943,1826406,67.8,1747362,64.9,79044,4.3
18622,June 2006,Delaware,657087,440812,67.1,425046,64.7,15766,3.6
18623,June 2006,District of Columbia,469865,315895,67.2,297364,63.3,18531,5.9
18624,June 2006,Florida,14157040,8988404,63.5,8699193,61.4,289211,3.2
18625,June 2006,Georgia,6906479,4703524,68.1,4478286,64.8,225238,4.8
18626,June 2006,Hawaii,960179,637851,66.4,620193,64.6,17658,2.8
18627,June 2006,Idaho,1085185,746787,68.8,720862,66.4,25925,3.5
18628,June 2006,Illinois,9669194,6513369,67.4,6220837,64.3,292532,4.5
18629,June 2006,Indiana,4793709,3236652,67.5,3068156,64.0,168496,5.2
18630,June 2006,Iowa,2290118,1659672,72.5,1599195,69.8,60477,3.6
18631,June 2006,Kansas,2078448,1464874,70.5,1400964,67.4,63910,4.4
18632,June 2006,Kentucky,3245138,2026319,62.4,1910522,58.9,115797,5.7
18633,June 2006,Louisiana,3190999,1976619,61.9,1893314,59.3,83305,4.2
18634,June 2006,Maine,1050414,700777,66.7,668717,63.7,32060,4.6
18635,June 2006,Maryland,4292028,2966266,69.1,2847728,66.3,118538,4.0
18636,June 2006,Massachusetts,5088681,3410957,67.0,3242929,63.7,168028,4.9
18637,June 2006,Michigan,7763097,5078681,65.4,4719518,60.8,359163,7.1
18638,June 2006,Minnesota,3969353,2880271,72.6,2770385,69.8,109886,3.8
18639,June 2006,Mississippi,2150308,1287864,59.9,1205023,56.0,82841,6.4
18640,June 2006,Missouri,4485298,3024309,67.4,2879381,64.2,144928,4.8
18641,June 2006,Montana,739054,495124,67.0,477461,64.6,17663,3.6
18642,June 2006,Nebraska,1332910,969137,72.7,939105,70.5,30032,3.1
18643,June 2006,Nevada,1881059,1284853,68.3,1232118,65.5,52735,4.1
18644,June 2006,New Hampshire,1032038,731454,70.9,706824,68.5,24630,3.4
18645,June 2006,New Jersey,6654358,4446630,66.8,4229397,63.6,217233,4.9
18646,June 2006,New Mexico,1460283,928610,63.6,889403,60.9,39207,4.2
18647,June 2006,New York,15090203,9513249,63.0,9069599,60.1,443650,4.7
18648,June 2006,North Carolina,6712612,4441627,66.2,4228758,63.0,212869,4.8
18649,June 2006,North Dakota,493775,360612,73.0,349044,70.7,11568,3.2
18650,June 2006,Ohio,8855024,5939688,67.1,5618412,63.4,321276,5.4
18651,June 2006,Oklahoma,2689206,1713809,63.7,1646096,61.2,67713,4.0
18652,June 2006,Oregon,2873984,1882716,65.5,1783078,62.0,99638,5.3
18653,June 2006,Pennsylvania,9762883,6293705,64.5,5998668,61.4,295037,4.7
18654,June 2006,Rhode Island,837343,572518,68.4,544151,65.0,28367,5.0
18655,June 2006,South Carolina,3301995,2105844,63.8,1967536,59.6,138308,6.6
18656,June 2006,South Dakota,596809,434361,72.8,420998,70.5,13363,3.1
18657,June 2006,Tennessee,4689861,3038729,64.8,2872225,61.2,166504,5.5
18658,June 2006,Texas,16999573,11327299,66.6,10757391,63.3,569908,5.0
18659,June 2006,Utah,1833309,1317494,71.9,1277660,69.7,39834,3.0
18660,June 2006,Vermont,499285,357085,71.5,344063,68.9,13022,3.6
18661,June 2006,Virginia,5785117,3973863,68.7,3849874,66.5,123989,3.1
18662,June 2006,Washington,4911633,3320180,67.6,3150905,64.2,169275,5.1
18663,June 2006,West Virginia,1439689,806970,56.1,765849,53.2,41121,5.1
18664,June 2006,Wisconsin,4321688,3056659,70.7,2912415,67.4,144244,4.7
18665,June 2006,Wyoming,395531,281082,71.1,272239,68.8,8843,3.1
18666,July 2006,Alabama,3524489,2169938,61.6,2080799,59.0,89139,4.1
18667,July 2006,Alaska,490950,350415,71.4,327418,66.7,22997,6.6
18668,July 2006,Arizona,4638684,2994425,64.6,2867839,61.8,126586,4.2
18669,July 2006,Arkansas,2144577,1364446,63.6,1292910,60.3,71536,5.2
18670,July 2006,California,27001429,17651454,65.4,16785547,62.2,865907,4.9
18671,July 2006,Colorado,3623832,2625866,72.5,2511637,69.3,114229,4.4
18672,July 2006,Connecticut,2694086,1829038,67.9,1749651,64.9,79387,4.3
18673,July 2006,Delaware,658065,441153,67.0,425421,64.6,15732,3.6
18674,July 2006,District of Columbia,470029,316569,67.4,298009,63.4,18560,5.9
18675,July 2006,Florida,14176539,9014400,63.6,8722861,61.5,291539,3.2
18676,July 2006,Georgia,6919458,4716205,68.2,4491570,64.9,224635,4.8
18677,July 2006,Hawaii,960755,638666,66.5,621567,64.7,17099,2.7
18678,July 2006,Idaho,1087671,747213,68.7,721805,66.4,25408,3.4
18679,July 2006,Illinois,9673133,6532199,67.5,6243665,64.5,288534,4.4
18680,July 2006,Indiana,4797047,3236044,67.5,3068080,64.0,167964,5.2
18681,July 2006,Iowa,2291405,1662689,72.6,1601390,69.9,61299,3.7
18682,July 2006,Kansas,2079254,1466067,70.5,1402397,67.4,63670,4.3
18683,July 2006,Kentucky,3248465,2029416,62.5,1913224,58.9,116192,5.7
18684,July 2006,Louisiana,3196377,1981041,62.0,1897899,59.4,83142,4.2
18685,July 2006,Maine,1051012,701393,66.7,668862,63.6,32531,4.6
18686,July 2006,Maryland,4294599,2969179,69.1,2849655,66.4,119524,4.0
18687,July 2006,Massachusetts,5090541,3415108,67.1,3247666,63.8,167442,4.9
18688,July 2006,Michigan,7764767,5074253,65.3,4713967,60.7,360286,7.1
18689,July 2006,Minnesota,3972847,2880828,72.5,2770115,69.7,110713,3.8
18690,July 2006,Mississippi,2155425,1289656,59.8,1207139,56.0,82517,6.4
18691,July 2006,Missouri,4489492,3029648,67.5,2883333,64.2,146315,4.8
18692,July 2006,Montana,739999,495183,66.9,477775,64.6,17408,3.5
18693,July 2006,Nebraska,1333638,969750,72.7,939590,70.5,30160,3.1
18694,July 2006,Nevada,1886237,1290051,68.4,1237104,65.6,52947,4.1
18695,July 2006,New Hampshire,1033102,732305,70.9,707155,68.4,25150,3.4
18696,July 2006,New Jersey,6655401,4449062,66.8,4233864,63.6,215198,4.8
18697,July 2006,New Mexico,1462013,929564,63.6,890137,60.9,39427,4.2
18698,July 2006,New York,15094862,9507535,63.0,9072177,60.1,435358,4.6
18699,July 2006,North Carolina,6724738,4457991,66.3,4242141,63.1,215850,4.8
18700,July 2006,North Dakota,493966,361304,73.1,349643,70.8,11661,3.2
18701,July 2006,Ohio,8857512,5949577,67.2,5624939,63.5,324638,5.5
18702,July 2006,Oklahoma,2692022,1714866,63.7,1646861,61.2,68005,4.0
18703,July 2006,Oregon,2878329,1888391,65.6,1787997,62.1,100394,5.3
18704,July 2006,Pennsylvania,9767552,6298723,64.5,6003934,61.5,294789,4.7
18705,July 2006,Rhode Island,837284,572812,68.4,544503,65.0,28309,4.9
18706,July 2006,South Carolina,3307776,2107974,63.7,1969823,59.6,138151,6.6
18707,July 2006,South Dakota,597445,435424,72.9,421748,70.6,13676,3.1
18708,July 2006,Tennessee,4696684,3050835,65.0,2884948,61.4,165887,5.4
18709,July 2006,Texas,17049031,11340413,66.5,10778246,63.2,562167,5.0
18710,July 2006,Utah,1838305,1320893,71.9,1282068,69.7,38825,2.9
18711,July 2006,Vermont,499602,357360,71.5,344061,68.9,13299,3.7
18712,July 2006,Virginia,5791297,3981949,68.8,3856643,66.6,125306,3.1
18713,July 2006,Washington,4919842,3325188,67.6,3154791,64.1,170397,5.1
18714,July 2006,West Virginia,1440094,808068,56.1,766119,53.2,41949,5.2
18715,July 2006,Wisconsin,4324694,3060503,70.8,2915251,67.4,145252,4.7
18716,July 2006,Wyoming,396049,281579,71.1,272606,68.8,8973,3.2
18717,August 2006,Alabama,3527515,2171457,61.6,2082696,59.0,88761,4.1
18718,August 2006,Alaska,491379,350468,71.3,327565,66.7,22903,6.5
18719,August 2006,Arizona,4649714,3003955,64.6,2878987,61.9,124968,4.2
18720,August 2006,Arkansas,2146566,1363987,63.5,1292356,60.2,71631,5.3
18721,August 2006,California,27025634,17674259,65.4,16812438,62.2,861821,4.9
18722,August 2006,Colorado,3629927,2630950,72.5,2518726,69.4,112224,4.3
18723,August 2006,Connecticut,2695372,1832045,68.0,1752416,65.0,79629,4.3
18724,August 2006,Delaware,658964,441522,67.0,425892,64.6,15630,3.5
18725,August 2006,District of Columbia,470304,317106,67.4,298577,63.5,18529,5.8
18726,August 2006,Florida,14191932,9041424,63.7,8747537,61.6,293887,3.3
18727,August 2006,Georgia,6933287,4729712,68.2,4506480,65.0,223232,4.7
18728,August 2006,Hawaii,961394,639519,66.5,623117,64.8,16402,2.6
18729,August 2006,Idaho,1089894,747856,68.6,722791,66.3,25065,3.4
18730,August 2006,Illinois,9679632,6552460,67.7,6266985,64.7,285475,4.4
18731,August 2006,Indiana,4800663,3236193,67.4,3070006,63.9,166187,5.1
18732,August 2006,Iowa,2292788,1664768,72.6,1602938,69.9,61830,3.7
18733,August 2006,Kansas,2080872,1467606,70.5,1404124,67.5,63482,4.3
18734,August 2006,Kentucky,3250741,2033118,62.5,1916771,59.0,116347,5.7
18735,August 2006,Louisiana,3204857,1987747,62.0,1903832,59.4,83915,4.2
18736,August 2006,Maine,1051575,702152,66.8,669303,63.6,32849,4.7
18737,August 2006,Maryland,4297454,2971488,69.1,2852232,66.4,119256,4.0
18738,August 2006,Massachusetts,5094563,3419738,67.1,3252707,63.8,167031,4.9
18739,August 2006,Michigan,7766182,5071246,65.3,4710134,60.6,361112,7.1
18740,August 2006,Minnesota,3976524,2883406,72.5,2770375,69.7,113031,3.9
18741,August 2006,Mississippi,2156898,1291641,59.9,1209376,56.1,82265,6.4
18742,August 2006,Missouri,4493471,3036125,67.6,2888089,64.3,148036,4.9
18743,August 2006,Montana,740941,494839,66.8,477774,64.5,17065,3.4
18744,August 2006,Nebraska,1334445,970387,72.7,940231,70.5,30156,3.1
18745,August 2006,Nevada,1890994,1294860,68.5,1241821,65.7,53039,4.1
18746,August 2006,New Hampshire,1033998,733140,70.9,707467,68.4,25673,3.5
18747,August 2006,New Jersey,6658378,4451748,66.9,4240204,63.7,211544,4.8
18748,August 2006,New Mexico,1463968,930262,63.5,890900,60.9,39362,4.2
18749,August 2006,New York,15104224,9503367,62.9,9077822,60.1,425545,4.5
18750,August 2006,North Carolina,6738725,4473899,66.4,4255852,63.2,218047,4.9
18751,August 2006,North Dakota,494129,362160,73.3,350401,70.9,11759,3.2
18752,August 2006,Ohio,8861768,5960102,67.3,5633067,63.6,327035,5.5
18753,August 2006,Oklahoma,2694318,1716299,63.7,1647885,61.2,68414,4.0
18754,August 2006,Oregon,2882700,1894109,65.7,1792971,62.2,101138,5.3
18755,August 2006,Pennsylvania,9773593,6304341,64.5,6011637,61.5,292704,4.6
18756,August 2006,Rhode Island,837324,573148,68.4,544956,65.1,28192,4.9
18757,August 2006,South Carolina,3313725,2111492,63.7,1974022,59.6,137470,6.5
18758,August 2006,South Dakota,598117,436431,73.0,422520,70.6,13911,3.2
18759,August 2006,Tennessee,4702407,3061308,65.1,2898231,61.6,163077,5.3
18760,August 2006,Texas,17079249,11353498,66.5,10802081,63.2,551417,4.9
18761,August 2006,Utah,1842871,1324166,71.9,1286453,69.8,37713,2.8
18762,August 2006,Vermont,499853,357612,71.5,344062,68.8,13550,3.8
18763,August 2006,Virginia,5797279,3990610,68.8,3864596,66.7,126014,3.2
18764,August 2006,Washington,4927599,3330782,67.6,3159977,64.1,170805,5.1
18765,August 2006,West Virginia,1440529,808848,56.1,766666,53.2,42182,5.2
18766,August 2006,Wisconsin,4327819,3064620,70.8,2918392,67.4,146228,4.8
18767,August 2006,Wyoming,396711,282053,71.1,272971,68.8,9082,3.2
18768,September 2006,Alabama,3530831,2173040,61.5,2084889,59.0,88151,4.1
18769,September 2006,Alaska,491865,350435,71.2,327624,66.6,22811,6.5
18770,September 2006,Arizona,4661126,3013586,64.7,2890291,62.0,123295,4.1
18771,September 2006,Arkansas,2148699,1364125,63.5,1292439,60.1,71686,5.3
18772,September 2006,California,27052081,17701869,65.4,16842028,62.3,859841,4.9
18773,September 2006,Colorado,3636313,2635851,72.5,2526060,69.5,109791,4.2
18774,September 2006,Connecticut,2696847,1835301,68.1,1755565,65.1,79736,4.3
18775,September 2006,Delaware,659891,441873,67.0,426432,64.6,15441,3.5
18776,September 2006,District of Columbia,470635,317520,67.5,299067,63.5,18453,5.8
18777,September 2006,Florida,14208495,9068807,63.8,8771654,61.7,297153,3.3
18778,September 2006,Georgia,6947670,4743529,68.3,4522398,65.1,221131,4.7
18779,September 2006,Hawaii,962139,640383,66.6,624606,64.9,15777,2.5
18780,September 2006,Idaho,1092208,748596,68.5,723812,66.3,24784,3.3
18781,September 2006,Illinois,9686923,6573252,67.9,6288064,64.9,285188,4.3
18782,September 2006,Indiana,4804585,3237300,67.4,3073292,64.0,164008,5.1
18783,September 2006,Iowa,2294361,1665836,72.6,1603753,69.9,62083,3.7
18784,September 2006,Kansas,2082641,1469466,70.6,1406064,67.5,63402,4.3
18785,September 2006,Kentucky,3253218,2037117,62.6,1920808,59.0,116309,5.7
18786,September 2006,Louisiana,3213610,1995460,62.1,1910446,59.4,85014,4.3
18787,September 2006,Maine,1052220,702971,66.8,670043,63.7,32928,4.7
18788,September 2006,Maryland,4300680,2973411,69.1,2855356,66.4,118055,4.0
18789,September 2006,Massachusetts,5098896,3424407,67.2,3257339,63.9,167068,4.9
18790,September 2006,Michigan,7768125,5069920,65.3,4708268,60.6,361652,7.1
18791,September 2006,Minnesota,3980510,2887416,72.5,2771072,69.6,116344,4.0
18792,September 2006,Mississippi,2158536,1293378,59.9,1211497,56.1,81881,6.3
18793,September 2006,Missouri,4497734,3042858,67.7,2893168,64.3,149690,4.9
18794,September 2006,Montana,741949,494357,66.6,477703,64.4,16654,3.4
18795,September 2006,Nebraska,1335339,971127,72.7,941002,70.5,30125,3.1
18796,September 2006,Nevada,1895903,1299370,68.5,1246215,65.7,53155,4.1
18797,September 2006,New Hampshire,1034962,734014,70.9,707870,68.4,26144,3.6
18798,September 2006,New Jersey,6661907,4454252,66.9,4247278,63.8,206974,4.6
18799,September 2006,New Mexico,1466021,930707,63.5,891697,60.8,39010,4.2
18800,September 2006,New York,15114759,9503147,62.9,9086018,60.1,417129,4.4
18801,September 2006,North Carolina,6753249,4488268,66.5,4268925,63.2,219343,4.9
18802,September 2006,North Dakota,494324,363136,73.5,351310,71.1,11826,3.3
18803,September 2006,Ohio,8866608,5970990,67.3,5642183,63.6,328807,5.5
18804,September 2006,Oklahoma,2696751,1718152,63.7,1649033,61.1,69119,4.0
18805,September 2006,Oregon,2887241,1899606,65.8,1797971,62.3,101635,5.4
18806,September 2006,Pennsylvania,9780250,6310546,64.5,6020935,61.6,289611,4.6
18807,September 2006,Rhode Island,837448,573581,68.5,545580,65.1,28001,4.9
18808,September 2006,South Carolina,3319924,2116380,63.7,1979918,59.6,136462,6.4
18809,September 2006,South Dakota,598851,437338,73.0,423306,70.7,14032,3.2
18810,September 2006,Tennessee,4708406,3069891,65.2,2911006,61.8,158885,5.2
18811,September 2006,Texas,17110941,11367062,66.4,10827205,63.3,539857,4.7
18812,September 2006,Utah,1847529,1327531,71.9,1290988,69.9,36543,2.8
18813,September 2006,Vermont,500114,357724,71.5,343996,68.8,13728,3.8
18814,September 2006,Virginia,5803659,3999375,68.9,3873318,66.7,126057,3.2
18815,September 2006,Washington,4935665,3336966,67.6,3166459,64.2,170507,5.1
18816,September 2006,West Virginia,1441068,809264,56.2,767459,53.3,41805,5.2
18817,September 2006,Wisconsin,4331183,3069254,70.9,2921836,67.5,147418,4.8
18818,September 2006,Wyoming,397410,282486,71.1,273376,68.8,9110,3.2
18819,October 2006,Alabama,3534233,2174902,61.5,2087658,59.1,87244,4.0
18820,October 2006,Alaska,492363,350357,71.2,327662,66.5,22695,6.5
18821,October 2006,Arizona,4672561,3022312,64.7,2900740,62.1,121572,4.0
18822,October 2006,Arkansas,2150924,1364981,63.5,1293299,60.1,71682,5.3
18823,October 2006,California,27078759,17732943,65.5,16872699,62.3,860244,4.9
18824,October 2006,Colorado,3642735,2640166,72.5,2533031,69.5,107135,4.1
18825,October 2006,Connecticut,2698356,1838596,68.1,1758949,65.2,79647,4.3
18826,October 2006,Delaware,660866,442186,66.9,426982,64.6,15204,3.4
18827,October 2006,District of Columbia,470976,317912,67.5,299574,63.6,18338,5.8
18828,October 2006,Florida,14225236,9095415,63.9,8794437,61.8,300978,3.3
18829,October 2006,Georgia,6962267,4756639,68.3,4538689,65.2,217950,4.6
18830,October 2006,Hawaii,962862,641194,66.6,625805,65.0,15389,2.4
18831,October 2006,Idaho,1094511,749388,68.5,724893,66.2,24495,3.3
18832,October 2006,Illinois,9694364,6592252,68.0,6305158,65.0,287094,4.4
18833,October 2006,Indiana,4808630,3238470,67.3,3077143,64.0,161327,5.0
18834,October 2006,Iowa,2295947,1665817,72.6,1603785,69.9,62032,3.7
18835,October 2006,Kansas,2084444,1471544,70.6,1408188,67.6,63356,4.3
18836,October 2006,Kentucky,3255793,2040836,62.7,1924848,59.1,115988,5.7
18837,October 2006,Louisiana,3222460,2003226,62.2,1917148,59.5,86078,4.3
18838,October 2006,Maine,1052853,703721,66.8,670992,63.7,32729,4.7
18839,October 2006,Maryland,4304017,2974895,69.1,2858743,66.4,116152,3.9
18840,October 2006,Massachusetts,5103347,3428381,67.2,3261298,63.9,167083,4.9
18841,October 2006,Michigan,7770240,5069211,65.2,4708795,60.6,360416,7.1
18842,October 2006,Minnesota,3984539,2891843,72.6,2772212,69.6,119631,4.1
18843,October 2006,Mississippi,2160264,1294625,59.9,1213261,56.2,81364,6.3
18844,October 2006,Missouri,4502085,3048686,67.7,2898195,64.4,150491,4.9
18845,October 2006,Montana,742968,494053,66.5,477899,64.3,16154,3.3
18846,October 2006,Nebraska,1336273,971855,72.7,941829,70.5,30026,3.1
18847,October 2006,Nevada,1900824,1303676,68.6,1250350,65.8,53326,4.1
18848,October 2006,New Hampshire,1035945,734920,70.9,708415,68.4,26505,3.6
18849,October 2006,New Jersey,6665480,4455606,66.8,4253916,63.8,201690,4.5
18850,October 2006,New Mexico,1468098,931009,63.4,892632,60.8,38377,4.1
18851,October 2006,New York,15125499,9507130,62.9,9096735,60.1,410395,4.3
18852,October 2006,North Carolina,6767948,4500093,66.5,4281242,63.3,218851,4.9
18853,October 2006,North Dakota,494543,364148,73.6,352315,71.2,11833,3.2
18854,October 2006,Ohio,8871588,5980716,67.4,5651712,63.7,329004,5.5
18855,October 2006,Oklahoma,2699281,1720385,63.7,1650367,61.1,70018,4.1
18856,October 2006,Oregon,2891842,1904557,65.9,1803012,62.3,101545,5.3
18857,October 2006,Pennsylvania,9787133,6316667,64.5,6031045,61.6,285622,4.5
18858,October 2006,Rhode Island,837557,574082,68.5,546319,65.2,27763,4.8
18859,October 2006,South Carolina,3326216,2121701,63.8,1986829,59.7,134872,6.4
18860,October 2006,South Dakota,599550,438116,73.1,424108,70.7,14008,3.2
18861,October 2006,Tennessee,4714580,3076436,65.3,2922541,62.0,153895,5.0
18862,October 2006,Texas,17142922,11380249,66.4,10852087,63.3,528162,4.6
18863,October 2006,Utah,1852277,1331118,71.9,1295807,70.0,35311,2.7
18864,October 2006,Vermont,500437,357624,71.5,343818,68.7,13806,3.9
18865,October 2006,Virginia,5810214,4007656,69.0,3882561,66.8,125095,3.1
18866,October 2006,Washington,4943864,3343568,67.6,3174238,64.2,169330,5.1
18867,October 2006,West Virginia,1441653,809408,56.1,768460,53.3,40948,5.1
18868,October 2006,Wisconsin,4334726,3074055,70.9,2925705,67.5,148350,4.8
18869,October 2006,Wyoming,398110,282876,71.1,273867,68.8,9009,3.2
18870,November 2006,Alabama,3537230,2177005,61.5,2090825,59.1,86180,4.0
18871,November 2006,Alaska,492811,350263,71.1,327723,66.5,22540,6.4
18872,November 2006,Arizona,4683513,3029102,64.7,2909091,62.1,120011,4.0
18873,November 2006,Arkansas,2152890,1366384,63.5,1294766,60.1,71618,5.2
18874,November 2006,California,27103225,17764761,65.5,16901015,62.4,863746,4.9
18875,November 2006,Colorado,3648895,2643315,72.4,2538964,69.6,104351,3.9
18876,November 2006,Connecticut,2699575,1841681,68.2,1762267,65.3,79414,4.3
18877,November 2006,Delaware,661769,442452,66.9,427448,64.6,15004,3.4
18878,November 2006,District of Columbia,471263,318418,67.6,300226,63.7,18192,5.7
18879,November 2006,Florida,14240024,9119319,64.0,8814010,61.9,305309,3.3
18880,November 2006,Georgia,6976303,4768186,68.3,4554020,65.3,214166,4.5
18881,November 2006,Hawaii,963638,641831,66.6,626523,65.0,15308,2.4
18882,November 2006,Idaho,1096757,750158,68.4,726024,66.2,24134,3.2
18883,November 2006,Illinois,9700854,6607145,68.1,6316919,65.1,290226,4.4
18884,November 2006,Indiana,4812269,3238820,67.3,3080502,64.0,158318,4.9
18885,November 2006,Iowa,2297319,1664736,72.5,1602946,69.8,61790,3.7
18886,November 2006,Kansas,2086023,1473612,70.6,1410395,67.6,63217,4.3
18887,November 2006,Kentucky,3258054,2043582,62.7,1928239,59.2,115343,5.6
18888,November 2006,Louisiana,3230986,2009868,62.2,1923095,59.5,86773,4.3
18889,November 2006,Maine,1053411,704221,66.9,671889,63.8,32332,4.6
18890,November 2006,Maryland,4306848,2975713,69.1,2861848,66.4,113865,3.8
18891,November 2006,Massachusetts,5107225,3431077,67.2,3264459,63.9,166618,4.9
18892,November 2006,Michigan,7771568,5067567,65.2,4710382,60.6,357185,7.0
18893,November 2006,Minnesota,3988221,2896042,72.6,2773633,69.5,122409,4.2
18894,November 2006,Mississippi,2161794,1295503,59.9,1214455,56.2,81048,6.3
18895,November 2006,Missouri,4506029,3052473,67.7,2902340,64.4,150133,4.9
18896,November 2006,Montana,743938,494193,66.4,478609,64.3,15584,3.2
18897,November 2006,Nebraska,1337076,972389,72.7,942675,70.5,29714,3.1
18898,November 2006,Nevada,1905607,1307788,68.6,1254235,65.8,53553,4.1
18899,November 2006,New Hampshire,1036864,735757,71.0,709018,68.4,26739,3.6
18900,November 2006,New Jersey,6668227,4454945,66.8,4258664,63.9,196281,4.4
18901,November 2006,New Mexico,1470040,931322,63.4,893746,60.8,37576,4.0
18902,November 2006,New York,15134698,9513238,62.9,9107686,60.2,405552,4.3
18903,November 2006,North Carolina,6782001,4508501,66.5,4291807,63.3,216694,4.8
18904,November 2006,North Dakota,494713,365083,73.8,353298,71.4,11785,3.2
18905,November 2006,Ohio,8875607,5988173,67.5,5660532,63.8,327641,5.5
18906,November 2006,Oklahoma,2701509,1722811,63.8,1651850,61.1,70961,4.1
18907,November 2006,Oregon,2896151,1908554,65.9,1807825,62.4,100729,5.3
18908,November 2006,Pennsylvania,9792714,6321567,64.6,6040626,61.7,280941,4.4
18909,November 2006,Rhode Island,837591,574503,68.6,546977,65.3,27526,4.8
18910,November 2006,South Carolina,3332174,2126205,63.8,1993582,59.8,132623,6.2
18911,November 2006,South Dakota,600249,438783,73.1,424933,70.8,13850,3.2
18912,November 2006,Tennessee,4720259,3080505,65.3,2931878,62.1,148627,4.8
18913,November 2006,Texas,17173555,11391430,66.3,10874236,63.3,517194,4.5
18914,November 2006,Utah,1856935,1334954,71.9,1300853,70.1,34101,2.6
18915,November 2006,Vermont,500707,357315,71.4,343500,68.6,13815,3.9
18916,November 2006,Virginia,5816239,4014613,69.0,3891398,66.9,123215,3.1
18917,November 2006,Washington,4951564,3350343,67.7,3182952,64.3,167391,5.0
18918,November 2006,West Virginia,1442055,809399,56.1,769572,53.4,39827,4.9
18919,November 2006,Wisconsin,4337810,3078542,71.0,2929642,67.5,148900,4.8
18920,November 2006,Wyoming,398800,283227,71.0,274449,68.8,8778,3.1
18921,December 2006,Alabama,3539975,2178766,61.5,2093624,59.1,85142,3.9
18922,December 2006,Alaska,493209,350163,71.0,327817,66.5,22346,6.4
18923,December 2006,Arizona,4694090,3032885,64.6,2914223,62.1,118662,3.9
18924,December 2006,Arkansas,2154700,1367842,63.5,1296341,60.2,71501,5.2
18925,December 2006,California,27125539,17792058,65.6,16921888,62.4,870170,4.9
18926,December 2006,Colorado,3654689,2644879,72.4,2543357,69.6,101522,3.8
18927,December 2006,Connecticut,2700572,1844273,68.3,1765109,65.4,79164,4.3
18928,December 2006,Delaware,662605,442636,66.8,427740,64.6,14896,3.4
18929,December 2006,District of Columbia,471541,319094,67.7,301066,63.8,18028,5.6
18930,December 2006,Florida,14253857,9137262,64.1,8827342,61.9,309920,3.4
18931,December 2006,Georgia,6989645,4776942,68.3,4566600,65.3,210342,4.4
18932,December 2006,Hawaii,964323,642158,66.6,626660,65.0,15498,2.4
18933,December 2006,Idaho,1098875,750862,68.3,727172,66.2,23690,3.2
18934,December 2006,Illinois,9706507,6616283,68.2,6322363,65.1,293920,4.4
18935,December 2006,Indiana,4815412,3236893,67.2,3081907,64.0,154986,4.8
18936,December 2006,Iowa,2298473,1662714,72.3,1601215,69.7,61499,3.7
18937,December 2006,Kansas,2087411,1475381,70.7,1412394,67.7,62987,4.3
18938,December 2006,Kentucky,3260036,2044729,62.7,1930370,59.2,114359,5.6
18939,December 2006,Louisiana,3239209,2014262,62.2,1927274,59.5,86988,4.3
18940,December 2006,Maine,1053865,704291,66.8,672383,63.8,31908,4.5
18941,December 2006,Maryland,4309390,2975332,69.0,2864018,66.5,111314,3.7
18942,December 2006,Massachusetts,5110695,3432012,67.2,3266563,63.9,165449,4.8
18943,December 2006,Michigan,7772247,5063073,65.1,4710625,60.6,352448,7.0
18944,December 2006,Minnesota,3991537,2899583,72.6,2775034,69.5,124549,4.3
18945,December 2006,Mississippi,2163100,1295972,59.9,1214936,56.2,81036,6.3
18946,December 2006,Missouri,4509532,3053169,67.7,2904393,64.4,148776,4.9
18947,December 2006,Montana,744795,494856,66.4,479823,64.4,15033,3.0
18948,December 2006,Nebraska,1337751,972726,72.7,943522,70.5,29204,3.0
18949,December 2006,Nevada,1910243,1311646,68.7,1257801,65.8,53845,4.1
18950,December 2006,New Hampshire,1037663,736390,71.0,709554,68.4,26836,3.6
18951,December 2006,New Jersey,6670558,4451558,66.7,4260259,63.9,191299,4.3
18952,December 2006,New Mexico,1471865,931638,63.3,894904,60.8,36734,3.9
18953,December 2006,New York,15142650,9517371,62.9,9114514,60.2,402857,4.2
18954,December 2006,North Carolina,6795447,4512413,66.4,4298865,63.3,213548,4.7
18955,December 2006,North Dakota,494830,365830,73.9,354130,71.6,11700,3.2
18956,December 2006,Ohio,8878875,5992321,67.5,5666904,63.8,325417,5.4
18957,December 2006,Oklahoma,2703508,1724964,63.8,1653139,61.1,71825,4.2
18958,December 2006,Oregon,2900173,1911215,65.9,1811899,62.5,99316,5.2
18959,December 2006,Pennsylvania,9797592,6323484,64.5,6047662,61.7,275822,4.4
18960,December 2006,Rhode Island,837598,574704,68.6,547368,65.3,27336,4.8
18961,December 2006,South Carolina,3337829,2128493,63.8,1998758,59.9,129735,6.1
18962,December 2006,South Dakota,600884,439388,73.1,425790,70.9,13598,3.1
18963,December 2006,Tennessee,4725564,3081540,65.2,2937908,62.2,143632,4.7
18964,December 2006,Texas,17202612,11397862,66.3,10890661,63.3,507201,4.4
18965,December 2006,Utah,1861354,1338908,71.9,1305872,70.2,33036,2.5
18966,December 2006,Vermont,500907,356837,71.2,343032,68.5,13805,3.9
18967,December 2006,Virginia,5821739,4019079,69.0,3898326,67.0,120753,3.0
18968,December 2006,Washington,4958849,3356894,67.7,3192047,64.4,164847,4.9
18969,December 2006,West Virginia,1442360,809231,56.1,770582,53.4,38649,4.8
18970,December 2006,Wisconsin,4340530,3082057,71.0,2932870,67.6,149187,4.8
18971,December 2006,Wyoming,399410,283546,71.0,275082,68.9,8464,3.0
18972,January 2007,Alabama,3542815,2179543,61.5,2095291,59.1,84252,3.9
18973,January 2007,Alaska,493664,350056,70.9,327906,66.4,22150,6.3
18974,January 2007,Arizona,4704694,3033441,64.5,2915978,62.0,117463,3.9
18975,January 2007,Arkansas,2156533,1368952,63.5,1297568,60.2,71384,5.2
18976,January 2007,California,27148345,17811805,65.6,16932315,62.4,879490,4.9
18977,January 2007,Colorado,3660570,2645116,72.3,2546275,69.6,98841,3.7
18978,January 2007,Connecticut,2701606,1846260,68.3,1767230,65.4,79030,4.3
18979,January 2007,Delaware,663461,442720,66.7,427824,64.5,14896,3.4
18980,January 2007,District of Columbia,471801,319815,67.8,301944,64.0,17871,5.6
18981,January 2007,Florida,14267753,9147556,64.1,8832507,61.9,315049,3.4
18982,January 2007,Georgia,7003265,4782401,68.3,4575271,65.3,207130,4.3
18983,January 2007,Hawaii,965074,642117,66.5,626279,64.9,15838,2.5
18984,January 2007,Idaho,1101043,751570,68.3,728386,66.2,23184,3.1
18985,January 2007,Illinois,9712343,6620604,68.2,6322280,65.1,298324,4.5
18986,January 2007,Indiana,4818643,3231991,67.1,3080328,63.9,151663,4.7
18987,January 2007,Iowa,2299627,1660286,72.2,1598949,69.5,61337,3.7
18988,January 2007,Kansas,2088878,1476771,70.7,1413986,67.7,62785,4.3
18989,January 2007,Kentucky,3262037,2044139,62.7,1931023,59.2,113116,5.5
18990,January 2007,Louisiana,3247530,2016195,62.1,1929258,59.4,86937,4.3
18991,January 2007,Maine,1054293,703834,66.8,672263,63.8,31571,4.5
18992,January 2007,Maryland,4312014,2973568,69.0,2864870,66.4,108698,3.7
18993,January 2007,Massachusetts,5114213,3431219,67.1,3267389,63.9,163830,4.8
18994,January 2007,Michigan,7773003,5055302,65.0,4707586,60.6,347716,6.9
18995,January 2007,Minnesota,3994866,2902180,72.6,2775988,69.5,126192,4.3
18996,January 2007,Mississippi,2164477,1296001,59.9,1214741,56.1,81260,6.3
18997,January 2007,Missouri,4513113,3050962,67.6,2903681,64.3,147281,4.8
18998,January 2007,Montana,745694,495923,66.5,481280,64.5,14643,3.0
18999,January 2007,Nebraska,1338456,973057,72.7,944359,70.6,28698,2.9
19000,January 2007,Nevada,1914899,1315176,68.7,1260934,65.8,54242,4.1
19001,January 2007,New Hampshire,1038461,736794,71.0,710001,68.4,26793,3.6
19002,January 2007,New Jersey,6672934,4445925,66.6,4258388,63.8,187537,4.2
19003,January 2007,New Mexico,1473685,931845,63.2,895895,60.8,35950,3.9
19004,January 2007,New York,15150952,9517017,62.8,9114266,60.2,402751,4.2
19005,January 2007,North Carolina,6809040,4512216,66.3,4301936,63.2,210280,4.7
19006,January 2007,North Dakota,494942,366337,74.0,354735,71.7,11602,3.2
19007,January 2007,Ohio,8882233,5993928,67.5,5669880,63.8,324048,5.4
19008,January 2007,Oklahoma,2705529,1726421,63.8,1653878,61.1,72543,4.2
19009,January 2007,Oregon,2904260,1912583,65.9,1814953,62.5,97630,5.1
19010,January 2007,Pennsylvania,9802460,6322426,64.5,6051218,61.7,271208,4.3
19011,January 2007,Rhode Island,837548,574635,68.6,547423,65.4,27212,4.7
19012,January 2007,South Carolina,3343563,2128380,63.7,2001901,59.9,126479,5.9
19013,January 2007,South Dakota,601464,439948,73.1,426650,70.9,13298,3.0
19014,January 2007,Tennessee,4730893,3079563,65.1,2940217,62.1,139346,4.5
19015,January 2007,Texas,17232072,11398544,66.1,10900033,63.3,498511,4.4
19016,January 2007,Utah,1865807,1342842,72.0,1310570,70.2,32272,2.4
19017,January 2007,Vermont,501089,356242,71.1,342452,68.3,13790,3.9
19018,January 2007,Virginia,5827381,4020595,69.0,3902272,67.0,118323,2.9
19019,January 2007,Washington,4966166,3363038,67.7,3201133,64.5,161905,4.8
19020,January 2007,West Virginia,1442623,808905,56.1,771332,53.5,37573,4.6
19021,January 2007,Wisconsin,4343261,3084239,71.0,2934908,67.6,149331,4.8
19022,January 2007,Wyoming,400067,283850,71.0,275706,68.9,8144,2.9
19023,February 2007,Alabama,3545167,2178931,61.5,2095516,59.1,83415,3.8
19024,February 2007,Alaska,494007,349954,70.8,327949,66.4,22005,6.3
19025,February 2007,Arizona,4714781,3031851,64.3,2915599,61.8,116252,3.8
19026,February 2007,Arkansas,2158081,1369549,63.5,1298140,60.2,71409,5.2
19027,February 2007,California,27168086,17825538,65.6,16934431,62.3,891107,5.0
19028,February 2007,Colorado,3666058,2645082,72.2,2548528,69.5,96554,3.7
19029,February 2007,Connecticut,2702303,1847816,68.4,1768730,65.5,79086,4.3
19030,February 2007,Delaware,664226,442736,66.7,427749,64.4,14987,3.4
19031,February 2007,District of Columbia,472017,320401,67.9,302662,64.1,17739,5.5
19032,February 2007,Florida,14279851,9151999,64.1,8830833,61.8,321166,3.5
19033,February 2007,Georgia,7016065,4785717,68.2,4580451,65.3,205266,4.3
19034,February 2007,Hawaii,965632,641708,66.5,625507,64.8,16201,2.5
19035,February 2007,Idaho,1103046,752348,68.2,729700,66.2,22648,3.0
19036,February 2007,Illinois,9717097,6623049,68.2,6319804,65.0,303245,4.6
19037,February 2007,Indiana,4821332,3224578,66.9,3075991,63.8,148587,4.6
19038,February 2007,Iowa,2300517,1658171,72.1,1596835,69.4,61336,3.7
19039,February 2007,Kansas,2090053,1477947,70.7,1415320,67.7,62627,4.2
19040,February 2007,Kentucky,3263696,2042206,62.6,1930560,59.2,111646,5.5
19041,February 2007,Louisiana,3255510,2016887,62.0,1929793,59.3,87094,4.3
19042,February 2007,Maine,1054627,702958,66.7,671555,63.7,31403,4.5
19043,February 2007,Maryland,4314108,2970937,68.9,2864666,66.4,106271,3.6
19044,February 2007,Massachusetts,5117238,3429482,67.0,3267316,63.8,162166,4.7
19045,February 2007,Michigan,7772855,5045302,64.9,4701215,60.5,344087,6.8
19046,February 2007,Minnesota,3997795,2903772,72.6,2776322,69.4,127450,4.4
19047,February 2007,Mississippi,2165618,1295798,59.8,1214358,56.1,81440,6.3
19048,February 2007,Missouri,4516134,3046883,67.5,2900511,64.2,146372,4.8
19049,February 2007,Montana,746466,497134,66.6,482575,64.6,14559,2.9
19050,February 2007,Nebraska,1338983,973588,72.7,945209,70.6,28379,2.9
19051,February 2007,Nevada,1919343,1318340,68.7,1263577,65.8,54763,4.2
19052,February 2007,New Hampshire,1039176,737021,70.9,710385,68.4,26636,3.6
19053,February 2007,New Jersey,6674560,4439697,66.5,4254200,63.7,185497,4.2
19054,February 2007,New Mexico,1475346,931981,63.2,896656,60.8,35325,3.8
19055,February 2007,New York,15157513,9513343,62.8,9107919,60.1,405424,4.3
19056,February 2007,North Carolina,6821893,4509795,66.1,4302030,63.1,207765,4.6
19057,February 2007,North Dakota,495024,366645,74.1,355131,71.7,11514,3.1
19058,February 2007,Ohio,8884607,5994172,67.5,5670006,63.8,324166,5.4
19059,February 2007,Oklahoma,2707226,1727231,63.8,1654065,61.1,73166,4.2
19060,February 2007,Oregon,2907965,1913074,65.8,1816978,62.5,96096,5.0
19061,February 2007,Pennsylvania,9806222,6320317,64.5,6052414,61.7,267903,4.2
19062,February 2007,Rhode Island,837415,574367,68.6,547183,65.3,27184,4.7
19063,February 2007,South Carolina,3348914,2126984,63.5,2003528,59.8,123456,5.8
19064,February 2007,South Dakota,602021,440491,73.2,427495,71.0,12996,3.0
19065,February 2007,Tennessee,4735729,3075211,64.9,2939611,62.1,135600,4.4
19066,February 2007,Texas,17259736,11396233,66.0,10904607,63.2,491626,4.3
19067,February 2007,Utah,1870120,1346650,72.0,1314734,70.3,31916,2.4
19068,February 2007,Vermont,501269,355629,70.9,341849,68.2,13780,3.9
19069,February 2007,Virginia,5832389,4020219,68.9,3903783,66.9,116436,2.9
19070,February 2007,Washington,4972954,3369201,67.8,3210097,64.6,159104,4.7
19071,February 2007,West Virginia,1442800,808626,56.0,771898,53.5,36728,4.5
19072,February 2007,Wisconsin,4345498,3085457,71.0,2935918,67.6,149539,4.8
19073,February 2007,Wyoming,400707,284191,70.9,276280,68.9,7911,2.8
19074,March 2007,Alabama,3547626,2176785,61.4,2094241,59.0,82544,3.8
19075,March 2007,Alaska,494382,349888,70.8,327958,66.3,21930,6.3
19076,March 2007,Arizona,4724746,3029105,64.1,2914290,61.7,114815,3.8
19077,March 2007,Arkansas,2159672,1369593,63.4,1297970,60.1,71623,5.2
19078,March 2007,California,27186717,17834238,65.6,16931362,62.3,902876,5.1
19079,March 2007,Colorado,3671548,2645641,72.1,2550808,69.5,94833,3.6
19080,March 2007,Connecticut,2703036,1848998,68.4,1769738,65.5,79260,4.3
19081,March 2007,Delaware,665035,442693,66.6,427606,64.3,15087,3.4
19082,March 2007,District of Columbia,472257,320741,67.9,303108,64.2,17633,5.5
19083,March 2007,Florida,14291739,9151861,64.0,8823838,61.7,328023,3.6
19084,March 2007,Georgia,7028941,4788037,68.1,4583175,65.2,204862,4.3
19085,March 2007,Hawaii,966129,640924,66.3,624413,64.6,16511,2.6
19086,March 2007,Idaho,1105085,753201,68.2,731045,66.2,22156,2.9
19087,March 2007,Illinois,9721893,6625194,68.1,6317542,65.0,307652,4.6
19088,March 2007,Indiana,4824188,3215324,66.7,3069729,63.6,145595,4.5
19089,March 2007,Iowa,2301493,1656697,72.0,1595386,69.3,61311,3.7
19090,March 2007,Kansas,2091299,1479015,70.7,1416589,67.7,62426,4.2
19091,March 2007,Kentucky,3265475,2039196,62.4,1929252,59.1,109944,5.4
19092,March 2007,Louisiana,3263490,2017261,61.8,1929737,59.1,87524,4.3
19093,March 2007,Maine,1054996,701834,66.5,670402,63.5,31432,4.5
19094,March 2007,Maryland,4316235,2968053,68.8,2863964,66.4,104089,3.5
19095,March 2007,Massachusetts,5120326,3427299,66.9,3266664,63.8,160635,4.7
19096,March 2007,Michigan,7772871,5033830,64.8,4692195,60.4,341635,6.8
19097,March 2007,Minnesota,4000855,2904432,72.6,2776056,69.4,128376,4.4
19098,March 2007,Mississippi,2166767,1295532,59.8,1214306,56.0,81226,6.3
19099,March 2007,Missouri,4519323,3041673,67.3,2895339,64.1,146334,4.8
19100,March 2007,Montana,747297,498331,66.7,483471,64.7,14860,3.0
19101,March 2007,Nebraska,1339583,974440,72.7,946126,70.6,28314,2.9
19102,March 2007,Nevada,1923771,1321085,68.7,1265676,65.8,55409,4.2
19103,March 2007,New Hampshire,1039913,737185,70.9,710780,68.3,26405,3.6
19104,March 2007,New Jersey,6676154,4433944,66.4,4249179,63.6,184765,4.2
19105,March 2007,New Mexico,1476898,932095,63.1,897231,60.8,34864,3.7
19106,March 2007,New York,15163922,9507329,62.7,9097197,60.0,410132,4.3
19107,March 2007,North Carolina,6834842,4506422,65.9,4300233,62.9,206189,4.6
19108,March 2007,North Dakota,495105,366803,74.1,355355,71.8,11448,3.1
19109,March 2007,Ohio,8887255,5992650,67.4,5667826,63.8,324824,5.4
19110,March 2007,Oklahoma,2708997,1727301,63.8,1653788,61.0,73513,4.3
19111,March 2007,Oregon,2911736,1913143,65.7,1818080,62.4,95063,5.0
19112,March 2007,Pennsylvania,9810236,6318612,64.4,6052599,61.7,266013,4.2
19113,March 2007,Rhode Island,837327,574043,68.6,546743,65.3,27300,4.8
19114,March 2007,South Carolina,3354308,2125194,63.4,2004222,59.8,120972,5.7
19115,March 2007,South Dakota,602607,441050,73.2,428325,71.1,12725,2.9
19116,March 2007,Tennessee,4740652,3069098,64.7,2937035,62.0,132063,4.3
19117,March 2007,Texas,17286779,11392933,65.9,10906835,63.1,486098,4.3
19118,March 2007,Utah,1874494,1350184,72.0,1318217,70.3,31967,2.4
19119,March 2007,Vermont,501453,355083,70.8,341301,68.1,13782,3.9
19120,March 2007,Virginia,5837444,4018972,68.8,3903711,66.9,115261,2.9
19121,March 2007,Washington,4979787,3375456,67.8,3218619,64.6,156837,4.6
19122,March 2007,West Virginia,1442984,808528,56.0,772371,53.5,36157,4.5
19123,March 2007,Wisconsin,4347897,3085860,71.0,2936033,67.5,149827,4.9
19124,March 2007,Wyoming,401306,284624,70.9,276805,69.0,7819,2.7
19125,April 2007,Alabama,3550367,2173924,61.2,2091857,58.9,82067,3.8
19126,April 2007,Alaska,494816,349891,70.7,327949,66.3,21942,6.3
19127,April 2007,Arizona,4735194,3026411,63.9,2913319,61.5,113092,3.7
19128,April 2007,Arkansas,2161464,1369275,63.3,1297217,60.0,72058,5.3
19129,April 2007,California,27208433,17841314,65.6,16927054,62.2,914260,5.1
19130,April 2007,Colorado,3677433,2647709,72.0,2553782,69.4,93927,3.5
19131,April 2007,Connecticut,2703993,1850015,68.4,1770521,65.5,79494,4.3
19132,April 2007,Delaware,665843,442617,66.5,427512,64.2,15105,3.4
19133,April 2007,District of Columbia,472521,320828,67.9,303266,64.2,17562,5.5
19134,April 2007,Florida,14305044,9149170,64.0,8813495,61.6,335675,3.7
19135,April 2007,Georgia,7042417,4790929,68.0,4584949,65.1,205980,4.3
19136,April 2007,Hawaii,966815,639825,66.2,623060,64.4,16765,2.6
19137,April 2007,Idaho,1107207,754126,68.1,732297,66.1,21829,2.9
19138,April 2007,Illinois,9727632,6629361,68.1,6317789,64.9,311572,4.7
19139,April 2007,Indiana,4827419,3206022,66.4,3062945,63.4,143077,4.5
19140,April 2007,Iowa,2302638,1655975,71.9,1594835,69.3,61140,3.7
19141,April 2007,Kansas,2092707,1480060,70.7,1417879,67.8,62181,4.2
19142,April 2007,Kentucky,3267511,2035657,62.3,1927427,59.0,108230,5.3
19143,April 2007,Louisiana,3271780,2017777,61.7,1929859,59.0,87918,4.4
19144,April 2007,Maine,1055438,700643,66.4,668987,63.4,31656,4.5
19145,April 2007,Maryland,4318781,2965743,68.7,2863381,66.3,102362,3.5
19146,April 2007,Massachusetts,5123854,3425258,66.8,3265992,63.7,159266,4.6
19147,April 2007,Michigan,7773549,5022525,64.6,4681778,60.2,340747,6.8
19148,April 2007,Minnesota,4004225,2904623,72.5,2775347,69.3,129276,4.5
19149,April 2007,Mississippi,2168121,1295669,59.8,1215020,56.0,80649,6.2
19150,April 2007,Missouri,4522851,3036487,67.1,2889220,63.9,147267,4.8
19151,April 2007,Montana,748152,499492,66.8,483948,64.7,15544,3.1
19152,April 2007,Nebraska,1340253,975653,72.8,947148,70.7,28505,2.9
19153,April 2007,Nevada,1928351,1323428,68.6,1267202,65.7,56226,4.2
19154,April 2007,New Hampshire,1040733,737377,70.9,711222,68.3,26155,3.5
19155,April 2007,New Jersey,6678395,4429830,66.3,4245010,63.6,184820,4.2
19156,April 2007,New Mexico,1478672,932140,63.0,897636,60.7,34504,3.7
19157,April 2007,New York,15171921,9501517,62.6,9085144,59.9,416373,4.4
19158,April 2007,North Carolina,6848364,4503842,65.8,4298130,62.8,205712,4.6
19159,April 2007,North Dakota,495243,366865,74.1,355438,71.8,11427,3.1
19160,April 2007,Ohio,8890662,5990153,67.4,5664263,63.7,325890,5.4
19161,April 2007,Oklahoma,2711001,1726756,63.7,1653300,61.0,73456,4.3
19162,April 2007,Oregon,2915785,1913478,65.6,1818658,62.4,94820,5.0
19163,April 2007,Pennsylvania,9815062,6318946,64.4,6053114,61.7,265832,4.2
19164,April 2007,Rhode Island,837293,573751,68.5,546154,65.2,27597,4.8
19165,April 2007,South Carolina,3359975,2123868,63.2,2004714,59.7,119154,5.6
19166,April 2007,South Dakota,603195,441628,73.2,429110,71.1,12518,2.8
19167,April 2007,Tennessee,4745983,3063006,64.5,2933585,61.8,129421,4.2
19168,April 2007,Texas,17315600,11391893,65.8,10909749,63.0,482144,4.2
19169,April 2007,Utah,1878974,1353375,72.0,1320951,70.3,32424,2.4
19170,April 2007,Vermont,501644,354624,70.7,340817,67.9,13807,3.9
19171,April 2007,Virginia,5843053,4018162,68.8,3903277,66.8,114885,2.9
19172,April 2007,Washington,4987100,3382044,67.8,3226505,64.7,155539,4.6
19173,April 2007,West Virginia,1443284,808695,56.0,772826,53.5,35869,4.4
19174,April 2007,Wisconsin,4350635,3085927,70.9,2935635,67.5,150292,4.9
19175,April 2007,Wyoming,401915,285161,71.0,277287,69.0,7874,2.8
19176,May 2007,Alabama,3553057,2171384,61.1,2089043,58.8,82341,3.8
19177,May 2007,Alaska,495225,350006,70.7,327974,66.2,22032,6.3
19178,May 2007,Arizona,4745562,3024750,63.7,2913403,61.4,111347,3.7
19179,May 2007,Arkansas,2163259,1368861,63.3,1296134,59.9,72727,5.3
19180,May 2007,California,27228543,17850870,65.6,16923871,62.2,926999,5.2
19181,May 2007,Colorado,3683212,2651742,72.0,2557678,69.4,94064,3.5
19182,May 2007,Connecticut,2704965,1851208,68.4,1771338,65.5,79870,4.3
19183,May 2007,Delaware,666703,442571,66.4,427553,64.1,15018,3.4
19184,May 2007,District of Columbia,472742,320782,67.9,303242,64.1,17540,5.5
19185,May 2007,Florida,14318164,9146329,63.9,8801414,61.5,344915,3.8
19186,May 2007,Georgia,7055680,4795731,68.0,4586962,65.0,208769,4.4
19187,May 2007,Hawaii,967396,638583,66.0,621590,64.3,16993,2.7
19188,May 2007,Idaho,1109395,755069,68.1,733243,66.1,21826,2.9
19189,May 2007,Illinois,9733064,6637831,68.2,6321339,64.9,316492,4.8
19190,May 2007,Indiana,4830704,3198577,66.2,3056864,63.3,141713,4.4
19191,May 2007,Iowa,2303875,1656044,71.9,1595132,69.2,60912,3.7
19192,May 2007,Kansas,2094137,1481198,70.7,1419174,67.8,62024,4.2
19193,May 2007,Kentucky,3269599,2032323,62.2,1925315,58.9,107008,5.3
19194,May 2007,Louisiana,3279938,2018620,61.5,1930821,58.9,87799,4.3
19195,May 2007,Maine,1055909,699615,66.3,667553,63.2,32062,4.6
19196,May 2007,Maryland,4321081,2964741,68.6,2863307,66.3,101434,3.4
19197,May 2007,Massachusetts,5127404,3423783,66.8,3265657,63.7,158126,4.6
19198,May 2007,Michigan,7774209,5013124,64.5,4670905,60.1,342219,6.8
19199,May 2007,Minnesota,4007656,2904924,72.5,2774409,69.2,130515,4.5
19200,May 2007,Mississippi,2169389,1296723,59.8,1216719,56.1,80004,6.2
19201,May 2007,Missouri,4526429,3032549,67.0,2883093,63.7,149456,4.9
19202,May 2007,Montana,749055,500637,66.8,484114,64.6,16523,3.3
19203,May 2007,Nebraska,1340978,977120,72.9,948251,70.7,28869,3.0
19204,May 2007,Nevada,1932909,1325530,68.6,1268265,65.6,57265,4.3
19205,May 2007,New Hampshire,1041546,737588,70.8,711651,68.3,25937,3.5
19206,May 2007,New Jersey,6680436,4428313,66.3,4242768,63.5,185545,4.2
19207,May 2007,New Mexico,1480386,932146,63.0,897916,60.7,34230,3.7
19208,May 2007,New York,15179310,9498541,62.6,9074455,59.8,424086,4.5
19209,May 2007,North Carolina,6861758,4503293,65.6,4296692,62.6,206601,4.6
19210,May 2007,North Dakota,495393,366896,74.1,355440,71.7,11456,3.1
19211,May 2007,Ohio,8893985,5988163,67.3,5660127,63.6,328036,5.5
19212,May 2007,Oklahoma,2713002,1725929,63.6,1652877,60.9,73052,4.2
19213,May 2007,Oregon,2919845,1914721,65.6,1819134,62.3,95587,5.0
19214,May 2007,Pennsylvania,9819965,6322616,64.4,6054521,61.7,268095,4.2
19215,May 2007,Rhode Island,837291,573533,68.5,545437,65.1,28096,4.9
19216,May 2007,South Carolina,3365566,2123546,63.1,2005307,59.6,118239,5.6
19217,May 2007,South Dakota,603847,442211,73.2,429810,71.2,12401,2.8
19218,May 2007,Tennessee,4751300,3058679,64.4,2929731,61.7,128948,4.2
19219,May 2007,Texas,17343816,11395472,65.7,10915098,62.9,480374,4.2
19220,May 2007,Utah,1883565,1356284,72.0,1323017,70.2,33267,2.5
19221,May 2007,Vermont,501915,354223,70.6,340343,67.8,13880,3.9
19222,May 2007,Virginia,5848525,4019091,68.7,3903524,66.7,115567,2.9
19223,May 2007,Washington,4994344,3389288,67.9,3233697,64.7,155591,4.6
19224,May 2007,West Virginia,1443637,809178,56.1,773282,53.6,35896,4.4
19225,May 2007,Wisconsin,4353467,3086270,70.9,2935054,67.4,151216,4.9
19226,May 2007,Wyoming,402568,285769,71.0,277734,69.0,8035,2.8
19227,June 2007,Alabama,3555840,2169967,61.0,2086659,58.7,83308,3.8
19228,June 2007,Alaska,495672,350249,70.7,328092,66.2,22157,6.3
19229,June 2007,Arizona,4756223,3024732,63.6,2914669,61.3,110063,3.6
19230,June 2007,Arkansas,2165134,1368485,63.2,1295049,59.8,73436,5.4
19231,June 2007,California,27250665,17864864,65.6,16923191,62.1,941673,5.3
19232,June 2007,Colorado,3689241,2657543,72.0,2562323,69.5,95220,3.6
19233,June 2007,Connecticut,2706011,1852890,68.5,1772339,65.5,80551,4.3
19234,June 2007,Delaware,667547,442635,66.3,427749,64.1,14886,3.4
19235,June 2007,District of Columbia,473022,320827,67.8,303251,64.1,17576,5.5
19236,June 2007,Florida,14332124,9145207,63.8,8789593,61.3,355614,3.9
19237,June 2007,Georgia,7069217,4802704,67.9,4590141,64.9,212563,4.4
19238,June 2007,Hawaii,968049,637381,65.8,620144,64.1,17237,2.7
19239,June 2007,Idaho,1111626,755853,68.0,733710,66.0,22143,2.9
19240,June 2007,Illinois,9738987,6650894,68.3,6327742,65.0,323152,4.9
19241,June 2007,Indiana,4834163,3194344,66.1,3052594,63.1,141750,4.4
19242,June 2007,Iowa,2305187,1656925,71.9,1596149,69.2,60776,3.7
19243,June 2007,Kansas,2095692,1482450,70.7,1420491,67.8,61959,4.2
19244,June 2007,Kentucky,3271781,2029699,62.0,1923161,58.8,106538,5.2
19245,June 2007,Louisiana,3288245,2020468,61.4,1933636,58.8,86832,4.3
19246,June 2007,Maine,1056469,698916,66.2,666350,63.1,32566,4.7
19247,June 2007,Maryland,4323615,2965230,68.6,2863969,66.2,101261,3.4
19248,June 2007,Massachusetts,5131157,3423049,66.7,3265932,63.6,157117,4.6
19249,June 2007,Michigan,7775181,5006340,64.4,4660472,59.9,345868,6.9
19250,June 2007,Minnesota,4011308,2905474,72.4,2773511,69.1,131963,4.5
19251,June 2007,Mississippi,2170706,1298818,59.8,1219458,56.2,79360,6.1
19252,June 2007,Missouri,4530219,3030140,66.9,2877640,63.5,152500,5.0
19253,June 2007,Montana,749995,501787,66.9,484149,64.6,17638,3.5
19254,June 2007,Nebraska,1341787,978752,72.9,949359,70.8,29393,3.0
19255,June 2007,Nevada,1937559,1327679,68.5,1269161,65.5,58518,4.4
19256,June 2007,New Hampshire,1042464,737802,70.8,712027,68.3,25775,3.5
19257,June 2007,New Jersey,6682870,4429514,66.3,4242879,63.5,186635,4.2
19258,June 2007,New Mexico,1482207,932271,62.9,898218,60.6,34053,3.7
19259,June 2007,New York,15187439,9499555,62.5,9067526,59.7,432029,4.5
19260,June 2007,North Carolina,6875476,4504736,65.5,4296311,62.5,208425,4.6
19261,June 2007,North Dakota,495569,366921,74.0,355444,71.7,11477,3.1
19262,June 2007,Ohio,8897675,5987288,67.3,5656449,63.6,330839,5.5
19263,June 2007,Oklahoma,2715153,1725256,63.5,1652869,60.9,72387,4.2
19264,June 2007,Oregon,2924062,1917102,65.6,1819931,62.2,97171,5.1
19265,June 2007,Pennsylvania,9825270,6329510,64.4,6057184,61.6,272326,4.3
19266,June 2007,Rhode Island,837306,573367,68.5,544604,65.0,28763,5.0
19267,June 2007,South Carolina,3371281,2124003,63.0,2005963,59.5,118040,5.6
19268,June 2007,South Dakota,604538,442761,73.2,430387,71.2,12374,2.8
19269,June 2007,Tennessee,4756801,3056809,64.3,2925537,61.5,131272,4.3
19270,June 2007,Texas,17373223,11403913,65.6,10923517,62.9,480396,4.2
19271,June 2007,Utah,1888192,1359008,72.0,1324675,70.2,34333,2.5
19272,June 2007,Vermont,502139,353821,70.5,339815,67.7,14006,4.0
19273,June 2007,Virginia,5854226,4022656,68.7,3905318,66.7,117338,2.9
19274,June 2007,Washington,5001907,3397375,67.9,3240514,64.8,156861,4.6
19275,June 2007,West Virginia,1444019,809946,56.1,773750,53.6,36196,4.5
19276,June 2007,Wisconsin,4356491,3087134,70.9,2934608,67.4,152526,4.9
19277,June 2007,Wyoming,403237,286416,71.0,278176,69.0,8240,2.9
19278,July 2007,Alabama,3558681,2170255,61.0,2085346,58.6,84909,3.9
19279,July 2007,Alaska,496104,350571,70.7,328304,66.2,22267,6.4
19280,July 2007,Arizona,4766960,3026555,63.5,2916639,61.2,109916,3.6
19281,July 2007,Arkansas,2167028,1368288,63.1,1294292,59.7,73996,5.4
19282,July 2007,California,27272732,17883860,65.6,16925007,62.1,958853,5.4
19283,July 2007,Colorado,3695257,2664412,72.1,2567243,69.5,97169,3.6
19284,July 2007,Connecticut,2707103,1855154,68.5,1773480,65.5,81674,4.4
19285,July 2007,Delaware,668413,442881,66.3,428072,64.0,14809,3.3
19286,July 2007,District of Columbia,473242,321198,67.9,303547,64.1,17651,5.5
19287,July 2007,Florida,14346248,9146699,63.8,8779207,61.2,367492,4.0
19288,July 2007,Georgia,7082742,4811598,67.9,4594816,64.9,216782,4.5
19289,July 2007,Hawaii,968654,636426,65.7,618828,63.9,17598,2.8
19290,July 2007,Idaho,1113839,756445,67.9,733656,65.9,22789,3.0
19291,July 2007,Illinois,9744901,6667148,68.4,6335700,65.0,331448,5.0
19292,July 2007,Indiana,4837626,3193793,66.0,3050705,63.1,143088,4.5
19293,July 2007,Iowa,2306506,1658545,71.9,1597678,69.3,60867,3.7
19294,July 2007,Kansas,2097234,1483889,70.8,1421742,67.8,62147,4.2
19295,July 2007,Kentucky,3274004,2028128,61.9,1921047,58.7,107081,5.3
19296,July 2007,Louisiana,3296552,2024271,61.4,1938832,58.8,85439,4.2
19297,July 2007,Maine,1056994,698634,66.1,665561,63.0,33073,4.7
19298,July 2007,Maryland,4326118,2966862,68.6,2865296,66.2,101566,3.4
19299,July 2007,Massachusetts,5134949,3423004,66.7,3266870,63.6,156134,4.6
19300,July 2007,Michigan,7776164,5001935,64.3,4650839,59.8,351096,7.0
19301,July 2007,Minnesota,4014920,2906293,72.4,2772797,69.1,133496,4.6
19302,July 2007,Mississippi,2172054,1301793,59.9,1223031,56.3,78762,6.1
19303,July 2007,Missouri,4533977,3029230,66.8,2873272,63.4,155958,5.1
19304,July 2007,Montana,750920,502912,67.0,484200,64.5,18712,3.7
19305,July 2007,Nebraska,1342569,980252,73.0,950331,70.8,29921,3.1
19306,July 2007,Nevada,1942229,1330152,68.5,1270243,65.4,59909,4.5
19307,July 2007,New Hampshire,1043343,737992,70.7,712322,68.3,25670,3.5
19308,July 2007,New Jersey,6685308,4432808,66.3,4244929,63.5,187879,4.2
19309,July 2007,New Mexico,1484068,932716,62.8,898660,60.6,34056,3.7
19310,July 2007,New York,15195561,9504776,62.5,9065612,59.7,439164,4.6
19311,July 2007,North Carolina,6889205,4507705,65.4,4296898,62.4,210807,4.7
19312,July 2007,North Dakota,495748,366982,74.0,355500,71.7,11482,3.1
19313,July 2007,Ohio,8901395,5987605,67.3,5653765,63.5,333840,5.6
19314,July 2007,Oklahoma,2717277,1724925,63.5,1653353,60.8,71572,4.1
19315,July 2007,Oregon,2928298,1920437,65.6,1821293,62.2,99144,5.2
19316,July 2007,Pennsylvania,9830577,6338481,64.5,6060935,61.7,277546,4.4
19317,July 2007,Rhode Island,837317,573188,68.5,543643,64.9,29545,5.2
19318,July 2007,South Carolina,3377018,2124898,62.9,2006529,59.4,118369,5.6
19319,July 2007,South Dakota,605214,443212,73.2,430791,71.2,12421,2.8
19320,July 2007,Tennessee,4762302,3057298,64.2,2920867,61.3,136431,4.5
19321,July 2007,Texas,17402744,11417028,65.6,10934650,62.8,482378,4.2
19322,July 2007,Utah,1892813,1361588,71.9,1326162,70.1,35426,2.6
19323,July 2007,Vermont,502403,353400,70.3,339226,67.5,14174,4.0
19324,July 2007,Virginia,5859929,4028886,68.8,3908754,66.7,120132,3.0
19325,July 2007,Washington,5009419,3406063,68.0,3247169,64.8,158894,4.7
19326,July 2007,West Virginia,1444435,810930,56.1,774189,53.6,36741,4.5
19327,July 2007,Wisconsin,4359501,3088423,70.8,2934529,67.3,153894,5.0
19328,July 2007,Wyoming,403916,287021,71.1,278627,69.0,8394,2.9
19329,August 2007,Alabama,3561917,2172270,61.0,2085207,58.5,87063,4.0
19330,August 2007,Alaska,496548,350937,70.7,328602,66.2,22335,6.4
19331,August 2007,Arizona,4776490,3030333,63.4,2918770,61.1,111563,3.7
19332,August 2007,Arkansas,2168911,1368429,63.1,1294104,59.7,74325,5.4
19333,August 2007,California,27303913,17907984,65.6,16928944,62.0,979040,5.5
19334,August 2007,Colorado,3701828,2671733,72.2,2572065,69.5,99668,3.7
19335,August 2007,Connecticut,2709153,1857947,68.6,1774702,65.5,83245,4.5
19336,August 2007,Delaware,669353,443356,66.2,428463,64.0,14893,3.4
19337,August 2007,District of Columbia,473631,322005,68.0,304253,64.2,17752,5.5
19338,August 2007,Florida,14359617,9151797,63.7,8771323,61.1,380474,4.2
19339,August 2007,Georgia,7093411,4822319,68.0,4600995,64.9,221324,4.6
19340,August 2007,Hawaii,969244,635928,65.6,617812,63.7,18116,2.8
19341,August 2007,Idaho,1115743,756654,67.8,733068,65.7,23586,3.1
19342,August 2007,Illinois,9751568,6684622,68.5,6343732,65.1,340890,5.1
19343,August 2007,Indiana,4841311,3196437,66.0,3051184,63.0,145253,4.5
19344,August 2007,Iowa,2307852,1660783,72.0,1599551,69.3,61232,3.7
19345,August 2007,Kansas,2098568,1485483,70.8,1422788,67.8,62695,4.2
19346,August 2007,Kentucky,3277367,2027579,61.9,1919028,58.6,108551,5.4
19347,August 2007,Louisiana,3301976,2030500,61.5,1946016,58.9,84484,4.2
19348,August 2007,Maine,1057594,698792,66.1,665256,62.9,33536,4.8
19349,August 2007,Maryland,4329119,2969124,68.6,2867129,66.2,101995,3.4
19350,August 2007,Massachusetts,5139706,3423607,66.6,3268311,63.6,155296,4.5
19351,August 2007,Michigan,7776510,4999204,64.3,4642450,59.7,356754,7.1
19352,August 2007,Minnesota,4018335,2907313,72.4,2772300,69.0,135013,4.6
19353,August 2007,Mississippi,2173543,1305581,60.1,1227116,56.5,78465,6.0
19354,August 2007,Missouri,4538164,3029620,66.8,2870257,63.2,159363,5.3
19355,August 2007,Montana,751782,503942,67.0,484343,64.4,19599,3.9
19356,August 2007,Nebraska,1343491,981399,73.0,951156,70.8,30243,3.1
19357,August 2007,Nevada,1945510,1333180,68.5,1271822,65.4,61358,4.6
19358,August 2007,New Hampshire,1044147,738199,70.7,712580,68.2,25619,3.5
19359,August 2007,New Jersey,6689085,4438114,66.3,4248446,63.5,189668,4.3
19360,August 2007,New Mexico,1485517,933629,62.8,899315,60.5,34314,3.7
19361,August 2007,New York,15203594,9514662,62.6,9069298,59.7,445364,4.7
19362,August 2007,North Carolina,6900621,4512317,65.4,4298531,62.3,213786,4.7
19363,August 2007,North Dakota,496058,367162,74.0,355651,71.7,11511,3.1
19364,August 2007,Ohio,8904792,5989049,67.3,5652133,63.5,336916,5.6
19365,August 2007,Oklahoma,2719731,1725035,63.4,1654363,60.8,70672,4.1
19366,August 2007,Oregon,2932301,1924484,65.6,1823343,62.2,101141,5.3
19367,August 2007,Pennsylvania,9836784,6348827,64.5,6065674,61.7,283153,4.5
19368,August 2007,Rhode Island,837455,572954,68.4,542539,64.8,30415,5.3
19369,August 2007,South Carolina,3382973,2125988,62.8,2006907,59.3,119081,5.6
19370,August 2007,South Dakota,605796,443530,73.2,431043,71.2,12487,2.8
19371,August 2007,Tennessee,4768036,3059573,64.2,2915760,61.2,143813,4.7
19372,August 2007,Texas,17433249,11434980,65.6,10948390,62.8,486590,4.3
19373,August 2007,Utah,1896507,1363999,71.9,1327577,70.0,36422,2.7
19374,August 2007,Vermont,502642,352998,70.2,338634,67.4,14364,4.1
19375,August 2007,Virginia,5866159,4037631,68.8,3913767,66.7,123864,3.1
19376,August 2007,Washington,5016731,3415145,68.1,3254034,64.9,161111,4.7
19377,August 2007,West Virginia,1444930,812116,56.2,774633,53.6,37483,4.6
19378,August 2007,Wisconsin,4362443,3089886,70.8,2935029,67.3,154857,5.0
19379,August 2007,Wyoming,404543,287545,71.1,279098,69.0,8447,2.9
19380,September 2007,Alabama,3565336,2175380,61.0,2085939,58.5,89441,4.1
19381,September 2007,Alaska,496997,351362,70.7,328976,66.2,22386,6.4
19382,September 2007,Arizona,4786223,3036055,63.4,2921025,61.0,115030,3.8
19383,September 2007,Arkansas,2170921,1368937,63.1,1294768,59.6,74169,5.4
19384,September 2007,California,27336405,17935435,65.6,16935568,62.0,999867,5.6
19385,September 2007,Colorado,3708531,2679172,72.2,2576843,69.5,102329,3.8
19386,September 2007,Connecticut,2711285,1861171,68.6,1776076,65.5,85095,4.6
19387,September 2007,Delaware,670273,444059,66.3,428880,64.0,15179,3.4
19388,September 2007,District of Columbia,474047,323163,68.2,305288,64.4,17875,5.5
19389,September 2007,Florida,14373626,9160898,63.7,8767241,61.0,393657,4.3
19390,September 2007,Georgia,7104351,4834612,68.1,4608639,64.9,225973,4.7
19391,September 2007,Hawaii,969891,635971,65.6,617250,63.6,18721,2.9
19392,September 2007,Idaho,1117698,756178,67.7,731995,65.5,24183,3.2
19393,September 2007,Illinois,9758656,6700912,68.7,6351056,65.1,349856,5.2
19394,September 2007,Indiana,4845110,3201296,66.1,3054043,63.0,147253,4.6
19395,September 2007,Iowa,2309268,1663398,72.0,1601728,69.4,61670,3.7
19396,September 2007,Kansas,2100032,1486962,70.8,1423619,67.8,63343,4.3
19397,September 2007,Kentucky,3280860,2027424,61.8,1917525,58.4,109899,5.4
19398,September 2007,Louisiana,3307526,2038498,61.6,1954321,59.1,84177,4.1
19399,September 2007,Maine,1058224,699325,66.1,665432,62.9,33893,4.8
19400,September 2007,Maryland,4332260,2971577,68.6,2869542,66.2,102035,3.4
19401,September 2007,Massachusetts,5144605,3424863,66.6,3270198,63.6,154665,4.5
19402,September 2007,Michigan,7777126,4996814,64.3,4635895,59.6,360919,7.2
19403,September 2007,Minnesota,4021916,2908243,72.3,2772053,68.9,136190,4.7
19404,September 2007,Mississippi,2175146,1309779,60.2,1231456,56.6,78323,6.0
19405,September 2007,Missouri,4542485,3030588,66.7,2868724,63.2,161864,5.3
19406,September 2007,Montana,752706,504881,67.1,484635,64.4,20246,4.0
19407,September 2007,Nebraska,1344485,982217,73.1,951943,70.8,30274,3.1
19408,September 2007,Nevada,1948879,1336800,68.6,1273968,65.4,62832,4.7
19409,September 2007,New Hampshire,1044982,738511,70.7,712885,68.2,25626,3.5
19410,September 2007,New Jersey,6693130,4445586,66.4,4253499,63.6,192087,4.3
19411,September 2007,New Mexico,1487059,934989,62.9,900203,60.5,34786,3.7
19412,September 2007,New York,15212214,9528946,62.6,9078967,59.7,449979,4.7
19413,September 2007,North Carolina,6912348,4518261,65.4,4301508,62.2,216753,4.8
19414,September 2007,North Dakota,496364,367481,74.0,355942,71.7,11539,3.1
19415,September 2007,Ohio,8908449,5991029,67.3,5652137,63.4,338892,5.7
19416,September 2007,Oklahoma,2722273,1725658,63.4,1656208,60.8,69450,4.0
19417,September 2007,Oregon,2936407,1928783,65.7,1826072,62.2,102711,5.3
19418,September 2007,Pennsylvania,9843273,6360256,64.6,6072032,61.7,288224,4.5
19419,September 2007,Rhode Island,837643,572655,68.4,541317,64.6,31338,5.5
19420,September 2007,South Carolina,3389023,2126989,62.8,2007344,59.2,119645,5.6
19421,September 2007,South Dakota,606448,443750,73.2,431258,71.1,12492,2.8
19422,September 2007,Tennessee,4773950,3062410,64.1,2910741,61.0,151669,5.0
19423,September 2007,Texas,17464661,11456726,65.6,10965668,62.8,491058,4.3
19424,September 2007,Utah,1900303,1366220,71.9,1328918,69.9,37302,2.7
19425,September 2007,Vermont,502894,352667,70.1,338119,67.2,14548,4.1
19426,September 2007,Virginia,5872564,4048461,68.9,3920620,66.8,127841,3.2
19427,September 2007,Washington,5024250,3424380,68.2,3261607,64.9,162773,4.8
19428,September 2007,West Virginia,1445488,813355,56.3,775207,53.6,38148,4.7
19429,September 2007,Wisconsin,4365543,3091166,70.8,2936392,67.3,154774,5.0
19430,September 2007,Wyoming,405178,288046,71.1,279630,69.0,8416,2.9
19431,October 2007,Alabama,3568596,2178388,61.0,2086659,58.5,91729,4.2
19432,October 2007,Alaska,497450,351834,70.7,329393,66.2,22441,6.4
19433,October 2007,Arizona,4795667,3042969,63.5,2922929,60.9,120040,3.9
19434,October 2007,Arkansas,2172797,1369630,63.0,1296215,59.7,73415,5.4
19435,October 2007,California,27367418,17962947,65.6,16942492,61.9,1020455,5.7
19436,October 2007,Colorado,3715036,2686197,72.3,2581271,69.5,104926,3.9
19437,October 2007,Connecticut,2713317,1864606,68.7,1777437,65.5,87169,4.7
19438,October 2007,Delaware,671234,444906,66.3,429288,64.0,15618,3.5
19439,October 2007,District of Columbia,474432,324459,68.4,306434,64.6,18025,5.6
19440,October 2007,Florida,14386906,9171937,63.8,8765116,60.9,406821,4.4
19441,October 2007,Georgia,7115031,4847703,68.1,4616731,64.9,230972,4.8
19442,October 2007,Hawaii,970511,636486,65.6,617207,63.6,19279,3.0
19443,October 2007,Idaho,1119585,754883,67.4,730550,65.3,24333,3.2
19444,October 2007,Illinois,9765252,6713641,68.8,6355963,65.1,357678,5.3
19445,October 2007,Indiana,4848744,3206853,66.1,3058004,63.1,148849,4.6
19446,October 2007,Iowa,2310605,1665963,72.1,1604050,69.4,61913,3.7
19447,October 2007,Kansas,2101341,1488060,70.8,1424185,67.8,63875,4.3
19448,October 2007,Kentucky,3284212,2026901,61.7,1916495,58.4,110406,5.4
19449,October 2007,Louisiana,3312952,2046774,61.8,1962165,59.2,84609,4.1
19450,October 2007,Maine,1058844,700049,66.1,665963,62.9,34086,4.9
19451,October 2007,Maryland,4335243,2973802,68.6,2872323,66.3,101479,3.4
19452,October 2007,Massachusetts,5149281,3426473,66.5,3271886,63.5,154587,4.5
19453,October 2007,Michigan,7777378,4993215,64.2,4630437,59.5,362778,7.3
19454,October 2007,Minnesota,4025298,2908861,72.3,2772027,68.9,136834,4.7
19455,October 2007,Mississippi,2176634,1313674,60.4,1235529,56.8,78145,5.9
19456,October 2007,Missouri,4546601,3030953,66.7,2867694,63.1,163259,5.4
19457,October 2007,Montana,753561,505775,67.1,485083,64.4,20692,4.1
19458,October 2007,Nebraska,1345387,982894,73.1,952793,70.8,30101,3.1
19459,October 2007,Nevada,1952165,1340745,68.7,1276412,65.4,64333,4.8
19460,October 2007,New Hampshire,1045757,738951,70.7,713259,68.2,25692,3.5
19461,October 2007,New Jersey,6696818,4454713,66.5,4259401,63.6,195312,4.4
19462,October 2007,New Mexico,1488458,936585,62.9,901172,60.5,35413,3.8
19463,October 2007,New York,15220098,9545835,62.7,9091815,59.7,454020,4.8
19464,October 2007,North Carolina,6923763,4524302,65.3,4304813,62.2,219489,4.9
19465,October 2007,North Dakota,496661,367905,74.1,356385,71.8,11520,3.1
19466,October 2007,Ohio,8911693,5992356,67.2,5652594,63.4,339762,5.7
19467,October 2007,Oklahoma,2724649,1726422,63.4,1658732,60.9,67690,3.9
19468,October 2007,Oregon,2940386,1932674,65.7,1829114,62.2,103560,5.4
19469,October 2007,Pennsylvania,9849346,6371812,64.7,6079277,61.7,292535,4.6
19470,October 2007,Rhode Island,837770,572319,68.3,540016,64.5,32303,5.6
19471,October 2007,South Carolina,3394942,2127718,62.7,2007912,59.1,119806,5.6
19472,October 2007,South Dakota,607011,443920,73.1,431555,71.1,12365,2.8
19473,October 2007,Tennessee,4779666,3064121,64.1,2905608,60.8,158513,5.2
19474,October 2007,Texas,17495067,11479835,65.6,10985136,62.8,494699,4.3
19475,October 2007,Utah,1904011,1368189,71.9,1330040,69.9,38149,2.8
19476,October 2007,Vermont,503126,352420,70.0,337719,67.1,14701,4.2
19477,October 2007,Virginia,5878751,4060091,69.1,3928594,66.8,131497,3.2
19478,October 2007,Washington,5031493,3433115,68.2,3269555,65.0,163560,4.8
19479,October 2007,West Virginia,1445972,814353,56.3,775876,53.7,38477,4.7
19480,October 2007,Wisconsin,4368458,3091561,70.8,2938399,67.3,153162,5.0
19481,October 2007,Wyoming,405800,288577,71.1,280229,69.1,8348,2.9
19482,November 2007,Alabama,3571609,2180164,61.0,2086787,58.4,93377,4.3
19483,November 2007,Alaska,497891,352339,70.8,329818,66.2,22521,6.4
19484,November 2007,Arizona,4804966,3050277,63.5,2924478,60.9,125799,4.1
19485,November 2007,Arkansas,2174594,1370296,63.0,1298179,59.7,72117,5.3
19486,November 2007,California,27397478,17988188,65.7,16949079,61.9,1039109,5.8
19487,November 2007,Colorado,3721443,2692523,72.4,2585206,69.5,107317,4.0
19488,November 2007,Connecticut,2715153,1867889,68.8,1778672,65.5,89217,4.8
19489,November 2007,Delaware,672135,445778,66.3,429670,63.9,16108,3.6
19490,November 2007,District of Columbia,474808,325684,68.6,307478,64.8,18206,5.6
19491,November 2007,Florida,14399166,9182915,63.8,8763760,60.9,419155,4.6
19492,November 2007,Georgia,7125436,4860881,68.2,4624811,64.9,236070,4.9
19493,November 2007,Hawaii,971191,637357,65.6,617646,63.6,19711,3.1
19494,November 2007,Idaho,1121480,752911,67.1,728883,65.0,24028,3.2
19495,November 2007,Illinois,9771394,6720994,68.8,6358249,65.1,362745,5.4
19496,November 2007,Indiana,4852139,3211381,66.2,3061704,63.1,149677,4.7
19497,November 2007,Iowa,2311802,1668276,72.2,1606389,69.5,61887,3.7
19498,November 2007,Kansas,2102572,1488790,70.8,1424677,67.8,64113,4.3
19499,November 2007,Kentucky,3287457,2025661,61.6,1915689,58.3,109972,5.4
19500,November 2007,Louisiana,3318199,2054068,61.9,1968545,59.3,85523,4.2
19501,November 2007,Maine,1059364,700821,66.2,666710,62.9,34111,4.9
19502,November 2007,Maryland,4337998,2975689,68.6,2875324,66.3,100365,3.4
19503,November 2007,Massachusetts,5153707,3428133,66.5,3272996,63.5,155137,4.5
19504,November 2007,Michigan,7777233,4986772,64.1,4625548,59.5,361224,7.2
19505,November 2007,Minnesota,4028498,2908992,72.2,2772260,68.8,136732,4.7
19506,November 2007,Mississippi,2178005,1316628,60.5,1238933,56.9,77695,5.9
19507,November 2007,Missouri,4550492,3029895,66.6,2866543,63.0,163352,5.4
19508,November 2007,Montana,754430,506613,67.2,485584,64.4,21029,4.2
19509,November 2007,Nebraska,1346253,983700,73.1,953760,70.8,29940,3.0
19510,November 2007,Nevada,1955382,1344793,68.8,1278877,65.4,65916,4.9
19511,November 2007,New Hampshire,1046517,739553,70.7,713739,68.2,25814,3.5
19512,November 2007,New Jersey,6700159,4464432,66.6,4265813,63.7,198619,4.4
19513,November 2007,New Mexico,1489820,938185,63.0,902119,60.6,36066,3.8
19514,November 2007,New York,15227156,9563786,62.8,9106286,59.8,457500,4.8
19515,November 2007,North Carolina,6934914,4529441,65.3,4308030,62.1,221411,4.9
19516,November 2007,North Dakota,496951,368403,74.1,356983,71.8,11420,3.1
19517,November 2007,Ohio,8914436,5990893,67.2,5652317,63.4,338576,5.7
19518,November 2007,Oklahoma,2726950,1727185,63.3,1661815,60.9,65370,3.8
19519,November 2007,Oregon,2944204,1935658,65.7,1832157,62.2,103501,5.3
19520,November 2007,Pennsylvania,9854658,6382861,64.8,6087093,61.8,295768,4.6
19521,November 2007,Rhode Island,837856,571995,68.3,538687,64.3,33308,5.8
19522,November 2007,South Carolina,3400722,2128097,62.6,2008697,59.1,119400,5.6
19523,November 2007,South Dakota,607603,444097,73.1,431994,71.1,12103,2.7
19524,November 2007,Tennessee,4785177,3063565,64.0,2900519,60.6,163046,5.3
19525,November 2007,Texas,17525088,11502507,65.6,11006263,62.8,496244,4.3
19526,November 2007,Utah,1907684,1369818,71.8,1330828,69.8,38990,2.8
19527,November 2007,Vermont,503341,352283,70.0,337464,67.0,14819,4.2
19528,November 2007,Virginia,5884697,4071799,69.2,3937545,66.9,134254,3.3
19529,November 2007,Washington,5038548,3440671,68.3,3277346,65.0,163325,4.7
19530,November 2007,West Virginia,1446379,814984,56.3,776619,53.7,38365,4.7
19531,November 2007,Wisconsin,4371156,3090795,70.7,2941050,67.3,149745,4.8
19532,November 2007,Wyoming,406411,289147,71.1,280868,69.1,8279,2.9
19533,December 2007,Alabama,3574475,2180630,61.0,2086157,58.4,94473,4.3
19534,December 2007,Alaska,498284,352900,70.8,330249,66.3,22651,6.4
19535,December 2007,Arizona,4813893,3057685,63.5,2925854,60.8,131831,4.3
19536,December 2007,Arkansas,2176232,1370993,63.0,1300447,59.8,70546,5.1
19537,December 2007,California,27425922,18011604,65.7,16955709,61.8,1055895,5.9
19538,December 2007,Colorado,3727619,2698033,72.4,2588610,69.4,109423,4.1
19539,December 2007,Connecticut,2716819,1870720,68.9,1779735,65.5,90985,4.9
19540,December 2007,Delaware,672993,446557,66.4,429982,63.9,16575,3.7
19541,December 2007,District of Columbia,475153,326711,68.8,308291,64.9,18420,5.6
19542,December 2007,Florida,14410520,9192972,63.8,8762145,60.8,430827,4.7
19543,December 2007,Georgia,7135470,4874326,68.3,4632770,64.9,241556,5.0
19544,December 2007,Hawaii,971788,638468,65.7,618405,63.6,20063,3.1
19545,December 2007,Idaho,1123263,750563,66.8,727148,64.7,23415,3.1
19546,December 2007,Illinois,9776966,6722716,68.8,6358186,65.0,364530,5.4
19547,December 2007,Indiana,4855240,3214364,66.2,3064603,63.1,149761,4.7
19548,December 2007,Iowa,2312834,1670243,72.2,1608592,69.6,61651,3.7
19549,December 2007,Kansas,2103675,1489360,70.8,1425415,67.8,63945,4.3
19550,December 2007,Kentucky,3290467,2023900,61.5,1914943,58.2,108957,5.4
19551,December 2007,Louisiana,3323283,2059822,62.0,1973338,59.4,86484,4.2
19552,December 2007,Maine,1059861,701552,66.2,667551,63.0,34001,4.8
19553,December 2007,Maryland,4340521,2977656,68.6,2878453,66.3,99203,3.3
19554,December 2007,Massachusetts,5157761,3429832,66.5,3273503,63.5,156329,4.6
19555,December 2007,Michigan,7776660,4977490,64.0,4620300,59.4,357190,7.2
19556,December 2007,Minnesota,4031466,2908891,72.2,2772662,68.8,136229,4.7
19557,December 2007,Mississippi,2179312,1318437,60.5,1241377,57.0,77060,5.8
19558,December 2007,Missouri,4554148,3027711,66.5,2865167,62.9,162544,5.4
19559,December 2007,Montana,755224,507391,67.2,486056,64.4,21335,4.2
19560,December 2007,Nebraska,1347008,984682,73.1,954836,70.9,29846,3.0
19561,December 2007,Nevada,1958465,1348782,68.9,1281090,65.4,67692,5.0
19562,December 2007,New Hampshire,1047214,740286,70.7,714314,68.2,25972,3.5
19563,December 2007,New Jersey,6703077,4473642,66.7,4272185,63.7,201457,4.5
19564,December 2007,New Mexico,1491081,939634,63.0,903032,60.6,36602,3.9
19565,December 2007,New York,15233381,9581991,62.9,9121473,59.9,460518,4.8
19566,December 2007,North Carolina,6945628,4533473,65.3,4311013,62.1,222460,4.9
19567,December 2007,North Dakota,497186,368962,74.2,357712,71.9,11250,3.0
19568,December 2007,Ohio,8916628,5986243,67.1,5650983,63.4,335260,5.6
19569,December 2007,Oklahoma,2729061,1728138,63.3,1665470,61.0,62668,3.6
19570,December 2007,Oregon,2947849,1937575,65.7,1834933,62.2,102642,5.3
19571,December 2007,Pennsylvania,9859441,6393772,64.8,6095859,61.8,297913,4.7
19572,December 2007,Rhode Island,837911,571721,68.2,537353,64.1,34368,6.0
19573,December 2007,South Carolina,3406289,2128414,62.5,2009737,59.0,118677,5.6
19574,December 2007,South Dakota,608131,444324,73.1,432549,71.1,11775,2.7
19575,December 2007,Tennessee,4790396,3060813,63.9,2895771,60.4,165042,5.4
19576,December 2007,Texas,17553909,11524334,65.7,11028715,62.8,495619,4.3
19577,December 2007,Utah,1911237,1371033,71.7,1331216,69.7,39817,2.9
19578,December 2007,Vermont,503532,352286,70.0,337377,67.0,14909,4.2
19579,December 2007,Virginia,5890286,4083460,69.3,3947470,67.0,135990,3.3
19580,December 2007,Washington,5045286,3446728,68.3,3284233,65.1,162495,4.7
19581,December 2007,West Virginia,1446671,815331,56.4,777493,53.7,37838,4.6
19582,December 2007,Wisconsin,4373577,3089160,70.6,2944322,67.3,144838,4.7
19583,December 2007,Wyoming,406998,289716,71.2,281500,69.2,8216,2.8
19584,January 2008,Alabama,3577198,2180011,60.9,2084307,58.3,95704,4.4
19585,January 2008,Alaska,498693,353534,70.9,330692,66.3,22842,6.5
19586,January 2008,Arizona,4822624,3064872,63.6,2926636,60.7,138236,4.5
19587,January 2008,Arkansas,2177814,1371702,63.0,1302583,59.8,69119,5.0
19588,January 2008,California,27453421,18033755,65.7,16959230,61.8,1074525,6.0
19589,January 2008,Colorado,3733587,2702411,72.4,2591051,69.4,111360,4.1
19590,January 2008,Connecticut,2718370,1872881,68.9,1780413,65.5,92468,4.9
19591,January 2008,Delaware,673835,447129,66.4,430131,63.8,16998,3.8
19592,January 2008,District of Columbia,475485,327502,68.9,308834,65.0,18668,5.7
19593,January 2008,Florida,14421176,9199886,63.8,8756660,60.7,443226,4.8
19594,January 2008,Georgia,7145219,4887690,68.4,4639668,64.9,248022,5.1
19595,January 2008,Hawaii,972401,639620,65.8,619170,63.7,20450,3.2
19596,January 2008,Idaho,1125010,748137,66.5,725393,64.5,22744,3.0
19597,January 2008,Illinois,9782110,6719466,68.7,6353880,65.0,365586,5.4
19598,January 2008,Indiana,4858075,3215956,66.2,3065927,63.1,150029,4.7
19599,January 2008,Iowa,2313758,1671686,72.2,1610245,69.6,61441,3.7
19600,January 2008,Kansas,2104656,1489971,70.8,1426445,67.8,63526,4.3
19601,January 2008,Kentucky,3293294,2022032,61.4,1913789,58.1,108243,5.4
19602,January 2008,Louisiana,3328228,2063664,62.0,1976346,59.4,87318,4.2
19603,January 2008,Maine,1060238,702139,66.2,668265,63.0,33874,4.8
19604,January 2008,Maryland,4342905,2979991,68.6,2881089,66.3,98902,3.3
19605,January 2008,Massachusetts,5161571,3431513,66.5,3273060,63.4,158453,4.6
19606,January 2008,Michigan,7775722,4966399,63.9,4612986,59.3,353413,7.1
19607,January 2008,Minnesota,4034155,2909013,72.1,2772826,68.7,136187,4.7
19608,January 2008,Mississippi,2180462,1319123,60.5,1242444,57.0,76679,5.8
19609,January 2008,Missouri,4557530,3024815,66.4,2863111,62.8,161704,5.3
19610,January 2008,Montana,755967,508059,67.2,486363,64.3,21696,4.3
19611,January 2008,Nebraska,1347708,985723,73.1,955901,70.9,29822,3.0
19612,January 2008,Nevada,1961491,1352475,69.0,1282694,65.4,69781,5.2
19613,January 2008,New Hampshire,1047818,740975,70.7,714820,68.2,26155,3.5
19614,January 2008,New Jersey,6705664,4481065,66.8,4276959,63.8,204106,4.6
19615,January 2008,New Mexico,1492337,940724,63.0,903768,60.6,36956,3.9
19616,January 2008,New York,15239027,9598042,63.0,9134103,59.9,463939,4.8
19617,January 2008,North Carolina,6956036,4536013,65.2,4312336,62.0,223677,4.9
19618,January 2008,North Dakota,497394,369532,74.3,358473,72.1,11059,3.0
19619,January 2008,Ohio,8918397,5978942,67.0,5647182,63.3,331760,5.5
19620,January 2008,Oklahoma,2731019,1729281,63.3,1669172,61.1,60109,3.5
19621,January 2008,Oregon,2951299,1938430,65.7,1836937,62.2,101493,5.2
19622,January 2008,Pennsylvania,9863659,6404023,64.9,6104281,61.9,299742,4.7
19623,January 2008,Rhode Island,837890,571482,68.2,535967,64.0,35515,6.2
19624,January 2008,South Carolina,3411702,2128869,62.4,2010622,58.9,118247,5.6
19625,January 2008,South Dakota,608608,444614,73.1,433113,71.2,11501,2.6
19626,January 2008,Tennessee,4795355,3056578,63.7,2890742,60.3,165836,5.4
19627,January 2008,Texas,17582139,11544197,65.7,11049576,62.8,494621,4.3
19628,January 2008,Utah,1914712,1371668,71.6,1331021,69.5,40647,3.0
19629,January 2008,Vermont,503680,352413,70.0,337411,67.0,15002,4.3
19630,January 2008,Virginia,5895643,4094298,69.4,3957008,67.1,137290,3.4
19631,January 2008,Washington,5051757,3451132,68.3,3289110,65.1,162022,4.7
19632,January 2008,West Virginia,1446862,815448,56.4,778361,53.8,37087,4.5
19633,January 2008,Wisconsin,4375769,3087039,70.5,2947416,67.4,139623,4.5
19634,January 2008,Wyoming,407544,290221,71.2,282065,69.2,8156,2.8
19635,February 2008,Alabama,3579499,2178866,60.9,2081227,58.1,97639,4.5
19636,February 2008,Alaska,499046,354231,71.0,331156,66.4,23075,6.5
19637,February 2008,Arizona,4830910,3071715,63.6,2926593,60.6,145122,4.7
19638,February 2008,Arkansas,2179102,1372373,63.0,1304276,59.9,68097,5.0
19639,February 2008,California,27479147,18055339,65.7,16957546,61.7,1097793,6.1
19640,February 2008,Colorado,3739334,2705791,72.4,2592399,69.3,113392,4.2
19641,February 2008,Connecticut,2719672,1874363,68.9,1780566,65.5,93797,5.0
19642,February 2008,Delaware,674570,447431,66.3,430031,63.7,17400,3.9
19643,February 2008,District of Columbia,475745,328082,69.0,309138,65.0,18944,5.8
19644,February 2008,Florida,14430272,9203053,63.8,8745579,60.6,457474,5.0
19645,February 2008,Georgia,7154305,4900362,68.5,4645096,64.9,255266,5.2
19646,February 2008,Hawaii,972875,640651,65.9,619650,63.7,21001,3.3
19647,February 2008,Idaho,1126616,745998,66.2,723741,64.2,22257,3.0
19648,February 2008,Illinois,9786404,6712103,68.6,6344116,64.8,367987,5.5
19649,February 2008,Indiana,4860492,3217041,66.2,3065481,63.1,151560,4.7
19650,February 2008,Iowa,2314422,1672748,72.3,1611135,69.6,61613,3.7
19651,February 2008,Kansas,2105468,1490759,70.8,1427675,67.8,63084,4.2
19652,February 2008,Kentucky,3295867,2020699,61.3,1912117,58.0,108582,5.4
19653,February 2008,Louisiana,3332810,2065937,62.0,1977960,59.3,87977,4.3
19654,February 2008,Maine,1060512,702566,66.2,668686,63.1,33880,4.8
19655,February 2008,Maryland,4344772,2982769,68.7,2882735,66.3,100034,3.4
19656,February 2008,Massachusetts,5164974,3433405,66.5,3271806,63.3,161599,4.7
19657,February 2008,Michigan,7773898,4954730,63.7,4602991,59.2,351739,7.1
19658,February 2008,Minnesota,4036544,2909787,72.1,2772517,68.7,137270,4.7
19659,February 2008,Mississippi,2181475,1318726,60.5,1241834,56.9,76892,5.8
19660,February 2008,Missouri,4560490,3021976,66.3,2860429,62.7,161547,5.3
19661,February 2008,Montana,756618,508539,67.2,486383,64.3,22156,4.4
19662,February 2008,Nebraska,1348302,986724,73.2,956786,71.0,29938,3.0
19663,February 2008,Nevada,1964358,1355756,69.0,1283521,65.3,72235,5.3
19664,February 2008,New Hampshire,1048377,741458,70.7,715122,68.2,26336,3.6
19665,February 2008,New Jersey,6707719,4485997,66.9,4279348,63.8,206649,4.6
19666,February 2008,New Mexico,1493429,941371,63.0,904224,60.5,37147,3.9
19667,February 2008,New York,15243207,9610400,63.0,9142919,60.0,467481,4.9
19668,February 2008,North Carolina,6965787,4537456,65.1,4311435,61.9,226021,5.0
19669,February 2008,North Dakota,497592,370098,74.4,359175,72.2,10923,3.0
19670,February 2008,Ohio,8919307,5971036,66.9,5640505,63.2,330531,5.5
19671,February 2008,Oklahoma,2732742,1730707,63.3,1672465,61.2,58242,3.4
19672,February 2008,Oregon,2954500,1938848,65.6,1838003,62.2,100845,5.2
19673,February 2008,Pennsylvania,9866910,6413011,65.0,6111149,61.9,301862,4.7
19674,February 2008,Rhode Island,837823,571236,68.2,534451,63.8,36785,6.4
19675,February 2008,South Carolina,3416752,2129430,62.3,2010886,58.9,118544,5.6
19676,February 2008,South Dakota,609056,444934,73.1,433539,71.2,11395,2.6
19677,February 2008,Tennessee,4799873,3052528,63.6,2885120,60.1,167408,5.5
19678,February 2008,Texas,17609205,11562088,65.7,11067372,62.8,494716,4.3
19679,February 2008,Utah,1918073,1371722,71.5,1330233,69.4,41489,3.0
19680,February 2008,Vermont,503793,352611,70.0,337497,67.0,15114,4.3
19681,February 2008,Virginia,5900482,4104063,69.6,3965200,67.2,138863,3.4
19682,February 2008,Washington,5057807,3454348,68.3,3291642,65.1,162706,4.7
19683,February 2008,West Virginia,1446983,815307,56.3,779060,53.8,36247,4.4
19684,February 2008,Wisconsin,4377602,3084938,70.5,2949701,67.4,135237,4.4
19685,February 2008,Wyoming,408100,290648,71.2,282544,69.2,8104,2.8
19686,March 2008,Alabama,3582052,2178034,60.8,2077321,58.0,100713,4.6
19687,March 2008,Alaska,499412,354965,71.1,331638,66.4,23327,6.6
19688,March 2008,Arizona,4839400,3078672,63.6,2925742,60.5,152930,5.0
19689,March 2008,Arkansas,2180553,1373075,63.0,1305364,59.9,67711,4.9
19690,March 2008,California,27505162,18079265,65.7,16950002,61.6,1129263,6.2
19691,March 2008,Colorado,3745254,2708612,72.3,2592763,69.2,115849,4.3
19692,March 2008,Connecticut,2721142,1875493,68.9,1780163,65.4,95330,5.1
19693,March 2008,Delaware,675366,447516,66.3,429637,63.6,17879,4.0
19694,March 2008,District of Columbia,476047,328612,69.0,309363,65.0,19249,5.9
19695,March 2008,Florida,14439993,9204905,63.7,8729340,60.5,475565,5.2
19696,March 2008,Georgia,7163749,4912518,68.6,4649080,64.9,263438,5.4
19697,March 2008,Hawaii,973332,641492,65.9,619682,63.7,21810,3.4
19698,March 2008,Idaho,1128349,744450,66.0,722340,64.0,22110,3.0
19699,March 2008,Illinois,9791250,6702655,68.5,6328876,64.6,373779,5.6
19700,March 2008,Indiana,4863316,3219448,66.2,3063877,63.0,155571,4.8
19701,March 2008,Iowa,2315303,1673879,72.3,1611394,69.6,62485,3.7
19702,March 2008,Kansas,2106418,1491944,70.8,1428961,67.8,62983,4.2
19703,March 2008,Kentucky,3298681,2020883,61.3,1910326,57.9,110557,5.5
19704,March 2008,Louisiana,3337626,2067910,62.0,1979262,59.3,88648,4.3
19705,March 2008,Maine,1060902,702891,66.3,668754,63.0,34137,4.9
19706,March 2008,Maryland,4346938,2986217,68.7,2883236,66.3,102981,3.4
19707,March 2008,Massachusetts,5168747,3436094,66.5,3270171,63.3,165923,4.8
19708,March 2008,Michigan,7772766,4944522,63.6,4590502,59.1,354020,7.2
19709,March 2008,Minnesota,4039257,2911762,72.1,2771800,68.6,139962,4.8
19710,March 2008,Mississippi,2182554,1317492,60.4,1239461,56.8,78031,5.9
19711,March 2008,Missouri,4563774,3020507,66.2,2857380,62.6,163127,5.4
19712,March 2008,Montana,757375,508814,67.2,486087,64.2,22727,4.5
19713,March 2008,Nebraska,1348963,987607,73.2,957358,71.0,30249,3.1
19714,March 2008,Nevada,1967341,1358688,69.1,1283582,65.2,75106,5.5
19715,March 2008,New Hampshire,1049025,741760,70.7,715236,68.2,26524,3.6
19716,March 2008,New Jersey,6710074,4489109,66.9,4279335,63.8,209774,4.7
19717,March 2008,New Mexico,1494519,941688,63.0,904384,60.5,37304,4.0
19718,March 2008,New York,15248105,9620542,63.1,9148598,60.0,471944,4.9
19719,March 2008,North Carolina,6975997,4539356,65.1,4308624,61.8,230732,5.1
19720,March 2008,North Dakota,497790,370687,74.5,359770,72.3,10917,2.9
19721,March 2008,Ohio,8920917,5966321,66.9,5631667,63.1,334654,5.6
19722,March 2008,Oklahoma,2734661,1732784,63.4,1675228,61.3,57556,3.3
19723,March 2008,Oregon,2957914,1939841,65.6,1838295,62.1,101546,5.2
19724,March 2008,Pennsylvania,9870932,6421500,65.1,6116183,62.0,305317,4.8
19725,March 2008,Rhode Island,837805,570945,68.1,532755,63.6,38190,6.7
19726,March 2008,South Carolina,3422061,2130552,62.3,2010243,58.7,120309,5.6
19727,March 2008,South Dakota,609538,445255,73.0,433726,71.2,11529,2.6
19728,March 2008,Tennessee,4804746,3050219,63.5,2878894,59.9,171325,5.6
19729,March 2008,Texas,17636630,11580523,65.7,11082153,62.8,498370,4.3
19730,March 2008,Utah,1921544,1371484,71.4,1329084,69.2,42400,3.1
19731,March 2008,Vermont,503985,352853,70.0,337597,67.0,15256,4.3
19732,March 2008,Virginia,5905631,4113238,69.6,3971681,67.3,141557,3.4
19733,March 2008,Washington,5064189,3457666,68.3,3292464,65.0,165202,4.8
19734,March 2008,West Virginia,1447234,814870,56.3,779510,53.9,35360,4.3
19735,March 2008,Wisconsin,4379735,3083709,70.4,2950867,67.4,132842,4.3
19736,March 2008,Wyoming,408662,291041,71.2,282960,69.2,8081,2.8
19737,April 2008,Alabama,3584693,2177852,60.8,2072897,57.8,104955,4.8
19738,April 2008,Alaska,499825,355661,71.2,332098,66.4,23563,6.6
19739,April 2008,Arizona,4848008,3086160,63.7,2924015,60.3,162145,5.3
19740,April 2008,Arkansas,2182082,1373905,63.0,1305801,59.8,68104,5.0
19741,April 2008,California,27532092,18107051,65.8,16936408,61.5,1170643,6.5
19742,April 2008,Colorado,3751342,2711000,72.3,2592090,69.1,118910,4.4
19743,April 2008,Connecticut,2722664,1876660,68.9,1779214,65.3,97446,5.2
19744,April 2008,Delaware,676171,447476,66.2,428932,63.4,18544,4.1
19745,April 2008,District of Columbia,476375,329288,69.1,309702,65.0,19586,5.9
19746,April 2008,Florida,14449961,9207367,63.7,8708931,60.3,498436,5.4
19747,April 2008,Georgia,7173457,4924234,68.6,4651672,64.8,272562,5.5
19748,April 2008,Hawaii,973900,642055,65.9,619130,63.6,22925,3.6
19749,April 2008,Idaho,1130104,756645,67.0,721227,63.8,35418,4.7
19750,April 2008,Illinois,9796390,6691978,68.3,6308469,64.4,383509,5.7
19751,April 2008,Indiana,4866256,3223835,66.2,3061677,62.9,162158,5.0
19752,April 2008,Iowa,2316272,1675360,72.3,1611267,69.6,64093,3.8
19753,April 2008,Kansas,2107403,1493581,70.9,1430102,67.9,63479,4.3
19754,April 2008,Kentucky,3301623,2023004,61.3,1908624,57.8,114380,5.7
19755,April 2008,Louisiana,3342530,2070677,61.9,1980675,59.3,90002,4.3
19756,April 2008,Maine,1061310,703117,66.2,668426,63.0,34691,4.9
19757,April 2008,Maryland,4349192,2990264,68.8,2882606,66.3,107658,3.6
19758,April 2008,Massachusetts,5172601,3439829,66.5,3268385,63.2,171444,5.0
19759,April 2008,Michigan,7771825,4936844,63.5,4576119,58.9,360725,7.3
19760,April 2008,Minnesota,4042105,2915042,72.1,2770889,68.6,144153,4.9
19761,April 2008,Mississippi,2183705,1315651,60.2,1235479,56.6,80172,6.1
19762,April 2008,Missouri,4567221,3020906,66.1,2853952,62.5,166954,5.5
19763,April 2008,Montana,758116,508950,67.1,485549,64.0,23401,4.6
19764,April 2008,Nebraska,1349702,988275,73.2,957550,70.9,30725,3.1
19765,April 2008,Nevada,1970300,1361332,69.1,1282966,65.1,78366,5.8
19766,April 2008,New Hampshire,1049651,742001,70.7,715254,68.1,26747,3.6
19767,April 2008,New Jersey,6712574,4491622,66.9,4277351,63.7,214271,4.8
19768,April 2008,New Mexico,1495667,941981,63.0,904341,60.5,37640,4.0
19769,April 2008,New York,15253522,9630522,63.1,9151583,60.0,478939,5.0
19770,April 2008,North Carolina,6986356,4542659,65.0,4304254,61.6,238405,5.2
19771,April 2008,North Dakota,498037,371282,74.5,360224,72.3,11058,3.0
19772,April 2008,Ohio,8922741,5966147,66.9,5621249,63.0,344898,5.8
19773,April 2008,Oklahoma,2736623,1735732,63.4,1677539,61.3,58193,3.4
19774,April 2008,Oregon,2961357,1941983,65.6,1837880,62.1,104103,5.4
19775,April 2008,Pennsylvania,9875143,6430056,65.1,6119520,62.0,310536,4.8
19776,April 2008,Rhode Island,837801,570638,68.1,530913,63.4,39725,7.0
19777,April 2008,South Carolina,3427401,2132637,62.2,2008519,58.6,124118,5.8
19778,April 2008,South Dakota,610010,445581,73.0,433680,71.1,11901,2.7
19779,April 2008,Tennessee,4809741,3050145,63.4,2872177,59.7,177968,5.8
19780,April 2008,Texas,17664569,11601493,65.7,11094376,62.8,507117,4.4
19781,April 2008,Utah,1925126,1371280,71.2,1327878,69.0,43402,3.2
19782,April 2008,Vermont,504134,353154,70.1,337713,67.0,15441,4.4
19783,April 2008,Virginia,5910973,4121849,69.7,3976129,67.3,145720,3.5
19784,April 2008,Washington,5070675,3461901,68.3,3292424,64.9,169477,4.9
19785,April 2008,West Virginia,1447470,814145,56.2,779653,53.9,34492,4.2
19786,April 2008,Wisconsin,4381983,3083678,70.4,2950746,67.3,132932,4.3
19787,April 2008,Wyoming,409212,291462,71.2,283349,69.2,8113,2.8
19788,May 2008,Alabama,3587446,2178344,60.7,2068253,57.7,110091,5.1
19789,May 2008,Alaska,500225,356235,71.2,332479,66.5,23756,6.7
19790,May 2008,Arizona,4856783,3094308,63.7,2921576,60.2,172732,5.6
19791,May 2008,Arkansas,2183726,1375005,63.0,1305780,59.8,69225,5.0
19792,May 2008,California,27559044,18139327,65.8,16918510,61.4,1220817,6.7
19793,May 2008,Colorado,3757482,2713277,72.2,2590545,68.9,122732,4.5
19794,May 2008,Connecticut,2724259,1878160,68.9,1777870,65.3,100290,5.3
19795,May 2008,Delaware,677046,447391,66.1,427942,63.2,19449,4.3
19796,May 2008,District of Columbia,476678,330116,69.3,310152,65.1,19964,6.0
19797,May 2008,Florida,14460689,9211977,63.7,8686535,60.1,525442,5.7
19798,May 2008,Georgia,7183238,4935792,68.7,4653402,64.8,282390,5.7
19799,May 2008,Hawaii,974398,642213,65.9,617884,63.4,24329,3.8
19800,May 2008,Idaho,1131924,760206,67.2,720340,63.6,39866,5.2
19801,May 2008,Illinois,9801672,6680143,68.2,6284189,64.1,395954,5.9
19802,May 2008,Indiana,4869426,3229861,66.3,3059324,62.8,170537,5.3
19803,May 2008,Iowa,2317378,1677168,72.4,1611039,69.5,66129,3.9
19804,May 2008,Kansas,2108535,1495605,70.9,1430975,67.9,64630,4.3
19805,May 2008,Kentucky,3304688,2026564,61.3,1906977,57.7,119587,5.9
19806,May 2008,Louisiana,3347495,2074917,62.0,1982227,59.2,92690,4.5
19807,May 2008,Maine,1061827,703179,66.2,667682,62.9,35497,5.0
19808,May 2008,Maryland,4351442,2994717,68.8,2881167,66.2,113550,3.8
19809,May 2008,Massachusetts,5176718,3444640,66.5,3266701,63.1,177939,5.2
19810,May 2008,Michigan,7771115,4931729,63.5,4561016,58.7,370713,7.5
19811,May 2008,Minnesota,4045132,2919227,72.2,2770044,68.5,149183,5.1
19812,May 2008,Mississippi,2184868,1313458,60.1,1230426,56.3,83032,6.3
19813,May 2008,Missouri,4570847,3022958,66.1,2850306,62.4,172652,5.7
19814,May 2008,Montana,758910,509059,67.1,484899,63.9,24160,4.7
19815,May 2008,Nebraska,1350512,988760,73.2,957465,70.9,31295,3.2
19816,May 2008,Nevada,1973333,1363753,69.1,1281780,65.0,81973,6.0
19817,May 2008,New Hampshire,1050338,742285,70.7,715279,68.1,27006,3.6
19818,May 2008,New Jersey,6715242,4494916,66.9,4274499,63.7,220417,4.9
19819,May 2008,New Mexico,1496868,942599,63.0,904281,60.4,38318,4.1
19820,May 2008,New York,15259142,9642282,63.2,9153029,60.0,489253,5.1
19821,May 2008,North Carolina,6996920,4547857,65.0,4299294,61.4,248563,5.5
19822,May 2008,North Dakota,498302,371804,74.6,360496,72.3,11308,3.0
19823,May 2008,Ohio,8924889,5969766,66.9,5610186,62.9,359580,6.0
19824,May 2008,Oklahoma,2738669,1739591,63.5,1679747,61.3,59844,3.4
19825,May 2008,Oregon,2965016,1945509,65.6,1836911,62.0,108598,5.6
19826,May 2008,Pennsylvania,9879825,6439363,65.2,6122030,62.0,317333,4.9
19827,May 2008,Rhode Island,837855,570359,68.1,528999,63.1,41360,7.3
19828,May 2008,South Carolina,3432857,2135798,62.2,2005909,58.4,129889,6.1
19829,May 2008,South Dakota,610576,445935,73.0,433494,71.0,12441,2.8
19830,May 2008,Tennessee,4814888,3052073,63.4,2865468,59.5,186605,6.1
19831,May 2008,Texas,17692809,11626382,65.7,11105401,62.8,520981,4.5
19832,May 2008,Utah,1928810,1371314,71.1,1326818,68.8,44496,3.2
19833,May 2008,Vermont,504303,353559,70.1,337893,67.0,15666,4.4
19834,May 2008,Virginia,5916469,4129890,69.8,3978871,67.3,151019,3.7
19835,May 2008,Washington,5077412,3467253,68.3,3292273,64.8,174980,5.0
19836,May 2008,West Virginia,1447778,813271,56.2,779543,53.8,33728,4.1
19837,May 2008,Wisconsin,4384483,3084883,70.4,2949599,67.3,135284,4.4
19838,May 2008,Wyoming,409806,291983,71.2,283769,69.2,8214,2.8
19839,June 2008,Alabama,3590424,2179192,60.7,2063354,57.5,115838,5.3
19840,June 2008,Alaska,500654,356639,71.2,332733,66.5,23906,6.7
19841,June 2008,Arizona,4865847,3103036,63.8,2918967,60.0,184069,5.9
19842,June 2008,Arkansas,2185440,1376388,63.0,1305374,59.7,71014,5.2
19843,June 2008,California,27587706,18175008,65.9,16898444,61.3,1276564,7.0
19844,June 2008,Colorado,3763867,2715900,72.2,2588616,68.8,127284,4.7
19845,June 2008,Connecticut,2726025,1880149,69.0,1776403,65.2,103746,5.5
19846,June 2008,Delaware,677885,447326,66.0,426730,63.0,20596,4.6
19847,June 2008,District of Columbia,477031,330950,69.4,310533,65.1,20417,6.2
19848,June 2008,Florida,14472206,9219484,63.7,8664403,59.9,555081,6.0
19849,June 2008,Georgia,7193494,4947526,68.8,4654872,64.7,292654,5.9
19850,June 2008,Hawaii,974980,641937,65.8,615993,63.2,25944,4.0
19851,June 2008,Idaho,1133789,761212,67.1,719408,63.5,41804,5.5
19852,June 2008,Illinois,9807583,6667190,68.0,6258121,63.8,409069,6.1
19853,June 2008,Indiana,4872865,3236303,66.4,3056722,62.7,179581,5.5
19854,June 2008,Iowa,2318576,1679085,72.4,1610855,69.5,68230,4.1
19855,June 2008,Kansas,2109796,1497928,71.0,1431583,67.9,66345,4.4
19856,June 2008,Kentucky,3307933,2030531,61.4,1905282,57.6,125249,6.2
19857,June 2008,Louisiana,3352675,2081090,62.1,1984107,59.2,96983,4.7
19858,June 2008,Maine,1062361,703014,66.2,666499,62.7,36515,5.2
19859,June 2008,Maryland,4354007,2999538,68.9,2879383,66.1,120155,4.0
19860,June 2008,Massachusetts,5181107,3450325,66.6,3265286,63.0,185039,5.4
19861,June 2008,Michigan,7770857,4928308,63.4,4546189,58.5,382119,7.8
19862,June 2008,Minnesota,4048438,2923829,72.2,2769395,68.4,154434,5.3
19863,June 2008,Mississippi,2186207,1311051,60.0,1225044,56.0,86007,6.6
19864,June 2008,Missouri,4574724,3026250,66.2,2846846,62.2,179404,5.9
19865,June 2008,Montana,759760,509232,67.0,484231,63.7,25001,4.9
19866,June 2008,Nebraska,1351414,989173,73.2,957288,70.8,31885,3.2
19867,June 2008,Nevada,1976466,1365900,69.1,1279944,64.8,85956,6.3
19868,June 2008,New Hampshire,1051123,742657,70.7,715350,68.1,27307,3.7
19869,June 2008,New Jersey,6718294,4499707,67.0,4271786,63.6,227921,5.1
19870,June 2008,New Mexico,1498176,943705,63.0,904295,60.4,39410,4.2
19871,June 2008,New York,15265601,9657335,63.3,9154693,60.0,502642,5.2
19872,June 2008,North Carolina,7007925,4554347,65.0,4294463,61.3,259884,5.7
19873,June 2008,North Dakota,498606,372162,74.6,360557,72.3,11605,3.1
19874,June 2008,Ohio,8927562,5974800,66.9,5598986,62.7,375814,6.3
19875,June 2008,Oklahoma,2740965,1744210,63.6,1682142,61.4,62068,3.6
19876,June 2008,Oregon,2968804,1950369,65.7,1835401,61.8,114968,5.9
19877,June 2008,Pennsylvania,9885062,6449889,65.2,6124268,62.0,325621,5.0
19878,June 2008,Rhode Island,837929,570140,68.0,527077,62.9,43063,7.6
19879,June 2008,South Carolina,3438473,2139802,62.2,2002785,58.2,137017,6.4
19880,June 2008,South Dakota,611174,446340,73.0,433263,70.9,13077,2.9
19881,June 2008,Tennessee,4820351,3055174,63.4,2859291,59.3,195883,6.4
19882,June 2008,Texas,17722244,11655723,65.8,11116564,62.7,539159,4.6
19883,June 2008,Utah,1932599,1371540,71.0,1325788,68.6,45752,3.3
19884,June 2008,Vermont,504558,354102,70.2,338177,67.0,15925,4.5
19885,June 2008,Virginia,5922288,4137526,69.9,3980695,67.2,156831,3.8
19886,June 2008,Washington,5084384,3473740,68.3,3292676,64.8,181064,5.2
19887,June 2008,West Virginia,1448230,812466,56.1,779305,53.8,33161,4.1
19888,June 2008,Wisconsin,4387249,3087438,70.4,2947927,67.2,139511,4.5
19889,June 2008,Wyoming,410427,292645,71.3,284250,69.3,8395,2.9
19890,July 2008,Alabama,3593293,2179298,60.6,2057701,57.3,121597,5.6
19891,July 2008,Alaska,501082,356856,71.2,332858,66.4,23998,6.7
19892,July 2008,Arizona,4874841,3111845,63.8,2916357,59.8,195488,6.3
19893,July 2008,Arkansas,2187167,1377649,63.0,1304334,59.6,73315,5.3
19894,July 2008,California,27615732,18209191,65.9,16875741,61.1,1333450,7.3
19895,July 2008,Colorado,3770226,2718730,72.1,2586542,68.6,132188,4.9
19896,July 2008,Connecticut,2727747,1882470,69.0,1774948,65.1,107522,5.7
19897,July 2008,Delaware,678769,447280,65.9,425347,62.7,21933,4.9
19898,July 2008,District of Columbia,477346,331629,69.5,310633,65.1,20996,6.3
19899,July 2008,Florida,14483564,9227693,63.7,8642421,59.7,585272,6.3
19900,July 2008,Georgia,7203540,4959084,68.8,4655861,64.6,303223,6.1
19901,July 2008,Hawaii,975546,641232,65.7,613570,62.9,27662,4.3
19902,July 2008,Idaho,1135675,761068,67.0,718050,63.2,43018,5.7
19903,July 2008,Illinois,9813237,6652581,67.8,6231413,63.5,421168,6.3
19904,July 2008,Indiana,4876173,3241356,66.5,3052757,62.6,188599,5.8
19905,July 2008,Iowa,2319771,1680775,72.5,1610602,69.4,70173,4.2
19906,July 2008,Kansas,2110980,1500304,71.1,1431986,67.8,68318,4.6
19907,July 2008,Kentucky,3311128,2033724,61.4,1903220,57.5,130504,6.4
19908,July 2008,Louisiana,3357744,2088524,62.2,1986160,59.2,102364,4.9
19909,July 2008,Maine,1062884,702556,66.1,664830,62.5,37726,5.4
19910,July 2008,Maryland,4356418,3004426,69.0,2877410,66.0,127016,4.2
19911,July 2008,Massachusetts,5185422,3456222,66.7,3263899,62.9,192323,5.6
19912,July 2008,Michigan,7770438,4924382,63.4,4531843,58.3,392539,8.0
19913,July 2008,Minnesota,4051642,2928191,72.3,2768735,68.3,159456,5.4
19914,July 2008,Mississippi,2187453,1308114,59.8,1219739,55.8,88375,6.8
19915,July 2008,Missouri,4578539,3029648,66.2,2843482,62.1,186166,6.1
19916,July 2008,Montana,760598,509525,67.0,483625,63.6,25900,5.1
19917,July 2008,Nebraska,1352261,989687,73.2,957160,70.8,32527,3.3
19918,July 2008,Nevada,1979594,1367577,69.1,1277130,64.5,90447,6.6
19919,July 2008,New Hampshire,1051868,743038,70.6,715330,68.0,27708,3.7
19920,July 2008,New Jersey,6721248,4505474,67.0,4269183,63.5,236291,5.2
19921,July 2008,New Mexico,1499466,945121,63.0,904278,60.3,40843,4.3
19922,July 2008,New York,15271726,9674584,63.3,9156275,60.0,518309,5.4
19923,July 2008,North Carolina,7018773,4559638,65.0,4289392,61.1,270246,5.9
19924,July 2008,North Dakota,498898,372248,74.6,360409,72.2,11839,3.2
19925,July 2008,Ohio,8930028,5977137,66.9,5586828,62.6,390309,6.5
19926,July 2008,Oklahoma,2743144,1749084,63.8,1684705,61.4,64379,3.7
19927,July 2008,Oregon,2972578,1955947,65.8,1833034,61.7,122913,6.3
19928,July 2008,Pennsylvania,9890101,6460877,65.3,6125474,61.9,335403,5.2
19929,July 2008,Rhode Island,838009,570002,68.0,525183,62.7,44819,7.9
19930,July 2008,South Carolina,3444043,2143954,62.3,1999261,58.0,144693,6.7
19931,July 2008,South Dakota,611741,446783,73.0,433062,70.8,13721,3.1
19932,July 2008,Tennessee,4825694,3057805,63.4,2853490,59.1,204315,6.7
19933,July 2008,Texas,17751353,11686033,65.8,11126971,62.7,559062,4.8
19934,July 2008,Utah,1936350,1371741,70.8,1324473,68.4,47268,3.4
19935,July 2008,Vermont,504770,354764,70.3,338529,67.1,16235,4.6
19936,July 2008,Virginia,5927975,4144200,69.9,3981731,67.2,162469,3.9
19937,July 2008,Washington,5091309,3480886,68.4,3293801,64.7,187085,5.4
19938,July 2008,West Virginia,1448618,811808,56.0,778956,53.8,32852,4.0
19939,July 2008,Wisconsin,4389936,3090765,70.4,2945681,67.1,145084,4.7
19940,July 2008,Wyoming,411048,293426,71.4,284773,69.3,8653,2.9
19941,August 2008,Alabama,3596204,2178199,60.6,2050572,57.0,127627,5.9
19942,August 2008,Alaska,502170,356920,71.1,332875,66.3,24045,6.7
19943,August 2008,Arizona,4882204,3119852,63.9,2913360,59.7,206492,6.6
19944,August 2008,Arkansas,2188840,1378339,63.0,1302247,59.5,76092,5.5
19945,August 2008,California,27647757,18237890,66.0,16848007,60.9,1389883,7.6
19946,August 2008,Colorado,3776709,2721408,72.1,2584334,68.4,137074,5.0
19947,August 2008,Connecticut,2729782,1884779,69.0,1773463,65.0,111316,5.9
19948,August 2008,Delaware,679481,447205,65.8,423812,62.4,23393,5.2
19949,August 2008,District of Columbia,478161,332088,69.5,310364,64.9,21724,6.5
19950,August 2008,Florida,14494359,9233153,63.7,8618353,59.5,614800,6.7
19951,August 2008,Georgia,7212743,4970199,68.9,4655685,64.5,314514,6.3
19952,August 2008,Hawaii,976125,640136,65.6,610705,62.6,29431,4.6
19953,August 2008,Idaho,1137065,760211,66.9,716090,63.0,44121,5.8
19954,August 2008,Illinois,9820037,6636562,67.6,6205083,63.2,431479,6.5
19955,August 2008,Indiana,4879459,3243996,66.5,3045898,62.4,198098,6.1
19956,August 2008,Iowa,2321258,1682188,72.5,1609982,69.4,72206,4.3
19957,August 2008,Kansas,2112793,1502681,71.1,1432280,67.8,70401,4.7
19958,August 2008,Kentucky,3312948,2035826,61.5,1900324,57.4,135502,6.7
19959,August 2008,Louisiana,3360884,2095848,62.4,1987845,59.1,108003,5.2
19960,August 2008,Maine,1063209,701831,66.0,662648,62.3,39183,5.6
19961,August 2008,Maryland,4360469,3009085,69.0,2875001,65.9,134084,4.5
19962,August 2008,Massachusetts,5190727,3461656,66.7,3261996,62.8,199660,5.8
19963,August 2008,Michigan,7771436,4917986,63.3,4515832,58.1,402154,8.2
19964,August 2008,Minnesota,4054892,2931765,72.3,2767588,68.3,164177,5.6
19965,August 2008,Mississippi,2188782,1304395,59.6,1214580,55.5,89815,6.9
19966,August 2008,Missouri,4581836,3032357,66.2,2839766,62.0,192591,6.4
19967,August 2008,Montana,761268,509867,67.0,482985,63.4,26882,5.3
19968,August 2008,Nebraska,1353373,990467,73.2,957058,70.7,33409,3.4
19969,August 2008,Nevada,1981608,1368608,69.1,1272966,64.2,95642,7.0
19970,August 2008,New Hampshire,1052469,743374,70.6,715029,67.9,28345,3.8
19971,August 2008,New Jersey,6726036,4511286,67.1,4265739,63.4,245547,5.4
19972,August 2008,New Mexico,1501107,946548,63.1,903944,60.2,42604,4.5
19973,August 2008,New York,15280962,9691204,63.4,9155607,59.9,535597,5.5
19974,August 2008,North Carolina,7028454,4561100,64.9,4282656,60.9,278444,6.1
19975,August 2008,North Dakota,499374,372016,74.5,360038,72.1,11978,3.2
19976,August 2008,Ohio,8933289,5974348,66.9,5572394,62.4,401954,6.7
19977,August 2008,Oklahoma,2746239,1753696,63.9,1687032,61.4,66664,3.8
19978,August 2008,Oregon,2976099,1961436,65.9,1829264,61.5,132172,6.7
19979,August 2008,Pennsylvania,9895782,6470784,65.4,6123898,61.9,346886,5.4
19980,August 2008,Rhode Island,838423,569908,68.0,523287,62.4,46621,8.2
19981,August 2008,South Carolina,3448595,2147759,62.3,1995089,57.9,152670,7.1
19982,August 2008,South Dakota,612285,447254,73.0,432892,70.7,14362,3.2
19983,August 2008,Tennessee,4829913,3058962,63.3,2847397,59.0,211565,6.9
19984,August 2008,Texas,17783166,11713184,65.9,11134279,62.6,578905,4.9
19985,August 2008,Utah,1939685,1371555,70.7,1322489,68.2,49066,3.6
19986,August 2008,Vermont,505023,355500,70.4,338854,67.1,16646,4.7
19987,August 2008,Virginia,5934957,4149182,69.9,3981181,67.1,168001,4.0
19988,August 2008,Washington,5099238,3488008,68.4,3294926,64.6,193082,5.5
19989,August 2008,West Virginia,1449189,811377,56.0,778383,53.7,32994,4.1
19990,August 2008,Wisconsin,4392873,3094238,70.4,2942494,67.0,151744,4.9
19991,August 2008,Wyoming,411744,294248,71.5,285272,69.3,8976,3.1
19992,September 2008,Alabama,3598993,2176487,60.5,2041145,56.7,135342,6.2
19993,September 2008,Alaska,503222,356908,70.9,332812,66.1,24096,6.8
19994,September 2008,Arizona,4889372,3126192,63.9,2909013,59.5,217179,6.9
19995,September 2008,Arkansas,2190470,1378258,62.9,1298773,59.3,79485,5.8
19996,September 2008,California,27679019,18260708,66.0,16810826,60.7,1449882,7.9
19997,September 2008,Colorado,3783064,2723635,72.0,2581662,68.2,141973,5.2
19998,September 2008,Connecticut,2731705,1886694,69.1,1771746,64.9,114948,6.1
19999,September 2008,Delaware,680178,447058,65.7,422110,62.1,24948,5.6
20000,September 2008,District of Columbia,478964,332380,69.4,309780,64.7,22600,6.8
20001,September 2008,Florida,14504739,9233547,63.7,8588046,59.2,645501,7.0
20002,September 2008,Georgia,7221664,4809851,66.6,4481586,62.1,328265,6.8
20003,September 2008,Hawaii,976705,638797,65.4,607480,62.2,31317,4.9
20004,September 2008,Idaho,1138405,759054,66.7,713499,62.7,45555,6.0
20005,September 2008,Illinois,9826546,6621432,67.4,6179097,62.9,442335,6.7
20006,September 2008,Indiana,4882575,3244148,66.4,3034594,62.2,209554,6.5
20007,September 2008,Iowa,2322671,1683498,72.5,1608630,69.3,74868,4.4
20008,September 2008,Kansas,2114526,1505247,71.2,1432437,67.7,72810,4.8
20009,September 2008,Kentucky,3314652,2037443,61.5,1896010,57.2,141433,6.9
20010,September 2008,Louisiana,3363894,2101575,62.5,1988229,59.1,113346,5.4
20011,September 2008,Maine,1063497,700983,65.9,659988,62.1,40995,5.8
20012,September 2008,Maryland,4364380,3013634,69.1,2871664,65.8,141970,4.7
20013,September 2008,Massachusetts,5195775,3466081,66.7,3258630,62.7,207451,6.0
20014,September 2008,Michigan,7772172,4909036,63.2,4494598,57.8,414438,8.4
20015,September 2008,Minnesota,4058030,2934806,72.3,2765254,68.1,169552,5.8
20016,September 2008,Mississippi,2190044,1300163,59.4,1209356,55.2,90807,7.0
20017,September 2008,Missouri,4584996,3034841,66.2,2834975,61.8,199866,6.6
20018,September 2008,Montana,761925,510063,66.9,482096,63.3,27967,5.5
20019,September 2008,Nebraska,1354435,991334,73.2,956830,70.6,34504,3.5
20020,September 2008,Nevada,1983560,1368888,69.0,1267235,63.9,101653,7.4
20021,September 2008,New Hampshire,1053023,743657,70.6,714285,67.8,29372,3.9
20022,September 2008,New Jersey,6730644,4516599,67.1,4259747,63.3,256852,5.7
20023,September 2008,New Mexico,1502721,947697,63.1,902914,60.1,44783,4.7
20024,September 2008,New York,15289715,9704706,63.5,9148655,59.8,556051,5.7
20025,September 2008,North Carolina,7037922,4557791,64.8,4271997,60.7,285794,6.3
20026,September 2008,North Dakota,499813,371582,74.3,359437,71.9,12145,3.3
20027,September 2008,Ohio,8936246,5967863,66.8,5553961,62.2,413902,6.9
20028,September 2008,Oklahoma,2749269,1757430,63.9,1688239,61.4,69191,3.9
20029,September 2008,Oregon,2979483,1966533,66.0,1823527,61.2,143006,7.3
20030,September 2008,Pennsylvania,9901160,6478764,65.4,6117227,61.8,361537,5.6
20031,September 2008,Rhode Island,838861,569838,67.9,521334,62.1,48504,8.5
20032,September 2008,South Carolina,3453007,2151287,62.3,1989652,57.6,161635,7.5
20033,September 2008,South Dakota,612844,447704,73.1,432657,70.6,15047,3.4
20034,September 2008,Tennessee,4834013,3058919,63.3,2839856,58.7,219063,7.2
20035,September 2008,Texas,17814485,11735105,65.9,11135112,62.5,599993,5.1
20036,September 2008,Utah,1942966,1370622,70.5,1319447,67.9,51175,3.7
20037,September 2008,Vermont,505257,356283,70.5,339054,67.1,17229,4.8
20038,September 2008,Virginia,5941756,4152142,69.9,3977381,66.9,174761,4.2
20039,September 2008,Washington,5106981,3494749,68.4,3294708,64.5,200041,5.7
20040,September 2008,West Virginia,1449753,811267,56.0,777350,53.6,33917,4.2
20041,September 2008,Wisconsin,4395671,3097724,70.5,2937725,66.8,159999,5.2
20042,September 2008,Wyoming,412444,294970,71.5,285626,69.3,9344,3.2
20043,October 2008,Alabama,3601896,2174964,60.4,2028929,56.3,146035,6.7
20044,October 2008,Alaska,504284,356922,70.8,332707,66.0,24215,6.8
20045,October 2008,Arizona,4896695,3130478,63.9,2902497,59.3,227981,7.3
20046,October 2008,Arkansas,2192094,1377361,62.8,1293812,59.0,83549,6.1
20047,October 2008,California,27710666,18278674,66.0,16760254,60.5,1518420,8.3
20048,October 2008,Colorado,3789510,2725327,71.9,2578144,68.0,147183,5.4
20049,October 2008,Connecticut,2733733,1887938,69.1,1769593,64.7,118345,6.3
20050,October 2008,Delaware,680882,446804,65.6,420197,61.7,26607,6.0
20051,October 2008,District of Columbia,479756,332555,69.3,308958,64.4,23597,7.1
20052,October 2008,Florida,14515421,9228005,63.6,8547770,58.9,680235,7.4
20053,October 2008,Georgia,7230835,4770489,66.0,4424420,61.2,346069,7.3
20054,October 2008,Hawaii,977292,637383,65.2,603962,61.8,33421,5.2
20055,October 2008,Idaho,1139803,757850,66.5,710324,62.3,47526,6.3
20056,October 2008,Illinois,9833265,6610157,67.2,6152180,62.6,457977,6.9
20057,October 2008,Indiana,4885822,3242652,66.4,3018183,61.8,224469,6.9
20058,October 2008,Iowa,2324167,1685021,72.5,1606327,69.1,78694,4.7
20059,October 2008,Kansas,2116326,1507919,71.3,1432283,67.7,75636,5.0
20060,October 2008,Kentucky,3316457,2039396,61.5,1890098,57.0,149298,7.3
20061,October 2008,Louisiana,3366976,2104209,62.5,1986258,59.0,117951,5.6
20062,October 2008,Maine,1063777,700183,65.8,656924,61.8,43259,6.2
20063,October 2008,Maryland,4368415,3018207,69.1,2866984,65.6,151223,5.0
20064,October 2008,Massachusetts,5200987,3469120,66.7,3253005,62.5,216115,6.2
20065,October 2008,Michigan,7773056,4898150,63.0,4466106,57.5,432044,8.8
20066,October 2008,Minnesota,4061267,2937794,72.3,2761107,68.0,176687,6.0
20067,October 2008,Mississippi,2191391,1295854,59.1,1203724,54.9,92130,7.1
20068,October 2008,Missouri,4588232,3037807,66.2,2828474,61.6,209333,6.9
20069,October 2008,Montana,762562,509861,66.9,480689,63.0,29172,5.7
20070,October 2008,Nebraska,1355531,992102,73.2,956336,70.6,35766,3.6
20071,October 2008,Nevada,1985545,1368365,68.9,1259968,63.5,108397,7.9
20072,October 2008,New Hampshire,1053601,743939,70.6,713008,67.7,30931,4.2
20073,October 2008,New Jersey,6735309,4521482,67.1,4249792,63.1,271690,6.0
20074,October 2008,New Mexico,1504338,948298,63.0,900805,59.9,47493,5.0
20075,October 2008,New York,15298763,9713684,63.5,9131699,59.7,581985,6.0
20076,October 2008,North Carolina,7047540,4549917,64.6,4255492,60.4,294425,6.5
20077,October 2008,North Dakota,500268,371091,74.2,358640,71.7,12451,3.4
20078,October 2008,Ohio,8939361,5960773,66.7,5530558,61.9,430215,7.2
20079,October 2008,Oklahoma,2752323,1760061,63.9,1687543,61.3,72518,4.1
20080,October 2008,Oregon,2982987,1971342,66.1,1815456,60.9,155886,7.9
20081,October 2008,Pennsylvania,9906713,6484511,65.5,6103669,61.6,380842,5.9
20082,October 2008,Rhode Island,839290,569799,67.9,519276,61.9,50523,8.9
20083,October 2008,South Carolina,3457510,2154714,62.3,1982401,57.3,172313,8.0
20084,October 2008,South Dakota,613424,448126,73.1,432275,70.5,15851,3.5
20085,October 2008,Tennessee,4838191,3058871,63.2,2829788,58.5,229083,7.5
20086,October 2008,Texas,17846170,11751292,65.8,11126900,62.3,624392,5.3
20087,October 2008,Utah,1946306,1368703,70.3,1315096,67.6,53607,3.9
20088,October 2008,Vermont,505508,357125,70.6,339066,67.1,18059,5.1
20089,October 2008,Virginia,5948680,4153146,69.8,3968914,66.7,184232,4.4
20090,October 2008,Washington,5114846,3501098,68.4,3291885,64.4,209213,6.0
20091,October 2008,West Virginia,1450291,811462,56.0,775655,53.5,35807,4.4
20092,October 2008,Wisconsin,4398555,3101342,70.5,2930543,66.6,170799,5.5
20093,October 2008,Wyoming,413128,295534,71.5,285732,69.2,9802,3.3
20094,November 2008,Alabama,3604408,2174068,60.3,2014057,55.9,160011,7.4
20095,November 2008,Alaska,505353,357059,70.7,332600,65.8,24459,6.9
20096,November 2008,Arizona,4903496,3132628,63.9,2893408,59.0,239220,7.6
20097,November 2008,Arkansas,2193563,1375782,62.7,1287664,58.7,88118,6.4
20098,November 2008,California,27740241,18290767,65.9,16694115,60.2,1596652,8.7
20099,November 2008,Colorado,3795646,2726382,71.8,2573392,67.8,152990,5.6
20100,November 2008,Connecticut,2735434,1888455,69.0,1766692,64.6,121763,6.4
20101,November 2008,Delaware,681538,446400,65.5,418038,61.3,28362,6.4
20102,November 2008,District of Columbia,480537,332575,69.2,307928,64.1,24647,7.4
20103,November 2008,Florida,14524347,9215819,63.5,8495651,58.5,720168,7.8
20104,November 2008,Georgia,7239404,4767265,65.9,4399483,60.8,367782,7.7
20105,November 2008,Hawaii,977913,636024,65.0,600271,61.4,35753,5.6
20106,November 2008,Idaho,1141084,756613,66.3,706739,61.9,49874,6.6
20107,November 2008,Illinois,9839056,6604189,67.1,6122512,62.2,481677,7.3
20108,November 2008,Indiana,4888584,3240128,66.3,2997029,61.3,243099,7.5
20109,November 2008,Iowa,2325378,1686832,72.5,1603022,68.9,83810,5.0
20110,November 2008,Kansas,2117869,1510525,71.3,1431555,67.6,78970,5.2
20111,November 2008,Kentucky,3317952,2042162,61.5,1882841,56.7,159321,7.8
20112,November 2008,Louisiana,3369760,2102636,62.4,1981048,58.8,121588,5.8
20113,November 2008,Maine,1063982,699534,65.7,653611,61.4,45923,6.6
20114,November 2008,Maryland,4372021,3022477,69.1,2860729,65.4,161748,5.4
20115,November 2008,Massachusetts,5205636,3470534,66.7,3244976,62.3,225558,6.5
20116,November 2008,Michigan,7773150,4885217,62.8,4430745,57.0,454472,9.3
20117,November 2008,Minnesota,4064091,2940901,72.4,2754990,67.8,185911,6.3
20118,November 2008,Mississippi,2192508,1291758,58.9,1197261,54.6,94497,7.3
20119,November 2008,Missouri,4591041,3041096,66.2,2820018,61.4,221078,7.3
20120,November 2008,Montana,763186,509133,66.7,478664,62.7,30469,6.0
20121,November 2008,Nebraska,1356466,992662,73.2,955427,70.4,37235,3.8
20122,November 2008,Nevada,1987408,1366894,68.8,1251382,63.0,115512,8.5
20123,November 2008,New Hampshire,1054080,744273,70.6,711162,67.5,33111,4.4
20124,November 2008,New Jersey,6739298,4526135,67.2,4235483,62.8,290652,6.4
20125,November 2008,New Mexico,1505843,948220,63.0,897405,59.6,50815,5.4
20126,November 2008,New York,15306265,9716531,63.5,9102543,59.5,613988,6.3
20127,November 2008,North Carolina,7056552,4616976,65.4,4232297,60.0,384679,8.3
20128,November 2008,North Dakota,500681,370602,74.0,357655,71.4,12947,3.5
20129,November 2008,Ohio,8941524,5955123,66.6,5501689,61.5,453434,7.6
20130,November 2008,Oklahoma,2755121,1761565,63.9,1684498,61.1,77067,4.4
20131,November 2008,Oregon,2986162,1976033,66.2,1805112,60.4,170921,8.6
20132,November 2008,Pennsylvania,9911055,6486514,65.4,6082058,61.4,404456,6.2
20133,November 2008,Rhode Island,839631,569773,67.9,517048,61.6,52725,9.3
20134,November 2008,South Carolina,3461709,2158003,62.3,1973130,57.0,184873,8.6
20135,November 2008,South Dakota,613922,448490,73.1,431631,70.3,16859,3.8
20136,November 2008,Tennessee,4841978,3059544,63.2,2816457,58.2,243087,7.9
20137,November 2008,Texas,17876599,11761609,65.8,11108817,62.1,652792,5.6
20138,November 2008,Utah,1949504,1365637,70.1,1309344,67.2,56293,4.1
20139,November 2008,Vermont,505734,357991,70.8,338832,67.0,19159,5.4
20140,November 2008,Virginia,5955076,4151870,69.7,3954841,66.4,197029,4.7
20141,November 2008,Washington,5122196,3506808,68.5,3285505,64.1,221303,6.3
20142,November 2008,West Virginia,1450727,811887,56.0,773140,53.3,38747,4.8
20143,November 2008,Wisconsin,4401027,3104864,70.5,2920166,66.4,184698,5.9
20144,November 2008,Wyoming,413791,296048,71.5,285541,69.0,10507,3.5
20145,December 2008,Alabama,3606592,2173742,60.3,1997479,55.4,176263,8.1
20146,December 2008,Alaska,506307,357354,70.6,332502,65.7,24852,7.0
20147,December 2008,Arizona,4909739,3133132,63.8,2882194,58.7,250938,8.0
20148,December 2008,Arkansas,2194791,1373717,62.6,1280857,58.4,92860,6.8
20149,December 2008,California,27766504,18295790,65.9,16614164,59.8,1681626,9.2
20150,December 2008,Colorado,3801345,2727035,71.7,2567495,67.5,159540,5.9
20151,December 2008,Connecticut,2736850,1888392,69.0,1762885,64.4,125507,6.6
20152,December 2008,Delaware,682121,445841,65.4,415667,60.9,30174,6.8
20153,December 2008,District of Columbia,481256,332448,69.1,306746,63.7,25702,7.7
20154,December 2008,Florida,14531697,9198113,63.3,8433606,58.0,764507,8.3
20155,December 2008,Georgia,7247260,4773301,65.9,4381976,60.5,391325,8.2
20156,December 2008,Hawaii,978390,634791,64.9,596591,61.0,38200,6.0
20157,December 2008,Idaho,1142231,755248,66.1,702988,61.5,52260,6.9
20158,December 2008,Illinois,9843756,6603955,67.1,6090230,61.9,513725,7.8
20159,December 2008,Indiana,4890861,3236984,66.2,2972558,60.8,264426,8.2
20160,December 2008,Iowa,2326326,1688816,72.6,1598934,68.7,89882,5.3
20161,December 2008,Kansas,2119222,1513104,71.4,1430115,67.5,82989,5.5
20162,December 2008,Kentucky,3319100,2045962,61.6,1874818,56.5,171144,8.4
20163,December 2008,Louisiana,3372245,2096924,62.2,1972534,58.5,124390,5.9
20164,December 2008,Maine,1064068,699094,65.7,650310,61.1,48784,7.0
20165,December 2008,Maryland,4375176,3026042,69.2,2853106,65.2,172936,5.7
20166,December 2008,Massachusetts,5209753,3470510,66.6,3235212,62.1,235298,6.8
20167,December 2008,Michigan,7772501,4870344,62.7,4391564,56.5,478780,9.8
20168,December 2008,Minnesota,4066483,2943948,72.4,2747438,67.6,196510,6.7
20169,December 2008,Mississippi,2193422,1288234,58.7,1189886,54.2,98348,7.6
20170,December 2008,Missouri,4593380,3044195,66.3,2809972,61.2,234223,7.7
20171,December 2008,Montana,763677,507892,66.5,476130,62.3,31762,6.3
20172,December 2008,Nebraska,1357295,993023,73.2,954045,70.3,38978,3.9
20173,December 2008,Nevada,1989039,1364419,68.6,1241905,62.4,122514,9.0
20174,December 2008,New Hampshire,1054467,744749,70.6,708878,67.2,35871,4.8
20175,December 2008,New Jersey,6742566,4531044,67.2,4218207,62.6,312837,6.9
20176,December 2008,New Mexico,1507121,947576,62.9,892860,59.2,54716,5.8
20177,December 2008,New York,15312191,9712772,63.4,9062274,59.2,650498,6.7
20178,December 2008,North Carolina,7064890,4625824,65.5,4203640,59.5,422184,9.1
20179,December 2008,North Dakota,501043,370134,73.9,356512,71.2,13622,3.7
20180,December 2008,Ohio,8942768,5951557,66.6,5467776,61.1,483781,8.1
20181,December 2008,Oklahoma,2757591,1762281,63.9,1679285,60.9,82996,4.7
20182,December 2008,Oregon,2988988,1980678,66.3,1793258,60.0,187420,9.5
20183,December 2008,Pennsylvania,9914426,6483392,65.4,6052892,61.1,430500,6.6
20184,December 2008,Rhode Island,839896,569723,67.8,514644,61.3,55079,9.7
20185,December 2008,South Carolina,3465575,2160891,62.4,1962136,56.6,198755,9.2
20186,December 2008,South Dakota,614351,448751,73.0,430683,70.1,18068,4.0
20187,December 2008,Tennessee,4845237,3061037,63.2,2800344,57.8,260693,8.5
20188,December 2008,Texas,17904835,11767135,65.7,11083429,61.9,683706,5.8
20189,December 2008,Utah,1952476,1377498,70.6,1302419,66.7,75079,5.5
20190,December 2008,Vermont,505873,358836,70.9,338360,66.9,20476,5.7
20191,December 2008,Virginia,5960915,4148515,69.6,3935818,66.0,212697,5.1
20192,December 2008,Washington,5129048,3511407,68.5,3275669,63.9,235738,6.7
20193,December 2008,West Virginia,1451003,812439,56.0,769764,53.1,42675,5.3
20194,December 2008,Wisconsin,4402985,3107939,70.6,2906733,66.0,201206,6.5
20195,December 2008,Wyoming,414409,296679,71.6,285078,68.8,11601,3.9
20196,January 2009,Alabama,3608960,2173685,60.2,1980615,54.9,193070,8.9
20197,January 2009,Alaska,507364,357777,70.5,332382,65.5,25395,7.1
20198,January 2009,Arizona,4916200,3132436,63.7,2869750,58.4,262686,8.4
20199,January 2009,Arkansas,2196134,1371285,62.4,1273890,58.0,97395,7.1
20200,January 2009,California,27794667,18293381,65.8,16525770,59.5,1767611,9.7
20201,January 2009,Colorado,3807212,2727691,71.6,2560849,67.3,166842,6.1
20202,January 2009,Connecticut,2738401,1887932,68.9,1758319,64.2,129613,6.9
20203,January 2009,Delaware,682762,445150,65.2,413180,60.5,31970,7.2
20204,January 2009,District of Columbia,481994,332248,68.9,305521,63.4,26727,8.0
20205,January 2009,Florida,14539769,9177322,63.1,8366455,57.5,810867,8.8
20206,January 2009,Georgia,7255557,4780074,65.9,4365597,60.2,414477,8.7
20207,January 2009,Hawaii,978992,633729,64.7,593141,60.6,40588,6.4
20208,January 2009,Idaho,1143426,753767,65.9,699370,61.2,54397,7.2
20209,January 2009,Illinois,9849030,6608305,67.1,6057455,61.5,550850,8.3
20210,January 2009,Indiana,4893292,3233684,66.1,2947163,60.2,286521,8.9
20211,January 2009,Iowa,2327391,1690828,72.6,1594508,68.5,96320,5.7
20212,January 2009,Kansas,2120640,1515543,71.5,1428007,67.3,87536,5.8
20213,January 2009,Kentucky,3320357,2050657,61.8,1866731,56.2,183926,9.0
20214,January 2009,Louisiana,3374902,2088301,61.9,1961574,58.1,126727,6.1
20215,January 2009,Maine,1064171,698856,65.7,647269,60.8,51587,7.4
20216,January 2009,Maryland,4378599,3028765,69.2,2844852,65.0,183913,6.1
20217,January 2009,Massachusetts,5214072,3469508,66.5,3224796,61.8,244712,7.1
20218,January 2009,Michigan,7772160,4886407,62.9,4351830,56.0,534577,10.9
20219,January 2009,Minnesota,4068989,2946821,72.4,2739235,67.3,207586,7.0
20220,January 2009,Mississippi,2194462,1285294,58.6,1181924,53.9,103370,8.0
20221,January 2009,Missouri,4595874,3047000,66.3,2799327,60.9,247673,8.1
20222,January 2009,Montana,764203,506319,66.3,473400,61.9,32919,6.5
20223,January 2009,Nebraska,1358167,993134,73.1,952258,70.1,40876,4.1
20224,January 2009,Nevada,1990788,1361212,68.4,1232133,61.9,129079,9.5
20225,January 2009,New Hampshire,1054866,745444,70.7,706419,67.0,39025,5.2
20226,January 2009,New Jersey,6746210,4536585,67.2,4200201,62.3,336384,7.4
20227,January 2009,New Mexico,1508503,946635,62.8,887617,58.8,59018,6.2
20228,January 2009,New York,15319033,9703544,63.3,9014776,58.8,688768,7.1
20229,January 2009,North Carolina,7073513,4616885,65.3,4172359,59.0,444526,9.6
20230,January 2009,North Dakota,501410,369699,73.7,355313,70.9,14386,3.9
20231,January 2009,Ohio,8944394,5949445,66.5,5430732,60.7,518713,8.7
20232,January 2009,Oklahoma,2760215,1762788,63.9,1672825,60.6,89963,5.1
20233,January 2009,Oregon,2991928,1984958,66.3,1781050,59.5,203908,10.3
20234,January 2009,Pennsylvania,9918169,6475095,65.3,6018683,60.7,456412,7.0
20235,January 2009,Rhode Island,840146,569602,67.8,512166,61.0,57436,10.1
20236,January 2009,South Carolina,3469613,2162951,62.3,1950041,56.2,212910,9.8
20237,January 2009,South Dakota,614788,448873,73.0,429485,69.9,19388,4.3
20238,January 2009,Tennessee,4848693,3062991,63.2,2782920,57.4,280071,9.1
20239,January 2009,Texas,17934287,11769634,65.6,11055467,61.6,714167,6.1
20240,January 2009,Utah,1955576,1380586,70.6,1294880,66.2,85706,6.2
20241,January 2009,Vermont,506066,359635,71.1,337747,66.7,21888,6.1
20242,January 2009,Virginia,5967043,4143762,69.4,3913981,65.6,229781,5.5
20243,January 2009,Washington,5136093,3514341,68.4,3263380,63.5,250961,7.1
20244,January 2009,West Virginia,1451299,813085,56.0,765737,52.8,47348,5.8
20245,January 2009,Wisconsin,4405116,3110398,70.6,2891327,65.6,219071,7.0
20246,January 2009,Wyoming,415020,297510,71.7,284410,68.5,13100,4.4
20247,February 2009,Alabama,3611025,2173720,60.2,1964927,54.4,208793,9.6
20248,February 2009,Alaska,508336,358286,70.5,332240,65.4,26046,7.3
20249,February 2009,Arizona,4922302,3131559,63.6,2857465,58.1,274094,8.8
20250,February 2009,Arkansas,2197249,1368869,62.3,1267462,57.7,101407,7.4
20251,February 2009,California,27820364,18286012,65.7,16436941,59.1,1849071,10.1
20252,February 2009,Colorado,3812882,2728695,71.6,2553972,67.0,174723,6.4
20253,February 2009,Connecticut,2739720,1887508,68.9,1753494,64.0,134014,7.1
20254,February 2009,Delaware,683309,444328,65.0,410691,60.1,33637,7.6
20255,February 2009,District of Columbia,482677,332118,68.8,304425,63.1,27693,8.3
20256,February 2009,Florida,14546500,9156984,62.9,8301270,57.1,855714,9.3
20257,February 2009,Georgia,7263209,4785841,65.9,4350081,59.9,435760,9.1
20258,February 2009,Hawaii,979422,632864,64.6,590177,60.3,42687,6.7
20259,February 2009,Idaho,1144528,752108,65.7,696142,60.8,55966,7.4
20260,February 2009,Illinois,9853542,6616877,67.2,6027328,61.2,589549,8.9
20261,February 2009,Indiana,4895465,3230361,66.0,2923493,59.7,306868,9.5
20262,February 2009,Iowa,2328279,1692539,72.7,1590225,68.3,102314,6.0
20263,February 2009,Kansas,2121939,1517994,71.5,1425428,67.2,92566,6.1
20264,February 2009,Kentucky,3321451,2055859,61.9,1859463,56.0,196396,9.6
20265,February 2009,Louisiana,3377231,2079054,61.6,1949758,57.7,129296,6.2
20266,February 2009,Maine,1064193,698671,65.7,644638,60.6,54033,7.7
20267,February 2009,Maryland,4381626,3030766,69.2,2836954,64.7,193812,6.4
20268,February 2009,Massachusetts,5218090,3468584,66.5,3215090,61.6,253494,7.3
20269,February 2009,Michigan,7771192,4901958,63.1,4314905,55.5,587053,12.0
20270,February 2009,Minnesota,4071329,2949309,72.4,2731319,67.1,217990,7.4
20271,February 2009,Mississippi,2195299,1282729,58.4,1174007,53.5,108722,8.5
20272,February 2009,Missouri,4598092,3049995,66.3,2789506,60.7,260489,8.5
20273,February 2009,Montana,764676,504705,66.0,470898,61.6,33807,6.7
20274,February 2009,Nebraska,1358954,993007,73.1,950308,69.9,42699,4.3
20275,February 2009,Nevada,1992370,1357727,68.1,1222705,61.4,135022,9.9
20276,February 2009,New Hampshire,1055240,746208,70.7,703986,66.7,42222,5.7
20277,February 2009,New Jersey,6749302,4543195,67.3,4183717,62.0,359478,7.9
20278,February 2009,New Mexico,1509768,945690,62.6,882290,58.4,63400,6.7
20279,February 2009,New York,15324584,9692579,63.2,8966570,58.5,726009,7.5
20280,February 2009,North Carolina,7081590,4603954,65.0,4142505,58.5,461449,10.0
20281,February 2009,North Dakota,501770,369267,73.6,354188,70.6,15079,4.1
20282,February 2009,Ohio,8945406,5947861,66.5,5393729,60.3,554132,9.3
20283,February 2009,Oklahoma,2762668,1763600,63.8,1666488,60.3,97112,5.5
20284,February 2009,Oregon,2994706,1988297,66.4,1769890,59.1,218407,11.0
20285,February 2009,Pennsylvania,9921186,6463243,65.1,5983571,60.3,479672,7.4
20286,February 2009,Rhode Island,840386,569393,67.8,509796,60.7,59597,10.5
20287,February 2009,South Carolina,3473309,2164204,62.3,1938030,55.8,226174,10.5
20288,February 2009,South Dakota,615184,448857,73.0,428191,69.6,20666,4.6
20289,February 2009,Tennessee,4851827,3065139,63.2,2766149,57.0,298990,9.8
20290,February 2009,Texas,17962241,11771891,65.5,11030382,61.4,741509,6.3
20291,February 2009,Utah,1958558,1379404,70.4,1287362,65.7,92042,6.7
20292,February 2009,Vermont,506207,360330,71.2,337112,66.6,23218,6.4
20293,February 2009,Virginia,5972693,4138697,69.3,3892397,65.2,246300,6.0
20294,February 2009,Washington,5142825,3515362,68.4,3250405,63.2,264957,7.5
20295,February 2009,West Virginia,1451524,813967,56.1,761555,52.5,52412,6.4
20296,February 2009,Wisconsin,4407013,3112254,70.6,2875741,65.3,236513,7.6
20297,February 2009,Wyoming,415658,298486,71.8,283611,68.2,14875,5.0
20298,March 2009,Alabama,3613034,2173702,60.2,1951720,54.0,221982,10.2
20299,March 2009,Alaska,509304,358814,70.5,332099,65.2,26715,7.4
20300,March 2009,Arizona,4928269,3131780,63.5,2847144,57.8,284636,9.1
20301,March 2009,Arkansas,2198385,1366740,62.2,1262198,57.4,104542,7.6
20302,March 2009,California,27845224,18276718,65.6,16357536,58.7,1919182,10.5
20303,March 2009,Colorado,3818492,2730335,71.5,2547655,66.7,182680,6.7
20304,March 2009,Connecticut,2741025,1887631,68.9,1749195,63.8,138436,7.3
20305,March 2009,Delaware,683851,443326,64.8,408301,59.7,35025,7.9
20306,March 2009,District of Columbia,483386,332212,68.7,303618,62.8,28594,8.6
20307,March 2009,Florida,14553015,9140524,62.8,8246345,56.7,894179,9.8
20308,March 2009,Georgia,7270704,4790542,65.9,4337302,59.7,453240,9.5
20309,March 2009,Hawaii,979839,632205,64.5,587893,60.0,44312,7.0
20310,March 2009,Idaho,1145653,750126,65.5,693440,60.5,56686,7.6
20311,March 2009,Illinois,9857938,6628347,67.2,6003114,60.9,625233,9.4
20312,March 2009,Indiana,4897589,3226201,65.9,2903578,59.3,322623,10.0
20313,March 2009,Iowa,2329173,1693675,72.7,1586537,68.1,107138,6.3
20314,March 2009,Kansas,2123219,1520462,71.6,1422751,67.0,97711,6.4
20315,March 2009,Kentucky,3322520,2061013,62.0,1853912,55.8,207101,10.0
20316,March 2009,Louisiana,3379507,2071502,61.3,1939019,57.4,132483,6.4
20317,March 2009,Maine,1064236,698393,65.6,642531,60.4,55862,8.0
20318,March 2009,Maryland,4384547,3032199,69.2,2830424,64.6,201775,6.7
20319,March 2009,Massachusetts,5222100,3468927,66.4,3207470,61.4,261457,7.5
20320,March 2009,Michigan,7770196,4917605,63.3,4284635,55.1,632970,12.9
20321,March 2009,Minnesota,4073662,2951059,72.4,2724675,66.9,226384,7.7
20322,March 2009,Mississippi,2196101,1280210,58.3,1166850,53.1,113360,8.9
20323,March 2009,Missouri,4600232,3053342,66.4,2782239,60.5,271103,8.9
20324,March 2009,Montana,765161,503244,65.8,468904,61.3,34340,6.8
20325,March 2009,Nebraska,1359717,992757,73.0,948491,69.8,44266,4.5
20326,March 2009,Nevada,1993918,1354398,67.9,1214152,60.9,140246,10.4
20327,March 2009,New Hampshire,1055611,746705,70.7,701694,66.5,45011,6.0
20328,March 2009,New Jersey,6752326,4550569,67.4,4170687,61.8,379882,8.3
20329,March 2009,New Mexico,1510969,944960,62.5,877548,58.1,67412,7.1
20330,March 2009,New York,15329880,9684568,63.2,8926228,58.2,758340,7.8
20331,March 2009,North Carolina,7089569,4592393,64.8,4118553,58.1,473840,10.3
20332,March 2009,North Dakota,502125,368802,73.4,353254,70.4,15548,4.2
20333,March 2009,Ohio,8946406,5944948,66.5,5360656,59.9,584292,9.8
20334,March 2009,Oklahoma,2765042,1765118,63.8,1661573,60.1,103545,5.9
20335,March 2009,Oregon,2997399,1990031,66.4,1761005,58.8,229026,11.5
20336,March 2009,Pennsylvania,9924198,6450076,65.0,5952110,60.0,497966,7.7
20337,March 2009,Rhode Island,840612,569062,67.7,507705,60.4,61357,10.8
20338,March 2009,South Carolina,3476992,2164461,62.3,1927640,55.4,236821,10.9
20339,March 2009,South Dakota,615607,448669,72.9,426943,69.4,21726,4.8
20340,March 2009,Tennessee,4854945,3067181,63.2,2752312,56.7,314869,10.3
20341,March 2009,Texas,17989636,11776375,65.5,11014244,61.2,762131,6.5
20342,March 2009,Utah,1961510,1376406,70.2,1280436,65.3,95970,7.0
20343,March 2009,Vermont,506354,360853,71.3,336575,66.5,24278,6.7
20344,March 2009,Virginia,5978215,4134643,69.2,3874611,64.8,260032,6.3
20345,March 2009,Washington,5149512,3514527,68.2,3238785,62.9,275742,7.8
20346,March 2009,West Virginia,1451749,815171,56.2,757826,52.2,57345,7.0
20347,March 2009,Wisconsin,4408918,3113712,70.6,2862079,64.9,251633,8.1
20348,March 2009,Wyoming,416274,299452,71.9,282766,67.9,16686,5.6
20349,April 2009,Alabama,3615107,2173271,60.1,1941359,53.7,231912,10.7
20350,April 2009,Alaska,510314,359285,70.4,331973,65.1,27312,7.6
20351,April 2009,Arizona,4934381,3133389,63.5,2839332,57.5,294057,9.4
20352,April 2009,Arkansas,2199548,1364748,62.0,1258228,57.2,106520,7.8
20353,April 2009,California,27871138,18265805,65.5,16291967,58.5,1973838,10.8
20354,April 2009,Colorado,3824191,2732255,71.4,2542201,66.5,190054,7.0
20355,April 2009,Connecticut,2742384,1888492,68.9,1745913,63.7,142579,7.5
20356,April 2009,Delaware,684422,442082,64.6,406055,59.3,36027,8.1
20357,April 2009,District of Columbia,484082,332570,68.7,303116,62.6,29454,8.9
20358,April 2009,Florida,14559741,9128564,62.7,8205183,56.4,923381,10.1
20359,April 2009,Georgia,7278430,4794116,65.9,4328106,59.5,466010,9.7
20360,April 2009,Hawaii,980298,631768,64.4,586360,59.8,45408,7.2
20361,April 2009,Idaho,1146825,747798,65.2,691298,60.3,56500,7.6
20362,April 2009,Illinois,9862551,6639249,67.3,5985380,60.7,653869,9.8
20363,April 2009,Indiana,4899811,3220409,65.7,2888020,58.9,332389,10.3
20364,April 2009,Iowa,2330117,1693890,72.7,1583665,68.0,110225,6.5
20365,April 2009,Kansas,2124509,1522676,71.7,1420258,66.9,102418,6.7
20366,April 2009,Kentucky,3323639,2065253,62.1,1850488,55.7,214765,10.4
20367,April 2009,Louisiana,3381899,2066691,61.1,1930773,57.1,135918,6.6
20368,April 2009,Maine,1064283,697986,65.6,641007,60.2,56979,8.2
20369,April 2009,Maryland,4387555,3033061,69.1,2825729,64.4,207332,6.8
20370,April 2009,Massachusetts,5226156,3470884,66.4,3202196,61.3,268688,7.7
20371,April 2009,Michigan,7769346,4932643,63.5,4262350,54.9,670293,13.6
20372,April 2009,Minnesota,4076031,2951603,72.4,2719566,66.7,232037,7.9
20373,April 2009,Mississippi,2196932,1277360,58.1,1160721,52.8,116639,9.1
20374,April 2009,Missouri,4602491,3056796,66.4,2778045,60.4,278751,9.1
20375,April 2009,Montana,765637,502025,65.6,467514,61.1,34511,6.9
20376,April 2009,Nebraska,1360520,992535,73.0,947009,69.6,45526,4.6
20377,April 2009,Nevada,1995501,1351554,67.7,1206744,60.5,144810,10.7
20378,April 2009,New Hampshire,1055963,746709,70.7,699647,66.3,47062,6.3
20379,April 2009,New Jersey,6755477,4557454,67.5,4161261,61.6,396193,8.7
20380,April 2009,New Mexico,1512230,944421,62.5,873814,57.8,70607,7.5
20381,April 2009,New York,15335577,9680939,63.1,8897835,58.0,783104,8.1
20382,April 2009,North Carolina,7097695,4583588,64.6,4102521,57.8,481067,10.5
20383,April 2009,North Dakota,502469,368329,73.3,352605,70.2,15724,4.3
20384,April 2009,Ohio,8947541,5939158,66.4,5333787,59.6,605371,10.2
20385,April 2009,Oklahoma,2767495,1767274,63.9,1658536,59.9,108738,6.2
20386,April 2009,Oregon,3000182,1989740,66.3,1754948,58.5,234792,11.8
20387,April 2009,Pennsylvania,9927312,6436820,64.8,5926361,59.7,510459,7.9
20388,April 2009,Rhode Island,840836,568583,67.6,505977,60.2,62606,11.0
20389,April 2009,South Carolina,3480696,2163283,62.2,1919603,55.1,243680,11.3
20390,April 2009,South Dakota,616006,448261,72.8,425835,69.1,22426,5.0
20391,April 2009,Tennessee,4858086,3068207,63.2,2742407,56.5,325800,10.6
20392,April 2009,Texas,18017597,11782809,65.4,11008811,61.1,773998,6.6
20393,April 2009,Utah,1964512,1372900,69.9,1274429,64.9,98471,7.2
20394,April 2009,Vermont,506480,361117,71.3,336208,66.4,24909,6.9
20395,April 2009,Virginia,5983942,4131894,69.0,3862173,64.5,269721,6.5
20396,April 2009,Washington,5156239,3525973,68.4,3229781,62.6,296192,8.4
20397,April 2009,West Virginia,1451981,816452,56.2,754927,52.0,61525,7.5
20398,April 2009,Wisconsin,4410843,3114433,70.6,2851393,64.6,263040,8.4
20399,April 2009,Wyoming,416861,300242,72.0,281983,67.6,18259,6.1
20400,May 2009,Alabama,3617361,2171932,60.0,1932868,53.4,239064,11.0
20401,May 2009,Alaska,511330,359655,70.3,331855,64.9,27800,7.7
20402,May 2009,Arizona,4940746,3135363,63.5,2832563,57.3,302800,9.7
20403,May 2009,Arkansas,2200846,1362623,61.9,1255134,57.0,107489,7.9
20404,May 2009,California,27897359,18251000,65.4,16235880,58.2,2015120,11.0
20405,May 2009,Colorado,3830099,2733120,71.4,2536831,66.2,196289,7.2
20406,May 2009,Connecticut,2743885,1889805,68.9,1743458,63.5,146347,7.7
20407,May 2009,Delaware,684993,440544,64.3,403915,59.0,36629,8.3
20408,May 2009,District of Columbia,484774,333228,68.7,302915,62.5,30313,9.1
20409,May 2009,Florida,14567324,9117789,62.6,8173684,56.1,944105,10.4
20410,May 2009,Georgia,7286426,4795798,65.8,4320949,59.3,474849,9.9
20411,May 2009,Hawaii,980763,631561,64.4,585526,59.7,46035,7.3
20412,May 2009,Idaho,1148040,759949,66.2,689681,60.1,70268,9.2
20413,May 2009,Illinois,9867563,6645470,67.3,5970489,60.5,674981,10.2
20414,May 2009,Indiana,4902376,3212459,65.5,2875512,58.7,336947,10.5
20415,May 2009,Iowa,2331259,1693027,72.6,1581393,67.8,111634,6.6
20416,May 2009,Kansas,2125995,1524186,71.7,1417890,66.7,106296,7.0
20417,May 2009,Kentucky,3325013,2067837,62.2,1848635,55.6,219202,10.6
20418,May 2009,Louisiana,3384370,2064108,61.0,1925008,56.9,139100,6.7
20419,May 2009,Maine,1064444,697409,65.5,639949,60.1,57460,8.2
20420,May 2009,Maryland,4390739,3033247,69.1,2822386,64.3,210861,7.0
20421,May 2009,Massachusetts,5230561,3473546,66.4,3197925,61.1,275621,7.9
20422,May 2009,Michigan,7768973,4945784,63.7,4245768,54.7,700016,14.2
20423,May 2009,Minnesota,4078760,2950545,72.3,2715505,66.6,235040,8.0
20424,May 2009,Mississippi,2197842,1273794,58.0,1155221,52.6,118573,9.3
20425,May 2009,Missouri,4605119,3059216,66.4,2775427,60.3,283789,9.3
20426,May 2009,Montana,766208,501035,65.4,466642,60.9,34393,6.9
20427,May 2009,Nebraska,1361436,992365,72.9,945900,69.5,46465,4.7
20428,May 2009,Nevada,1997181,1349324,67.6,1200382,60.1,148942,11.0
20429,May 2009,New Hampshire,1056410,746210,70.6,697941,66.1,48269,6.5
20430,May 2009,New Jersey,6758890,4561990,67.5,4153141,61.4,408849,9.0
20431,May 2009,New Mexico,1513523,943745,62.4,871029,57.5,72716,7.7
20432,May 2009,New York,15341722,9678652,63.1,8877362,57.9,801290,8.3
20433,May 2009,North Carolina,7106207,4576425,64.4,4092376,57.6,484049,10.6
20434,May 2009,North Dakota,502873,367902,73.2,352266,70.1,15636,4.3
20435,May 2009,Ohio,8949202,5929417,66.3,5312053,59.4,617364,10.4
20436,May 2009,Oklahoma,2770103,1769280,63.9,1656641,59.8,112639,6.4
20437,May 2009,Oregon,3003209,1987185,66.2,1751282,58.3,235903,11.9
20438,May 2009,Pennsylvania,9931122,6423372,64.7,5905056,59.5,518316,8.1
20439,May 2009,Rhode Island,841152,567970,67.5,504628,60.0,63342,11.2
20440,May 2009,South Carolina,3484598,2160610,62.0,1913554,54.9,247056,11.4
20441,May 2009,South Dakota,616518,447622,72.6,424897,68.9,22725,5.1
20442,May 2009,Tennessee,4861579,3066690,63.1,2735262,56.3,331428,10.8
20443,May 2009,Texas,18046180,11909643,66.0,11009038,61.0,900605,7.6
20444,May 2009,Utah,1967728,1369447,69.6,1269323,64.5,100124,7.3
20445,May 2009,Vermont,506662,361051,71.3,335992,66.3,25059,6.9
20446,May 2009,Virginia,5989932,4128969,68.9,3853300,64.3,275669,6.7
20447,May 2009,Washington,5163366,3535906,68.5,3223070,62.4,312836,8.8
20448,May 2009,West Virginia,1452368,817303,56.3,752761,51.8,64542,7.9
20449,May 2009,Wisconsin,4413190,3113388,70.5,2842895,64.4,270493,8.7
20450,May 2009,Wyoming,417505,300710,72.0,281311,67.4,19399,6.5
20451,June 2009,Alabama,3619629,2169509,59.9,1925237,53.2,244272,11.3
20452,June 2009,Alaska,512325,359940,70.3,331749,64.8,28191,7.8
20453,June 2009,Arizona,4947208,3136698,63.4,2825341,57.1,311357,9.9
20454,June 2009,Arkansas,2202154,1360365,61.8,1252557,56.9,107808,7.9
20455,June 2009,California,27924313,18232811,65.3,16184887,58.0,2047924,11.2
20456,June 2009,Colorado,3836067,2732012,71.2,2530915,66.0,201097,7.4
20457,June 2009,Connecticut,2745421,1891243,68.9,1741507,63.4,149736,7.9
20458,June 2009,Delaware,685612,438726,64.0,401821,58.6,36905,8.4
20459,June 2009,District of Columbia,485488,334228,68.8,303039,62.4,31189,9.3
20460,June 2009,Florida,14575145,9105647,62.5,8147015,55.9,958632,10.5
20461,June 2009,Georgia,7294421,4795700,65.7,4314308,59.1,481392,10.0
20462,June 2009,Hawaii,981229,631468,64.4,585167,59.6,46301,7.3
20463,June 2009,Idaho,1149304,761904,66.3,688624,59.9,73280,9.6
20464,June 2009,Illinois,9872670,6644812,67.3,5955214,60.3,689598,10.4
20465,June 2009,Indiana,4904977,3202508,65.3,2864618,58.4,337890,10.6
20466,June 2009,Iowa,2332447,1691314,72.5,1579477,67.7,111837,6.6
20467,June 2009,Kansas,2127510,1524522,71.7,1415562,66.5,108960,7.1
20468,June 2009,Kentucky,3326417,2068623,62.2,1847534,55.5,221089,10.7
20469,June 2009,Louisiana,3386911,2062784,60.9,1920986,56.7,141798,6.9
20470,June 2009,Maine,1064612,696683,65.4,639200,60.0,57483,8.3
20471,June 2009,Maryland,4393922,3032958,69.0,2819760,64.2,213198,7.0
20472,June 2009,Massachusetts,5235023,3475807,66.4,3193419,61.0,282388,8.1
20473,June 2009,Michigan,7768604,4957123,63.8,4232085,54.5,725038,14.6
20474,June 2009,Minnesota,4081532,2947998,72.2,2712019,66.4,235979,8.0
20475,June 2009,Mississippi,2198782,1269706,57.7,1149973,52.3,119733,9.4
20476,June 2009,Missouri,4607694,3059867,66.4,2772659,60.2,287208,9.4
20477,June 2009,Montana,766762,500238,65.2,466120,60.8,34118,6.8
20478,June 2009,Nebraska,1362376,992148,72.8,945116,69.4,47032,4.7
20479,June 2009,Nevada,1998890,1347650,67.4,1194899,59.8,152751,11.3
20480,June 2009,New Hampshire,1056869,745324,70.5,696609,65.9,48715,6.5
20481,June 2009,New Jersey,6762432,4563335,67.5,4144441,61.3,418894,9.2
20482,June 2009,New Mexico,1514918,942686,62.2,868906,57.4,73780,7.8
20483,June 2009,New York,15348090,9674374,63.0,8859328,57.7,815046,8.4
20484,June 2009,North Carolina,7114742,4569914,64.2,4085283,57.4,484631,10.6
20485,June 2009,North Dakota,503284,367599,73.0,352206,70.0,15393,4.2
20486,June 2009,Ohio,8950933,5916642,66.1,5293949,59.1,622693,10.5
20487,June 2009,Oklahoma,2772778,1770372,63.8,1654967,59.7,115405,6.5
20488,June 2009,Oregon,3006279,1982474,65.9,1749219,58.2,233255,11.8
20489,June 2009,Pennsylvania,9935005,6409633,64.5,5886628,59.3,523005,8.2
20490,June 2009,Rhode Island,841446,567308,67.4,503663,59.9,63645,11.2
20491,June 2009,South Carolina,3488495,2156919,61.8,1908847,54.7,248072,11.5
20492,June 2009,South Dakota,617021,446795,72.4,424108,68.7,22687,5.1
20493,June 2009,Tennessee,4865073,3062328,62.9,2729676,56.1,332652,10.9
20494,June 2009,Texas,18075211,11970340,66.2,11010114,60.9,960226,8.0
20495,June 2009,Utah,1970908,1366277,69.3,1265021,64.2,101256,7.4
20496,June 2009,Vermont,506890,360679,71.2,335868,66.3,24811,6.9
20497,June 2009,Virginia,5995931,4124789,68.8,3845784,64.1,279005,6.8
20498,June 2009,Washington,5170538,3543902,68.5,3217388,62.2,326514,9.2
20499,June 2009,West Virginia,1452740,817399,56.3,751081,51.7,66318,8.1
20500,June 2009,Wisconsin,4415500,3109970,70.4,2835542,64.2,274428,8.8
20501,June 2009,Wyoming,418196,300799,71.9,280759,67.1,20040,6.7
20502,July 2009,Alabama,3622181,2165955,59.8,1917686,52.9,248269,11.5
20503,July 2009,Alaska,513402,360145,70.1,331650,64.6,28495,7.9
20504,July 2009,Arizona,4953939,3136081,63.3,2816534,56.9,319547,10.2
20505,July 2009,Arkansas,2203656,1358090,61.6,1250215,56.7,107875,7.9
20506,July 2009,California,27952375,18210977,65.2,16135173,57.7,2075804,11.4
20507,July 2009,Colorado,3842322,2728583,71.0,2523955,65.7,204628,7.5
20508,July 2009,Connecticut,2747122,1892510,68.9,1739692,63.3,152818,8.1
20509,July 2009,Delaware,686254,436739,63.6,399735,58.2,37004,8.5
20510,July 2009,District of Columbia,486237,335501,69.0,303457,62.4,32044,9.6
20511,July 2009,Florida,14583822,9090250,62.3,8120618,55.7,969632,10.7
20512,July 2009,Georgia,7302994,4793870,65.6,4306977,59.0,486893,10.2
20513,July 2009,Hawaii,981756,631328,64.3,584990,59.6,46338,7.3
20514,July 2009,Idaho,1150638,761185,66.2,688090,59.8,73095,9.6
20515,July 2009,Illinois,9878410,6636459,67.2,5937036,60.1,699423,10.5
20516,July 2009,Indiana,4907917,3190972,65.0,2854170,58.2,336802,10.6
20517,July 2009,Iowa,2333773,1688970,72.4,1577628,67.6,111342,6.6
20518,July 2009,Kansas,2129150,1523430,71.6,1413146,66.4,110284,7.2
20519,July 2009,Kentucky,3328074,2067526,62.1,1846402,55.5,221124,10.7
20520,July 2009,Louisiana,3389686,2061695,60.8,1917783,56.6,143912,7.0
20521,July 2009,Maine,1064870,695896,65.4,638623,60.0,57273,8.2
20522,July 2009,Maryland,4397413,3032522,69.0,2817284,64.1,215238,7.1
20523,July 2009,Massachusetts,5239849,3476387,66.3,3187670,60.8,288717,8.3
20524,July 2009,Michigan,7768829,4934566,63.5,4218622,54.3,715944,14.5
20525,July 2009,Minnesota,4084586,2944238,72.1,2708803,66.3,235435,8.0
20526,July 2009,Mississippi,2199851,1265589,57.5,1144765,52.0,120824,9.5
20527,July 2009,Missouri,4610651,3058087,66.3,2768238,60.0,289849,9.5
20528,July 2009,Montana,767393,499615,65.1,465730,60.7,33885,6.8
20529,July 2009,Nebraska,1363415,991818,72.7,944539,69.3,47279,4.8
20530,July 2009,Nevada,2000720,1346342,67.3,1190195,59.5,156147,11.6
20531,July 2009,New Hampshire,1057409,744270,70.4,695670,65.8,48600,6.5
20532,July 2009,New Jersey,6766378,4561427,67.4,4134146,61.1,427281,9.4
20533,July 2009,New Mexico,1516325,941147,62.1,867074,57.2,74073,7.9
20534,July 2009,New York,15355351,9664397,62.9,8838266,57.6,826131,8.5
20535,July 2009,North Carolina,7123840,4563028,64.1,4078206,57.2,484822,10.6
20536,July 2009,North Dakota,503744,367505,73.0,352358,69.9,15147,4.1
20537,July 2009,Ohio,8953337,5902491,65.9,5277655,58.9,624836,10.6
20538,July 2009,Oklahoma,2775621,1769834,63.8,1652597,59.5,117237,6.6
20539,July 2009,Oregon,3009552,1976412,65.7,1747976,58.1,228436,11.6
20540,July 2009,Pennsylvania,9939596,6394832,64.3,5869174,59.0,525658,8.2
20541,July 2009,Rhode Island,841807,566671,67.3,503026,59.8,63645,11.2
20542,July 2009,South Carolina,3492666,2152502,61.6,1904646,54.5,247856,11.5
20543,July 2009,South Dakota,617544,445876,72.2,423404,68.6,22472,5.0
20544,July 2009,Tennessee,4868936,3055354,62.8,2724437,56.0,330917,10.8
20545,July 2009,Texas,18105139,11994007,66.2,11008166,60.8,985841,8.2
20546,July 2009,Utah,1974253,1363368,69.1,1261275,63.9,102093,7.5
20547,July 2009,Vermont,507115,360119,71.0,335788,66.2,24331,6.8
20548,July 2009,Virginia,6002403,4118816,68.6,3837551,63.9,281265,6.8
20549,July 2009,Washington,5178070,3549799,68.6,3211035,62.0,338764,9.5
20550,July 2009,West Virginia,1453225,816594,56.2,749561,51.6,67033,8.2
20551,July 2009,Wisconsin,4418188,3104287,70.3,2828332,64.0,275955,8.9
20552,July 2009,Wyoming,418865,300635,71.8,280326,66.9,20309,6.8
20553,August 2009,Alabama,3624837,2161334,59.6,1909996,52.7,251338,11.6
20554,August 2009,Alaska,513656,360268,70.1,331567,64.6,28701,8.0
20555,August 2009,Arizona,4961060,3132849,63.1,2805980,56.6,326869,10.4
20556,August 2009,Arkansas,2205479,1355755,61.5,1247819,56.6,107936,8.0
20557,August 2009,California,27986270,18185991,65.0,16085598,57.5,2100393,11.5
20558,August 2009,Colorado,3847562,2723178,70.8,2515806,65.4,207372,7.6
20559,August 2009,Connecticut,2749085,1893368,68.9,1737584,63.2,155784,8.2
20560,August 2009,Delaware,686972,434741,63.3,397688,57.9,37053,8.5
20561,August 2009,District of Columbia,487163,336899,69.2,304082,62.4,32817,9.7
20562,August 2009,Florida,14599431,9071632,62.1,8092253,55.4,979379,10.8
20563,August 2009,Georgia,7312496,4790286,65.5,4298565,58.8,491721,10.3
20564,August 2009,Hawaii,982384,631138,64.2,584861,59.5,46277,7.3
20565,August 2009,Idaho,1151866,760106,66.0,687918,59.7,72188,9.5
20566,August 2009,Illinois,9884709,6622400,67.0,5915107,59.8,707293,10.7
20567,August 2009,Indiana,4911180,3178722,64.7,2843631,57.9,335091,10.5
20568,August 2009,Iowa,2335284,1686168,72.2,1575679,67.5,110489,6.6
20569,August 2009,Kansas,2130871,1521012,71.4,1410533,66.2,110479,7.3
20570,August 2009,Kentucky,3330802,2064524,62.0,1844716,55.4,219808,10.6
20571,August 2009,Louisiana,3392730,2060251,60.7,1914642,56.4,145609,7.1
20572,August 2009,Maine,1065143,695121,65.3,638115,59.9,57006,8.2
20573,August 2009,Maryland,4401975,3032228,68.9,2814713,63.9,217515,7.2
20574,August 2009,Massachusetts,5244207,3474827,66.3,3180685,60.7,294142,8.5
20575,August 2009,Michigan,7770891,4911235,63.2,4204918,54.1,706317,14.4
20576,August 2009,Minnesota,4087541,2939740,71.9,2705818,66.2,233922,8.0
20577,August 2009,Mississippi,2201059,1262002,57.3,1139573,51.8,122429,9.7
20578,August 2009,Missouri,4613947,3053579,66.2,2761739,59.9,291840,9.6
20579,August 2009,Montana,767959,499182,65.0,465335,60.6,33847,6.8
20580,August 2009,Nebraska,1364635,991328,72.6,944012,69.2,47316,4.8
20581,August 2009,Nevada,2002267,1345279,67.2,1186190,59.2,159089,11.8
20582,August 2009,New Hampshire,1057965,743222,70.3,695035,65.7,48187,6.5
20583,August 2009,New Jersey,6771321,4556810,67.3,4122578,60.9,434232,9.5
20584,August 2009,New Mexico,1518181,939133,61.9,865244,57.0,73889,7.9
20585,August 2009,New York,15363871,9646808,62.8,8811462,57.4,835346,8.7
20586,August 2009,North Carolina,7131143,4555878,63.9,4069639,57.1,486239,10.7
20587,August 2009,North Dakota,504297,367650,72.9,352669,69.9,14981,4.1
20588,August 2009,Ohio,8956374,5888291,65.7,5261792,58.7,626499,10.6
20589,August 2009,Oklahoma,2778180,1767531,63.6,1649078,59.4,118453,6.7
20590,August 2009,Oregon,3012625,1970264,65.4,1747036,58.0,223228,11.3
20591,August 2009,Pennsylvania,9945029,6378688,64.1,5851466,58.8,527222,8.3
20592,August 2009,Rhode Island,842187,566146,67.2,502663,59.7,63483,11.2
20593,August 2009,South Carolina,3496419,2147732,61.4,1900471,54.4,247261,11.5
20594,August 2009,South Dakota,618279,444943,72.0,422672,68.4,22271,5.0
20595,August 2009,Tennessee,4873515,3046966,62.5,2719070,55.8,327896,10.8
20596,August 2009,Texas,18134768,11997127,66.2,11002281,60.7,994846,8.3
20597,August 2009,Utah,1977352,1360769,68.8,1257882,63.6,102887,7.6
20598,August 2009,Vermont,507430,359511,70.8,335727,66.2,23784,6.6
20599,August 2009,Virginia,6009725,4111312,68.4,3827632,63.7,283680,6.9
20600,August 2009,Washington,5185004,3554038,68.5,3202899,61.8,351139,9.9
20601,August 2009,West Virginia,1453789,815002,56.1,747949,51.4,67053,8.2
20602,August 2009,Wisconsin,4420667,3097155,70.1,2820507,63.8,276648,8.9
20603,August 2009,Wyoming,419192,300431,71.7,279999,66.8,20432,6.8
20604,September 2009,Alabama,3627477,2156021,59.4,1902838,52.5,253183,11.7
20605,September 2009,Alaska,513872,360326,70.1,331517,64.5,28809,8.0
20606,September 2009,Arizona,4968072,3128000,63.0,2795046,56.3,332954,10.6
20607,September 2009,Arkansas,2207281,1353243,61.3,1245115,56.4,108128,8.0
20608,September 2009,California,28019194,18162947,64.8,16040179,57.2,2122768,11.7
20609,September 2009,Colorado,3852743,2717092,70.5,2507242,65.1,209850,7.7
20610,September 2009,Connecticut,2751032,1893831,68.8,1734997,63.1,158834,8.4
20611,September 2009,Delaware,687690,432906,63.0,395778,57.6,37128,8.6
20612,September 2009,District of Columbia,488028,338167,69.3,304739,62.4,33428,9.9
20613,September 2009,Florida,14615000,9053826,61.9,8064822,55.2,989004,10.9
20614,September 2009,Georgia,7321947,4786060,65.4,4290182,58.6,495878,10.4
20615,September 2009,Hawaii,982979,630972,64.2,584806,59.5,46166,7.3
20616,September 2009,Idaho,1153087,759277,65.8,687984,59.7,71293,9.4
20617,September 2009,Illinois,9890904,6607886,66.8,5892295,59.6,715591,10.8
20618,September 2009,Indiana,4914475,3167706,64.5,2833578,57.7,334128,10.5
20619,September 2009,Iowa,2336799,1683162,72.0,1573705,67.3,109457,6.5
20620,September 2009,Kansas,2132592,1517665,71.2,1407735,66.0,109930,7.2
20621,September 2009,Kentucky,3333496,2060561,61.8,1842410,55.3,218151,10.6
20622,September 2009,Louisiana,3395772,2058526,60.6,1911530,56.3,146996,7.1
20623,September 2009,Maine,1065440,694464,65.2,637661,59.8,56803,8.2
20624,September 2009,Maryland,4406548,3032186,68.8,2811931,63.8,220255,7.3
20625,September 2009,Massachusetts,5248524,3472149,66.2,3173883,60.5,298266,8.6
20626,September 2009,Michigan,7772966,4889252,62.9,4193120,53.9,696132,14.2
20627,September 2009,Minnesota,4090504,2935146,71.8,2703348,66.1,231798,7.9
20628,September 2009,Mississippi,2202315,1259563,57.2,1134683,51.5,124880,9.9
20629,September 2009,Missouri,4617243,3047344,66.0,2754295,59.7,293049,9.6
20630,September 2009,Montana,768524,498953,64.9,464901,60.5,34052,6.8
20631,September 2009,Nebraska,1365808,990799,72.5,943468,69.1,47331,4.8
20632,September 2009,Nevada,2003771,1344598,67.1,1182796,59.0,161802,12.0
20633,September 2009,New Hampshire,1058571,742290,70.1,694563,65.6,47727,6.4
20634,September 2009,New Jersey,6776199,4551022,67.2,4111578,60.7,439444,9.7
20635,September 2009,New Mexico,1519997,936856,61.6,863349,56.8,73507,7.8
20636,September 2009,New York,15372147,9624047,62.6,8781638,57.1,842409,8.8
20637,September 2009,North Carolina,7138415,4550437,63.7,4060670,56.9,489767,10.8
20638,September 2009,North Dakota,504849,367995,72.9,353121,69.9,14874,4.0
20639,September 2009,Ohio,8959495,5875771,65.6,5246624,58.6,629147,10.7
20640,September 2009,Oklahoma,2780669,1764484,63.5,1644874,59.2,119610,6.8
20641,September 2009,Oregon,3015664,1965187,65.2,1746364,57.9,218823,11.1
20642,September 2009,Pennsylvania,9950472,6362827,63.9,5833913,58.6,528914,8.3
20643,September 2009,Rhode Island,842570,565792,67.2,502525,59.6,63267,11.2
20644,September 2009,South Carolina,3500223,2143491,61.2,1896555,54.2,246936,11.5
20645,September 2009,South Dakota,619024,444039,71.7,421849,68.1,22190,5.0
20646,September 2009,Tennessee,4878100,3039497,62.3,2714731,55.7,324766,10.7
20647,September 2009,Texas,18163851,11992696,66.0,10996372,60.5,996324,8.3
20648,September 2009,Utah,1980374,1358521,68.6,1254831,63.4,103690,7.6
20649,September 2009,Vermont,507724,358984,70.7,335688,66.1,23296,6.5
20650,September 2009,Virginia,6017014,4103792,68.2,3816940,63.4,286852,7.0
20651,September 2009,Washington,5191902,3557323,68.5,3192933,61.5,364390,10.2
20652,September 2009,West Virginia,1454359,813118,55.9,746189,51.3,66929,8.2
20653,September 2009,Wisconsin,4423136,3089883,69.9,2812270,63.6,277613,9.0
20654,September 2009,Wyoming,419500,300376,71.6,279777,66.7,20599,6.9
20655,October 2009,Alabama,3630337,2150606,59.2,1896957,52.3,253649,11.8
20656,October 2009,Alaska,514133,360349,70.1,331488,64.5,28861,8.0
20657,October 2009,Arizona,4975352,3122493,62.8,2785206,56.0,337287,10.8
20658,October 2009,Arkansas,2209199,1350513,61.1,1241970,56.2,108543,8.0
20659,October 2009,California,28053709,18147271,64.7,16003108,57.0,2144163,11.8
20660,October 2009,Colorado,3858144,2711943,70.3,2499218,64.8,212725,7.8
20661,October 2009,Connecticut,2753149,1893878,68.8,1731954,62.9,161924,8.5
20662,October 2009,Delaware,688459,431389,62.7,394129,57.2,37260,8.6
20663,October 2009,District of Columbia,488980,339130,69.4,305312,62.4,33818,10.0
20664,October 2009,Florida,14631311,9041413,61.8,8042732,55.0,998681,11.0
20665,October 2009,Georgia,7331829,4782352,65.2,4283326,58.4,499026,10.4
20666,October 2009,Hawaii,983622,630928,64.1,584936,59.5,45992,7.3
20667,October 2009,Idaho,1154366,758838,65.7,688237,59.6,70601,9.3
20668,October 2009,Illinois,9897655,6597946,66.7,5873134,59.3,724812,11.0
20669,October 2009,Indiana,4918039,3159513,64.2,2824731,57.4,334782,10.6
20670,October 2009,Iowa,2338466,1680381,71.9,1571851,67.2,108530,6.5
20671,October 2009,Kansas,2134462,1513969,70.9,1404772,65.8,109197,7.2
20672,October 2009,Kentucky,3336401,2056626,61.6,1839559,55.1,217067,10.6
20673,October 2009,Louisiana,3398961,2056861,60.5,1908720,56.2,148141,7.2
20674,October 2009,Maine,1065788,694026,65.1,637287,59.8,56739,8.2
20675,October 2009,Maryland,4411347,3032767,68.7,2808995,63.7,223772,7.4
20676,October 2009,Massachusetts,5253091,3469626,66.0,3168619,60.3,301007,8.7
20677,October 2009,Michigan,7775455,4870727,62.6,4183935,53.8,686792,14.1
20678,October 2009,Minnesota,4093670,2931271,71.6,2701677,66.0,229594,7.8
20679,October 2009,Mississippi,2203668,1258512,57.1,1130408,51.3,128104,10.2
20680,October 2009,Missouri,4620808,3040995,65.8,2747440,59.5,293555,9.7
20681,October 2009,Montana,769146,498953,64.9,464459,60.4,34494,6.9
20682,October 2009,Nebraska,1367090,990411,72.4,942901,69.0,47510,4.8
20683,October 2009,Nevada,2005462,1344505,67.0,1179870,58.8,164635,12.2
20684,October 2009,New Hampshire,1059204,741600,70.0,694220,65.5,47380,6.4
20685,October 2009,New Jersey,6781404,4545581,67.0,4102786,60.5,442795,9.7
20686,October 2009,New Mexico,1521909,934676,61.4,861474,56.6,73202,7.8
20687,October 2009,New York,15381268,9599817,62.4,8753163,56.9,846654,8.8
20688,October 2009,North Carolina,7146124,4548549,63.7,4052924,56.7,495625,10.9
20689,October 2009,North Dakota,505426,368563,72.9,353720,70.0,14843,4.0
20690,October 2009,Ohio,8963041,5866509,65.5,5232930,58.4,633579,10.8
20691,October 2009,Oklahoma,2783333,1761652,63.3,1640678,58.9,120974,6.9
20692,October 2009,Oregon,3018895,1962001,65.0,1746163,57.8,215838,11.0
20693,October 2009,Pennsylvania,9956445,6349243,63.8,5817495,58.4,531748,8.4
20694,October 2009,Rhode Island,842981,565599,67.1,502556,59.6,63043,11.1
20695,October 2009,South Carolina,3504193,2140585,61.1,1893276,54.0,247309,11.6
20696,October 2009,South Dakota,619792,443231,71.5,420933,67.9,22298,5.0
20697,October 2009,Tennessee,4882981,3034882,62.2,2712823,55.6,322059,10.6
20698,October 2009,Texas,18194118,11990132,65.9,10994996,60.4,995136,8.3
20699,October 2009,Utah,1983529,1356580,68.4,1252086,63.1,104494,7.7
20700,October 2009,Vermont,508094,358617,70.6,335672,66.1,22945,6.4
20701,October 2009,Virginia,6024651,4097753,68.0,3806654,63.2,291099,7.1
20702,October 2009,Washington,5199075,3546724,68.2,3182010,61.2,364714,10.3
20703,October 2009,West Virginia,1455021,811550,55.8,744363,51.2,67187,8.3
20704,October 2009,Wisconsin,4425882,3083897,69.7,2804457,63.4,279440,9.1
20705,October 2009,Wyoming,419851,300557,71.6,279657,66.6,20900,7.0
20706,November 2009,Alabama,3632553,2146482,59.1,1893152,52.1,253330,11.8
20707,November 2009,Alaska,514325,360386,70.1,331485,64.5,28901,8.0
20708,November 2009,Arizona,4981854,3117876,62.6,2778192,55.8,339684,10.9
20709,November 2009,Arkansas,2210757,1347827,61.0,1238682,56.0,109145,8.1
20710,November 2009,California,28084234,18148264,64.6,15981007,56.9,2167257,11.9
20711,November 2009,Colorado,3862938,2709549,70.1,2492994,64.5,216555,8.0
20712,November 2009,Connecticut,2754731,1893983,68.8,1729069,62.8,164914,8.7
20713,November 2009,Delaware,689092,430324,62.4,392892,57.0,37432,8.7
20714,November 2009,District of Columbia,489804,339878,69.4,305911,62.5,33967,10.0
20715,November 2009,Florida,14645036,9041529,61.7,8032541,54.8,1008988,11.2
20716,November 2009,Georgia,7340523,4781457,65.1,4280158,58.3,501299,10.5
20717,November 2009,Hawaii,984262,631194,64.1,585445,59.5,45749,7.2
20718,November 2009,Idaho,1155469,758909,65.7,688717,59.6,70192,9.2
20719,November 2009,Illinois,9902704,6598227,66.6,5863022,59.2,735205,11.1
20720,November 2009,Indiana,4920671,3156429,64.1,2818715,57.3,337714,10.7
20721,November 2009,Iowa,2339640,1678347,71.7,1570544,67.1,107803,6.4
20722,November 2009,Kansas,2135884,1510584,70.7,1401836,65.6,108748,7.2
20723,November 2009,Kentucky,3338735,2053847,61.5,1836898,55.0,216949,10.6
20724,November 2009,Louisiana,3401585,2056699,60.5,1907243,56.1,149456,7.3
20725,November 2009,Maine,1065945,693876,65.1,637069,59.8,56807,8.2
20726,November 2009,Maryland,4415406,3034991,68.7,2806870,63.6,228121,7.5
20727,November 2009,Massachusetts,5256717,3469028,66.0,3166235,60.2,302793,8.7
20728,November 2009,Michigan,7776472,4859090,62.5,4178597,53.7,680493,14.0
20729,November 2009,Minnesota,4096104,2929236,71.5,2701297,65.9,227939,7.8
20730,November 2009,Mississippi,2204638,1258934,57.1,1127274,51.1,131660,10.5
20731,November 2009,Missouri,4623522,3037488,65.7,2743050,59.3,294438,9.7
20732,November 2009,Montana,769618,499194,64.9,464090,60.3,35104,7.0
20733,November 2009,Nebraska,1368134,990228,72.4,942436,68.9,47792,4.8
20734,November 2009,Nevada,2006744,1345289,67.0,1177434,58.7,167855,12.5
20735,November 2009,New Hampshire,1059643,741153,69.9,694019,65.5,47134,6.4
20736,November 2009,New Jersey,6785393,4542865,67.0,4098084,60.4,444781,9.8
20737,November 2009,New Mexico,1523609,933079,61.2,859902,56.4,73177,7.8
20738,November 2009,New York,15387723,9582339,62.3,8733084,56.8,849255,8.9
20739,November 2009,North Carolina,7152631,4553298,63.7,4049529,56.6,503769,11.1
20740,November 2009,North Dakota,505905,369444,73.0,354569,70.1,14875,4.0
20741,November 2009,Ohio,8964826,5863349,65.4,5223144,58.3,640205,10.9
20742,November 2009,Oklahoma,2785467,1759976,63.2,1637551,58.8,122425,7.0
20743,November 2009,Oregon,3021588,1961392,64.9,1746925,57.8,214467,10.9
20744,November 2009,Pennsylvania,9960433,6341910,63.7,5805125,58.3,536785,8.5
20745,November 2009,Rhode Island,843259,565582,67.1,502737,59.6,62845,11.1
20746,November 2009,South Carolina,3507589,2139877,61.0,1891342,53.9,248535,11.6
20747,November 2009,South Dakota,620458,442586,71.3,420078,67.7,22508,5.1
20748,November 2009,Tennessee,4886991,3035567,62.1,2715209,55.6,320358,10.6
20749,November 2009,Texas,18221759,11999329,65.9,11004318,60.4,995011,8.3
20750,November 2009,Utah,1986362,1355221,68.2,1249870,62.9,105351,7.8
20751,November 2009,Vermont,508329,358493,70.5,335749,66.0,22744,6.3
20752,November 2009,Virginia,6031267,4095945,67.9,3799649,63.0,296296,7.2
20753,November 2009,Washington,5205382,3538010,68.0,3172250,60.9,365760,10.3
20754,November 2009,West Virginia,1455387,810661,55.7,742760,51.0,67901,8.4
20755,November 2009,Wisconsin,4427819,3080690,69.6,2798709,63.2,281981,9.2
20756,November 2009,Wyoming,420108,300913,71.6,279665,66.6,21248,7.1
20757,December 2009,Alabama,3634419,2144499,59.0,1891907,52.1,252592,11.8
20758,December 2009,Alaska,514467,360453,70.1,331517,64.4,28936,8.0
20759,December 2009,Arizona,4987853,3115422,62.5,2775036,55.6,340386,10.9
20760,December 2009,Arkansas,2212101,1345690,60.8,1235879,55.9,109811,8.2
20761,December 2009,California,28111925,18172283,64.6,15979281,56.8,2193002,12.1
20762,December 2009,Colorado,3867378,2710561,70.1,2489336,64.4,221225,8.2
20763,December 2009,Connecticut,2756043,1894857,68.8,1727215,62.7,167642,8.8
20764,December 2009,Delaware,689720,429769,62.3,392190,56.9,37579,8.7
20765,December 2009,District of Columbia,490641,340661,69.4,306783,62.5,33878,9.9
20766,December 2009,Florida,14657213,9057975,61.8,8039270,54.8,1018705,11.2
20767,December 2009,Georgia,7348529,4785187,65.1,4282305,58.3,502882,10.5
20768,December 2009,Hawaii,984741,631973,64.2,586547,59.6,45426,7.2
20769,December 2009,Idaho,1156479,759545,65.7,689507,59.6,70038,9.2
20770,December 2009,Illinois,9906794,6610271,66.7,5865244,59.2,745027,11.3
20771,December 2009,Indiana,4922905,3159417,64.2,2816984,57.2,342433,10.8
20772,December 2009,Iowa,2340638,1677484,71.7,1570242,67.1,107242,6.4
20773,December 2009,Kansas,2137157,1507883,70.6,1399244,65.5,108639,7.2
20774,December 2009,Kentucky,3340801,2052984,61.5,1835339,54.9,217645,10.6
20775,December 2009,Louisiana,3403890,2059351,60.5,1907998,56.1,151353,7.3
20776,December 2009,Maine,1066053,693985,65.1,637053,59.8,56932,8.2
20777,December 2009,Maryland,4419022,3039460,68.8,2806783,63.5,232677,7.7
20778,December 2009,Massachusetts,5259886,3471474,66.0,3167437,60.2,304037,8.8
20779,December 2009,Michigan,7776809,4855255,62.4,4178124,53.7,677131,13.9
20780,December 2009,Minnesota,4098214,2929562,71.5,2702551,65.9,227011,7.7
20781,December 2009,Mississippi,2205398,1260414,57.2,1125638,51.0,134776,10.7
20782,December 2009,Missouri,4625852,3038815,65.7,2742566,59.3,296249,9.7
20783,December 2009,Montana,770036,499622,64.9,463837,60.2,35785,7.2
20784,December 2009,Nebraska,1369023,990253,72.3,942250,68.8,48003,4.8
20785,December 2009,Nevada,2007872,1347093,67.1,1175617,58.6,171476,12.7
20786,December 2009,New Hampshire,1060017,740836,69.9,693971,65.5,46865,6.3
20787,December 2009,New Jersey,6788789,4544433,66.9,4098646,60.4,445787,9.8
20788,December 2009,New Mexico,1525111,932476,61.1,858927,56.3,73549,7.9
20789,December 2009,New York,15392726,9578723,62.2,8727519,56.7,851204,8.9
20790,December 2009,North Carolina,7158470,4566393,63.8,4053239,56.6,513154,11.2
20791,December 2009,North Dakota,506446,370664,73.2,355769,70.2,14895,4.0
20792,December 2009,Ohio,8965878,5866982,65.4,5219676,58.2,647306,11.0
20793,December 2009,Oklahoma,2787381,1760154,63.1,1636403,58.7,123751,7.0
20794,December 2009,Oregon,3023994,1963411,64.9,1748959,57.8,214452,10.9
20795,December 2009,Pennsylvania,9963526,6343929,63.7,5799597,58.2,544332,8.6
20796,December 2009,Rhode Island,843434,565780,67.1,503035,59.6,62745,11.1
20797,December 2009,South Carolina,3510581,2141821,61.0,1891614,53.9,250207,11.7
20798,December 2009,South Dakota,621097,442135,71.2,419447,67.5,22688,5.1
20799,December 2009,Tennessee,4890561,3042726,62.2,2722908,55.7,319818,10.5
20800,December 2009,Texas,18247563,12026349,65.9,11028565,60.4,997784,8.3
20801,December 2009,Utah,1989021,1354722,68.1,1248472,62.8,106250,7.8
20802,December 2009,Vermont,508622,358618,70.5,335969,66.1,22649,6.3
20803,December 2009,Virginia,6037319,4100552,67.9,3798877,62.9,301675,7.4
20804,December 2009,Washington,5211219,3532638,67.8,3165654,60.7,366984,10.4
20805,December 2009,West Virginia,1455689,810555,55.7,741741,51.0,68814,8.5
20806,December 2009,Wisconsin,4429332,3080880,69.6,2796359,63.1,284521,9.2
20807,December 2009,Wyoming,420366,301339,71.7,279841,66.6,21498,7.1
20808,January 2010,Alabama,3636380,2144182,59.0,1893169,52.1,251013,11.7
20809,January 2010,Alaska,514628,360551,70.1,331605,64.4,28946,8.0
20810,January 2010,Arizona,4994110,3114963,62.4,2775542,55.6,339421,10.9
20811,January 2010,Arkansas,2213503,1344729,60.8,1234457,55.8,110272,8.2
20812,January 2010,California,28141513,18214520,64.7,15997913,56.8,2216607,12.2
20813,January 2010,Colorado,3871967,2714266,70.1,2488218,64.3,226048,8.3
20814,January 2010,Connecticut,2757497,1896872,68.8,1726968,62.6,169904,9.0
20815,January 2010,Delaware,690331,429710,62.2,392087,56.8,37623,8.8
20816,January 2010,District of Columbia,491473,341698,69.5,308097,62.7,33601,9.8
20817,January 2010,Florida,14670087,9087605,61.9,8063166,55.0,1024439,11.3
20818,January 2010,Georgia,7356794,4792496,65.1,4289733,58.3,502763,10.5
20819,January 2010,Hawaii,985330,633386,64.3,588348,59.7,45038,7.1
20820,January 2010,Idaho,1157503,760445,65.7,690531,59.7,69914,9.2
20821,January 2010,Illinois,9911282,6629263,66.9,5879062,59.3,750201,11.3
20822,January 2010,Indiana,4925217,3166341,64.3,2819597,57.2,346744,11.0
20823,January 2010,Iowa,2341680,1677700,71.6,1571136,67.1,106564,6.4
20824,January 2010,Kansas,2138455,1506003,70.4,1397325,65.3,108678,7.2
20825,January 2010,Kentucky,3342861,2053600,61.4,1835448,54.9,218152,10.6
20826,January 2010,Louisiana,3406282,2065028,60.6,1911282,56.1,153746,7.4
20827,January 2010,Maine,1066138,694243,65.1,637259,59.8,56984,8.2
20828,January 2010,Maryland,4422798,3045709,68.9,2809483,63.5,236226,7.8
20829,January 2010,Massachusetts,5263246,3476509,66.1,3171979,60.3,304530,8.8
20830,January 2010,Michigan,7777357,4855813,62.4,4182856,53.8,672957,13.9
20831,January 2010,Minnesota,4100422,2931636,71.5,2705380,66.0,226256,7.7
20832,January 2010,Mississippi,2206254,1262265,57.2,1125566,51.0,136699,10.8
20833,January 2010,Missouri,4628246,3044035,65.8,2746214,59.3,297821,9.8
20834,January 2010,Montana,770491,500111,64.9,463719,60.2,36392,7.3
20835,January 2010,Nebraska,1370014,990571,72.3,942479,68.8,48092,4.9
20836,January 2010,Nevada,2009168,1349605,67.2,1174472,58.5,175133,13.0
20837,January 2010,New Hampshire,1060421,740503,69.8,694080,65.5,46423,6.3
20838,January 2010,New Jersey,6792469,4549452,67.0,4104096,60.4,445356,9.8
20839,January 2010,New Mexico,1526749,933018,61.1,858746,56.2,74272,8.0
20840,January 2010,New York,15398444,9589044,62.3,8737735,56.7,851309,8.9
20841,January 2010,North Carolina,7164495,4585775,64.0,4064556,56.7,521219,11.4
20842,January 2010,North Dakota,506905,372147,73.4,357286,70.5,14861,4.0
20843,January 2010,Ohio,8967104,5874018,65.5,5223099,58.2,650919,11.1
20844,January 2010,Oklahoma,2789349,1762129,63.2,1637478,58.7,124651,7.1
20845,January 2010,Oregon,3026512,1967463,65.0,1752287,57.9,215176,10.9
20846,January 2010,Pennsylvania,9966890,6354075,63.8,5801663,58.2,552412,8.7
20847,January 2010,Rhode Island,843675,566147,67.1,503346,59.7,62801,11.1
20848,January 2010,South Carolina,3513739,2145645,61.1,1894376,53.9,251269,11.7
20849,January 2010,South Dakota,621730,441836,71.1,419084,67.4,22752,5.1
20850,January 2010,Tennessee,4894242,3054356,62.4,2735355,55.9,319001,10.4
20851,January 2010,Texas,18274485,12068751,66.0,11067039,60.6,1001712,8.3
20852,January 2010,Utah,1991747,1355042,68.0,1247979,62.7,107063,7.9
20853,January 2010,Vermont,508821,358889,70.5,336293,66.1,22596,6.3
20854,January 2010,Virginia,6043575,4111141,68.0,3805371,63.0,305770,7.4
20855,January 2010,Washington,5217186,3530511,67.7,3163087,60.6,367424,10.4
20856,January 2010,West Virginia,1455955,810979,55.7,741429,50.9,69550,8.6
20857,January 2010,Wisconsin,4430954,3083443,69.6,2797679,63.1,285764,9.3
20858,January 2010,Wyoming,420608,301774,71.7,280222,66.6,21552,7.1
20859,February 2010,Alabama,3637985,2143881,58.9,1895920,52.1,247961,11.6
20860,February 2010,Alaska,514760,360671,70.1,331758,64.4,28913,8.0
20861,February 2010,Arizona,4999841,3114578,62.3,2777742,55.6,336836,10.8
20862,February 2010,Arkansas,2214703,1345101,60.7,1234769,55.8,110332,8.2
20863,February 2010,California,28168472,18262083,64.8,16028580,56.9,2233503,12.2
20864,February 2010,Colorado,3876247,2718865,70.1,2488580,64.2,230285,8.5
20865,February 2010,Connecticut,2758668,1899771,68.9,1728256,62.6,171515,9.0
20866,February 2010,Delaware,690834,430100,62.3,392564,56.8,37536,8.7
20867,February 2010,District of Columbia,492229,343090,69.7,309848,62.9,33242,9.7
20868,February 2010,Florida,14681071,9121821,62.1,8097244,55.2,1024577,11.2
20869,February 2010,Georgia,7364379,4699011,63.8,4199161,57.0,499850,10.6
20870,February 2010,Hawaii,985714,635460,64.5,590772,59.9,44688,7.0
20871,February 2010,Idaho,1158417,761252,65.7,691539,59.7,69713,9.2
20872,February 2010,Illinois,9914870,6646430,67.0,5898678,59.5,747752,11.3
20873,February 2010,Indiana,4927158,3174143,64.4,2825320,57.3,348823,11.0
20874,February 2010,Iowa,2342488,1678413,71.7,1572916,67.1,105497,6.3
20875,February 2010,Kansas,2139596,1504661,70.3,1396164,65.3,108497,7.2
20876,February 2010,Kentucky,3344688,2054417,61.4,1836904,54.9,217513,10.6
20877,February 2010,Louisiana,3408339,2072458,60.8,1916327,56.2,156131,7.5
20878,February 2010,Maine,1066067,694475,65.1,637568,59.8,56907,8.2
20879,February 2010,Maryland,4426148,3052675,69.0,2814636,63.6,238039,7.8
20880,February 2010,Massachusetts,5266159,3482040,66.1,3178085,60.3,303955,8.7
20881,February 2010,Michigan,7777182,4855867,62.4,4190694,53.9,665173,13.7
20882,February 2010,Minnesota,4102269,2934157,71.5,2709231,66.0,224926,7.7
20883,February 2010,Mississippi,2206814,1264065,57.3,1126715,51.1,137350,10.9
20884,February 2010,Missouri,4630244,3050406,65.9,2752092,59.4,298314,9.8
20885,February 2010,Montana,770816,500537,64.9,463715,60.2,36822,7.4
20886,February 2010,Nebraska,1370817,991163,72.3,943140,68.8,48023,4.8
20887,February 2010,Nevada,2010225,1352271,67.3,1173869,58.4,178402,13.2
20888,February 2010,New Hampshire,1060683,740114,69.8,694365,65.5,45749,6.2
20889,February 2010,New Jersey,6795487,4555278,67.0,4112020,60.5,443258,9.7
20890,February 2010,New Mexico,1528209,934526,61.2,859339,56.2,75187,8.0
20891,February 2010,New York,15402678,9605948,62.4,8757142,56.9,848806,8.8
20892,February 2010,North Carolina,7169890,4606035,64.2,4080476,56.9,525559,11.4
20893,February 2010,North Dakota,507299,373754,73.7,358981,70.8,14773,4.0
20894,February 2010,Ohio,8967563,5878946,65.6,5230996,58.3,647950,11.0
20895,February 2010,Oklahoma,2791092,1765089,63.2,1640106,58.8,124983,7.1
20896,February 2010,Oregon,3028729,1972219,65.1,1756351,58.0,215868,10.9
20897,February 2010,Pennsylvania,9969289,6367507,63.9,5809093,58.3,558414,8.8
20898,February 2010,Rhode Island,843803,566578,67.1,503581,59.7,62997,11.1
20899,February 2010,South Carolina,3516497,2149682,61.1,1898964,54.0,250718,11.7
20900,February 2010,South Dakota,622261,441620,71.0,418975,67.3,22645,5.1
20901,February 2010,Tennessee,4897491,3066213,62.6,2750126,56.2,316087,10.3
20902,February 2010,Texas,18299762,12116512,66.2,11112513,60.7,1003999,8.3
20903,February 2010,Utah,1994390,1355856,68.0,1248210,62.6,107646,7.9
20904,February 2010,Vermont,509023,359206,70.6,336679,66.1,22527,6.3
20905,February 2010,Virginia,6049306,4124601,68.2,3817085,63.1,307516,7.5
20906,February 2010,Washington,5222744,3529820,67.6,3163688,60.6,366132,10.4
20907,February 2010,West Virginia,1456112,811352,55.7,741553,50.9,69799,8.6
20908,February 2010,Wisconsin,4432255,3086109,69.6,2801443,63.2,284666,9.2
20909,February 2010,Wyoming,420826,302123,71.8,280793,66.7,21330,7.1
20910,March 2010,Alabama,3639724,2142133,58.9,1898914,52.2,243219,11.4
20911,March 2010,Alaska,514896,360805,70.1,331968,64.5,28837,8.0
20912,March 2010,Arizona,5005603,3112379,62.2,2779363,55.5,333016,10.7
20913,March 2010,Arkansas,2215934,1346699,60.8,1236603,55.8,110096,8.2
20914,March 2010,California,28195088,18304098,64.9,16061366,57.0,2242732,12.3
20915,March 2010,Colorado,3880636,2722791,70.2,2489213,64.1,233578,8.6
20916,March 2010,Connecticut,2759910,1903190,69.0,1730684,62.7,172506,9.1
20917,March 2010,Delaware,691403,430874,62.3,393526,56.9,37348,8.7
20918,March 2010,District of Columbia,493007,344639,69.9,311743,63.2,32896,9.5
20919,March 2010,Florida,14692208,9153821,62.3,8133092,55.4,1020729,11.2
20920,March 2010,Georgia,7372287,4674480,63.4,4179456,56.7,495024,10.6
20921,March 2010,Hawaii,986160,638106,64.7,593618,60.2,44488,7.0
20922,March 2010,Idaho,1159426,761819,65.7,692372,59.7,69447,9.1
20923,March 2010,Illinois,9918785,6655359,67.1,5917703,59.7,737656,11.1
20924,March 2010,Indiana,4929346,3181033,64.5,2832872,57.5,348161,10.9
20925,March 2010,Iowa,2343400,1678977,71.6,1574961,67.2,104016,6.2
20926,March 2010,Kansas,2140798,1503545,70.2,1395688,65.2,107857,7.2
20927,March 2010,Kentucky,3346711,2054433,61.4,1839003,54.9,215430,10.5
20928,March 2010,Louisiana,3410594,2080069,61.0,1921681,56.3,158388,7.6
20929,March 2010,Maine,1066137,694551,65.1,637804,59.8,56747,8.2
20930,March 2010,Maryland,4429620,3059579,69.1,2821365,63.7,238214,7.8
20931,March 2010,Massachusetts,5269256,3485942,66.2,3183829,60.4,302113,8.7
20932,March 2010,Michigan,7777301,4852237,62.4,4198486,54.0,653751,13.5
20933,March 2010,Minnesota,4104281,2936270,71.5,2713397,66.1,222873,7.6
20934,March 2010,Mississippi,2207537,1265476,57.3,1128547,51.1,136929,10.8
20935,March 2010,Missouri,4632421,3055657,66.0,2758039,59.5,297618,9.7
20936,March 2010,Montana,771187,500852,64.9,463843,60.1,37009,7.4
20937,March 2010,Nebraska,1371688,991850,72.3,944146,68.8,47704,4.8
20938,March 2010,Nevada,2011335,1354628,67.3,1173685,58.4,180943,13.4
20939,March 2010,New Hampshire,1061057,739712,69.7,694801,65.5,44911,6.1
20940,March 2010,New Jersey,6798668,4559927,67.1,4119791,60.6,440136,9.7
20941,March 2010,New Mexico,1529618,936583,61.2,860436,56.3,76147,8.1
20942,March 2010,New York,15407189,9621227,62.4,8776986,57.0,844241,8.8
20943,March 2010,North Carolina,7175533,4622114,64.4,4097183,57.1,524931,11.4
20944,March 2010,North Dakota,507715,375337,73.9,360682,71.0,14655,3.9
20945,March 2010,Ohio,8968417,5878360,65.5,5239969,58.4,638391,10.9
20946,March 2010,Oklahoma,2792911,1768033,63.3,1643404,58.8,124629,7.0
20947,March 2010,Oregon,3031074,1976473,65.2,1760547,58.1,215926,10.9
20948,March 2010,Pennsylvania,9972037,6379694,64.0,5819200,58.4,560494,8.8
20949,March 2010,Rhode Island,843979,567057,67.2,503755,59.7,63302,11.2
20950,March 2010,South Carolina,3519427,2152972,61.2,1904386,54.1,248586,11.5
20951,March 2010,South Dakota,622857,441460,70.9,419069,67.3,22391,5.1
20952,March 2010,Tennessee,4900953,3075346,62.7,2764750,56.4,310596,10.1
20953,March 2010,Texas,18325113,12160592,66.4,11157088,60.9,1003504,8.3
20954,March 2010,Utah,1997075,1356837,67.9,1248856,62.5,107981,8.0
20955,March 2010,Vermont,509216,359488,70.6,337067,66.2,22421,6.2
20956,March 2010,Virginia,6055213,4137711,68.3,3830874,63.3,306837,7.4
20957,March 2010,Washington,5228475,3528642,67.5,3165760,60.5,362882,10.3
20958,March 2010,West Virginia,1456324,811333,55.7,741758,50.9,69575,8.6
20959,March 2010,Wisconsin,4433668,3087194,69.6,2806064,63.3,281130,9.1
20960,March 2010,Wyoming,421067,302337,71.8,281479,66.8,20858,6.9
20961,April 2010,Alabama,3696852,2202028,59.6,1964959,53.2,237069,10.8
20962,April 2010,Alaska,515855,360965,70.0,332248,64.4,28717,8.0
20963,April 2010,Arizona,4838483,3107972,64.2,2779450,57.4,328522,10.6
20964,April 2010,Arkansas,2231369,1349305,60.5,1239491,55.5,109814,8.1
20965,April 2010,California,28538473,18335653,64.2,16090440,56.4,2245213,12.2
20966,April 2010,Colorado,3848294,2725446,70.8,2489593,64.7,235853,8.7
20967,April 2010,Connecticut,2802301,1906859,68.0,1733838,61.9,173021,9.1
20968,April 2010,Delaware,701522,431940,61.6,394829,56.3,37111,8.6
20969,April 2010,District of Columbia,502467,346075,68.9,313469,62.4,32606,9.4
20970,April 2010,Florida,14959819,9181288,61.4,8165997,54.6,1015291,11.1
20971,April 2010,Georgia,7276817,4669893,64.2,4179931,57.4,489962,10.5
20972,April 2010,Hawaii,1039191,641085,61.7,596613,57.4,44472,6.9
20973,April 2010,Idaho,1163322,762064,65.5,692947,59.6,69117,9.1
20974,April 2010,Illinois,9881078,6654739,67.3,5932888,60.0,721851,10.8
20975,April 2010,Indiana,4962802,3185758,64.2,2840912,57.2,344846,10.8
20976,April 2010,Iowa,2358244,1679141,71.2,1576713,66.9,102428,6.1
20977,April 2010,Kansas,2147774,1502629,70.0,1395747,65.0,106882,7.1
20978,April 2010,Kentucky,3340233,2053563,61.5,1841330,55.1,212233,10.3
20979,April 2010,Louisiana,3434420,2086900,60.8,1926189,56.1,160711,7.7
20980,April 2010,Maine,1074478,694445,64.6,637892,59.4,56553,8.1
20981,April 2010,Maryland,4490954,3066143,68.3,2828799,63.0,237344,7.7
20982,April 2010,Massachusetts,5224462,3487331,66.8,3188377,61.0,298954,8.6
20983,April 2010,Michigan,7718802,4843967,62.8,4204439,54.5,639528,13.2
20984,April 2010,Minnesota,4108442,2937670,71.5,2717445,66.1,220225,7.5
20985,April 2010,Mississippi,2228891,1266360,56.8,1130601,50.7,135759,10.7
20986,April 2010,Missouri,4618708,3058868,66.2,2763038,59.8,295830,9.7
20987,April 2010,Montana,777448,501056,64.4,464095,59.7,36961,7.4
20988,April 2010,Nebraska,1388020,992450,71.5,945347,68.1,47103,4.7
20989,April 2010,Nevada,2073315,1356407,65.4,1173783,56.6,182624,13.5
20990,April 2010,New Hampshire,1051839,739270,70.3,695252,66.1,44018,6.0
20991,April 2010,New Jersey,6867537,4562426,66.4,4125865,60.1,436561,9.6
20992,April 2010,New Mexico,1564182,938582,60.0,861587,55.1,76995,8.2
20993,April 2010,New York,15339306,9630479,62.8,8792421,57.3,838058,8.7
20994,April 2010,North Carolina,7297328,4631285,63.5,4112003,56.3,519282,11.2
20995,April 2010,North Dakota,523126,376728,72.0,362204,69.2,14524,3.9
20996,April 2010,Ohio,8958260,5872041,65.5,5247840,58.6,624201,10.6
20997,April 2010,Oklahoma,2836229,1770146,62.4,1646616,58.1,123530,7.0
20998,April 2010,Oregon,3024385,1979679,65.5,1764584,58.3,215095,10.9
20999,April 2010,Pennsylvania,10056663,6388079,63.5,5830330,58.0,557749,8.7
21000,April 2010,Rhode Island,840371,567548,67.5,503899,60.0,63649,11.2
21001,April 2010,South Carolina,3567185,2155305,60.4,1909849,53.5,245456,11.4
21002,April 2010,South Dakota,616161,441349,71.6,419274,68.0,22075,5.0
21003,April 2010,Tennessee,4916746,3081216,62.7,2777976,56.5,303240,9.8
21004,April 2010,Texas,18541687,12196433,65.8,11196606,60.4,999827,8.2
21005,April 2010,Utah,1952080,1357702,69.6,1249619,64.0,108083,8.0
21006,April 2010,Vermont,506427,359650,71.0,337367,66.6,22283,6.2
21007,April 2010,Virginia,6149195,4148999,67.5,3844786,62.5,304213,7.3
21008,April 2010,Washington,5233192,3526005,67.4,3167824,60.5,358181,10.2
21009,April 2010,West Virginia,1481241,811023,54.8,741898,50.1,69125,8.5
21010,April 2010,Wisconsin,4428585,3086430,69.7,2810586,63.5,275844,8.9
21011,April 2010,Wyoming,432995,302446,69.8,282195,65.2,20251,6.7
21012,May 2010,Alabama,3700011,2215715,59.9,1985529,53.7,230186,10.4
21013,May 2010,Alaska,516832,361150,69.9,332605,64.4,28545,7.9
21014,May 2010,Arizona,4843792,3101692,64.0,2778096,57.4,323596,10.4
21015,May 2010,Arkansas,2233168,1352246,60.6,1242672,55.6,109574,8.1
21016,May 2010,California,28567608,18353688,64.2,16112833,56.4,2240855,12.2
21017,May 2010,Colorado,3852543,2726694,70.8,2489552,64.6,237142,8.7
21018,May 2010,Connecticut,2805016,1910490,68.1,1737260,61.9,173230,9.1
21019,May 2010,Delaware,702152,433161,61.7,396298,56.4,36863,8.5
21020,May 2010,District of Columbia,503352,347182,69.0,314804,62.5,32378,9.3
21021,May 2010,Florida,14974483,9203212,61.5,8193577,54.7,1009635,11.0
21022,May 2010,Georgia,7285322,4670823,64.1,4185382,57.4,485441,10.4
21023,May 2010,Hawaii,1040637,644088,61.9,599477,57.6,44611,6.9
21024,May 2010,Idaho,1164350,761960,65.4,693237,59.5,68723,9.0
21025,May 2010,Illinois,9885982,6645625,67.2,5943454,60.1,702171,10.6
21026,May 2010,Indiana,4965445,3187271,64.2,2848122,57.4,339149,10.6
21027,May 2010,Iowa,2359222,1678850,71.2,1577916,66.9,100934,6.0
21028,May 2010,Kansas,2148574,1501761,69.9,1396071,65.0,105690,7.0
21029,May 2010,Kentucky,3343521,2052134,61.4,1843647,55.1,208487,10.2
21030,May 2010,Louisiana,3437679,2092101,60.9,1929083,56.1,163018,7.8
21031,May 2010,Maine,1074472,694263,64.6,637898,59.4,56365,8.1
21032,May 2010,Maryland,4495035,3071885,68.3,2836057,63.1,235828,7.7
21033,May 2010,Massachusetts,5230408,3486138,66.7,3191639,61.0,294499,8.4
21034,May 2010,Michigan,7719425,4831063,62.6,4207937,54.5,623126,12.9
21035,May 2010,Minnesota,4110982,2938435,71.5,2721066,66.2,217369,7.4
21036,May 2010,Mississippi,2230703,1266762,56.8,1132519,50.8,134243,10.6
21037,May 2010,Missouri,4621429,3059887,66.2,2766767,59.9,293120,9.6
21038,May 2010,Montana,777807,501155,64.4,464415,59.7,36740,7.3
21039,May 2010,Nebraska,1388977,992876,71.5,946557,68.1,46319,4.7
21040,May 2010,Nevada,2074492,1357537,65.4,1174008,56.6,183529,13.5
21041,May 2010,New Hampshire,1052251,738781,70.2,695590,66.1,43191,5.8
21042,May 2010,New Jersey,6872351,4562235,66.4,4129579,60.1,432656,9.5
21043,May 2010,New Mexico,1565868,939956,60.0,862388,55.1,77568,8.3
21044,May 2010,New York,15348347,9631529,62.8,8801543,57.3,829986,8.6
21045,May 2010,North Carolina,7307942,4632515,63.4,4123402,56.4,509113,11.0
21046,May 2010,North Dakota,523564,377828,72.2,363433,69.4,14395,3.8
21047,May 2010,Ohio,8961258,5861236,65.4,5253608,58.6,607628,10.4
21048,May 2010,Oklahoma,2838869,1771014,62.4,1649251,58.1,121763,6.9
21049,May 2010,Oregon,3026904,1981748,65.5,1768359,58.4,213389,10.8
21050,May 2010,Pennsylvania,10060736,6391191,63.5,5841003,58.1,550188,8.6
21051,May 2010,Rhode Island,840835,567916,67.5,503983,59.9,63933,11.3
21052,May 2010,South Carolina,3570727,2156277,60.4,1914770,53.6,241507,11.2
21053,May 2010,South Dakota,616675,441263,71.6,419478,68.0,21785,4.9
21054,May 2010,Tennessee,4921488,3084496,62.7,2789401,56.7,295095,9.6
21055,May 2010,Texas,18567826,12222758,65.8,11230124,60.5,992634,8.1
21056,May 2010,Utah,1954684,1358240,69.5,1250301,64.0,107939,7.9
21057,May 2010,Vermont,506591,359676,71.0,337561,66.6,22115,6.1
21058,May 2010,Virginia,6155422,4157743,67.5,3857567,62.7,300176,7.2
21059,May 2010,Washington,5236982,3521607,67.2,3168900,60.5,352707,10.0
21060,May 2010,West Virginia,1481735,810631,54.7,741930,50.1,68701,8.5
21061,May 2010,Wisconsin,4430284,3084376,69.6,2814523,63.5,269853,8.7
21062,May 2010,Wyoming,433291,302531,69.8,282900,65.3,19631,6.5
21063,June 2010,Alabama,3703341,2215606,59.8,1991532,53.8,224074,10.1
21064,June 2010,Alaska,517834,361348,69.8,333011,64.3,28337,7.8
21065,June 2010,Arizona,4849126,3094080,63.8,2775146,57.2,318934,10.3
21066,June 2010,Arkansas,2234897,1354708,60.6,1245193,55.7,109515,8.1
21067,June 2010,California,28597342,18358525,64.2,16124135,56.4,2234390,12.2
21068,June 2010,Colorado,3856945,2726542,70.7,2488575,64.5,237967,8.7
21069,June 2010,Connecticut,2807733,1913669,68.2,1740215,62.0,173454,9.1
21070,June 2010,Delaware,702785,434360,61.8,397725,56.6,36635,8.4
21071,June 2010,District of Columbia,504197,347745,69.0,315533,62.6,32212,9.3
21072,June 2010,Florida,14989298,9219282,61.5,8212566,54.8,1006716,10.9
21073,June 2010,Georgia,7294213,4673422,64.1,4190456,57.4,482966,10.3
21074,June 2010,Hawaii,1042361,646940,62.1,602056,57.8,44884,6.9
21075,June 2010,Idaho,1165449,761585,65.3,693255,59.5,68330,9.0
21076,June 2010,Illinois,9890816,6631747,67.0,5948816,60.1,682931,10.3
21077,June 2010,Indiana,4967933,3185465,64.1,2852903,57.4,332562,10.4
21078,June 2010,Iowa,2360173,1678125,71.1,1578456,66.9,99669,5.9
21079,June 2010,Kansas,2149422,1500929,69.8,1396182,65.0,104747,7.0
21080,June 2010,Kentucky,3346914,2050773,61.3,1845449,55.1,205324,10.0
21081,June 2010,Louisiana,3440967,2094979,60.9,1929545,56.1,165434,7.9
21082,June 2010,Maine,1074424,694172,64.6,637919,59.4,56253,8.1
21083,June 2010,Maryland,4499123,3076363,68.4,2842041,63.2,234322,7.6
21084,June 2010,Massachusetts,5236237,3482961,66.5,3193402,61.0,289559,8.3
21085,June 2010,Michigan,7719880,4814161,62.4,4207785,54.5,606376,12.6
21086,June 2010,Minnesota,4113498,2938805,71.4,2723778,66.2,215027,7.3
21087,June 2010,Mississippi,2232442,1306437,58.5,1173441,52.6,132996,10.2
21088,June 2010,Missouri,4624209,3059038,66.2,2768613,59.9,290425,9.5
21089,June 2010,Montana,778144,501110,64.4,464658,59.7,36452,7.3
21090,June 2010,Nebraska,1389916,993203,71.5,947587,68.2,45616,4.6
21091,June 2010,Nevada,2075736,1358197,65.4,1174164,56.6,184033,13.5
21092,June 2010,New Hampshire,1052689,738284,70.1,695719,66.1,42565,5.8
21093,June 2010,New Jersey,6877124,4559450,66.3,4130185,60.1,429265,9.4
21094,June 2010,New Mexico,1567675,940305,60.0,862544,55.0,77761,8.3
21095,June 2010,New York,15357165,9623572,62.7,8801658,57.3,821914,8.5
21096,June 2010,North Carolina,7318800,4627292,63.2,4129971,56.4,497321,10.7
21097,June 2010,North Dakota,524012,378633,72.3,364357,69.5,14276,3.8
21098,June 2010,Ohio,8964100,5848419,65.2,5256057,58.6,592362,10.1
21099,June 2010,Oklahoma,2841677,1770646,62.3,1650800,58.1,119846,6.8
21100,June 2010,Oregon,3029409,1983223,65.5,1771808,58.5,211415,10.7
21101,June 2010,Pennsylvania,10064631,6389281,63.5,5848796,58.1,540485,8.5
21102,June 2010,Rhode Island,841266,568033,67.5,503956,59.9,64077,11.3
21103,June 2010,South Carolina,3574437,2156087,60.3,1918470,53.7,237617,11.0
21104,June 2010,South Dakota,617203,441191,71.5,419615,68.0,21576,4.9
21105,June 2010,Tennessee,4926278,3086643,62.7,2798311,56.8,288332,9.3
21106,June 2010,Texas,18594451,12241226,65.8,11256000,60.5,985226,8.0
21107,June 2010,Utah,1957301,1358279,69.4,1250702,63.9,107577,7.9
21108,June 2010,Vermont,506756,359582,71.0,337664,66.6,21918,6.1
21109,June 2010,Virginia,6162232,4163295,67.6,3867279,62.8,296016,7.1
21110,June 2010,Washington,5240915,3516112,67.1,3168197,60.5,347915,9.9
21111,June 2010,West Virginia,1482237,810305,54.7,741731,50.0,68574,8.5
21112,June 2010,Wisconsin,4431933,3081690,69.5,2817143,63.6,264547,8.6
21113,June 2010,Wyoming,433582,302704,69.8,283583,65.4,19121,6.3
21114,July 2010,Alabama,3706667,2212806,59.7,1992510,53.8,220296,10.0
21115,July 2010,Alaska,518911,361603,69.7,333436,64.3,28167,7.8
21116,July 2010,Arizona,4854804,3086291,63.6,2770957,57.1,315334,10.2
21117,July 2010,Arkansas,2236832,1356281,60.6,1246536,55.7,109745,8.1
21118,July 2010,California,28628056,18356993,64.1,16123990,56.3,2233003,12.2
21119,July 2010,Colorado,3861554,2725775,70.6,2486711,64.4,239064,8.8
21120,July 2010,Connecticut,2810603,1916044,68.2,1742076,62.0,173968,9.1
21121,July 2010,Delaware,703430,435388,61.9,398956,56.7,36432,8.4
21122,July 2010,District of Columbia,505084,347700,68.8,315592,62.5,32108,9.2
21123,July 2010,Florida,15004910,9232148,61.5,8223052,54.8,1009096,10.9
21124,July 2010,Georgia,7302572,4677782,64.1,4193763,57.4,484019,10.3
21125,July 2010,Hawaii,1044067,649539,62.2,604352,57.9,45187,7.0
21126,July 2010,Idaho,1166549,761044,65.2,693097,59.4,67947,8.9
21127,July 2010,Illinois,9896037,6618603,66.9,5950375,60.1,668228,10.1
21128,July 2010,Indiana,4970823,3181242,64.0,2854586,57.4,326656,10.3
21129,July 2010,Iowa,2361270,1677463,71.0,1578577,66.9,98886,5.9
21130,July 2010,Kansas,2150414,1500087,69.8,1395787,64.9,104300,7.0
21131,July 2010,Kentucky,3350225,2050339,61.2,1846533,55.1,203806,9.9
21132,July 2010,Louisiana,3444452,2095489,60.8,1927347,56.0,168142,8.0
21133,July 2010,Maine,1074463,694326,64.6,638068,59.4,56258,8.1
21134,July 2010,Maryland,4503575,3079776,68.4,2846212,63.2,233564,7.6
21135,July 2010,Massachusetts,5242479,3479296,66.4,3194060,60.9,285236,8.2
21136,July 2010,Michigan,7720839,4795586,62.1,4203795,54.4,591791,12.3
21137,July 2010,Minnesota,4116249,2939250,71.4,2725306,66.2,213944,7.3
21138,July 2010,Mississippi,2234327,1326439,59.4,1193677,53.4,132762,10.0
21139,July 2010,Missouri,4626941,3057515,66.1,2768607,59.8,288908,9.4
21140,July 2010,Montana,778551,500905,64.3,464705,59.7,36200,7.2
21141,July 2010,Nebraska,1390964,993503,71.4,948377,68.2,45126,4.5
21142,July 2010,Nevada,2077093,1358774,65.4,1174135,56.5,184639,13.6
21143,July 2010,New Hampshire,1053139,737836,70.1,695646,66.1,42190,5.7
21144,July 2010,New Jersey,6882283,4555437,66.2,4128028,60.0,427409,9.4
21145,July 2010,New Mexico,1569553,939503,59.9,861960,54.9,77543,8.3
21146,July 2010,New York,15367003,9609354,62.5,8792951,57.2,816403,8.5
21147,July 2010,North Carolina,7329900,4619653,63.0,4131890,56.4,487763,10.6
21148,July 2010,North Dakota,524469,379228,72.3,365054,69.6,14174,3.7
21149,July 2010,Ohio,8967562,5837074,65.1,5255283,58.6,581791,10.0
21150,July 2010,Oklahoma,2844290,1769672,62.2,1651238,58.1,118434,6.7
21151,July 2010,Oregon,3032106,1984774,65.5,1774965,58.5,209809,10.6
21152,July 2010,Pennsylvania,10069232,6385131,63.4,5852928,58.1,532203,8.3
21153,July 2010,Rhode Island,841783,567869,67.5,503804,59.8,64065,11.3
21154,July 2010,South Carolina,3577650,2155664,60.3,1920713,53.7,234951,10.9
21155,July 2010,South Dakota,617732,441139,71.4,419657,67.9,21482,4.9
21156,July 2010,Tennessee,4931322,3089678,62.7,2804779,56.9,284899,9.2
21157,July 2010,Texas,18621619,12256847,65.8,11274789,60.5,982058,8.0
21158,July 2010,Utah,1960065,1357782,69.3,1250758,63.8,107024,7.9
21159,July 2010,Vermont,506929,359413,70.9,337695,66.6,21718,6.0
21160,July 2010,Virginia,6169407,4166373,67.5,3873305,62.8,293068,7.0
21161,July 2010,Washington,5245237,3510442,66.9,3165672,60.4,344770,9.8
21162,July 2010,West Virginia,1482806,810258,54.6,741281,50.0,68977,8.5
21163,July 2010,Wisconsin,4433833,3079144,69.4,2818271,63.6,260873,8.5
21164,July 2010,Wyoming,433890,303001,69.8,284227,65.5,18774,6.2
21165,August 2010,Alabama,3708627,2211477,59.6,1991908,53.7,219569,9.9
21166,August 2010,Alaska,519973,361986,69.6,333880,64.2,28106,7.8
21167,August 2010,Arizona,4861070,3079408,63.3,2766497,56.9,312911,10.2
21168,August 2010,Arkansas,2238552,1357229,60.6,1246897,55.7,110332,8.1
21169,August 2010,California,28661578,18356485,64.0,16117692,56.2,2238793,12.2
21170,August 2010,Colorado,3867421,2725309,70.5,2484727,64.2,240582,8.8
21171,August 2010,Connecticut,2812802,1917663,68.2,1742854,62.0,174809,9.1
21172,August 2010,Delaware,704232,436206,61.9,399954,56.8,36252,8.3
21173,August 2010,District of Columbia,506174,347239,68.6,315168,62.3,32071,9.2
21174,August 2010,Florida,15028334,9244915,61.5,8229564,54.8,1015351,11.0
21175,August 2010,Georgia,7310344,4684376,64.1,4195887,57.4,488489,10.4
21176,August 2010,Hawaii,1045303,651813,62.4,606417,58.0,45396,7.0
21177,August 2010,Idaho,1167721,760533,65.1,692962,59.3,67571,8.9
21178,August 2010,Illinois,9901875,6609418,66.7,5950971,60.1,658447,10.0
21179,August 2010,Indiana,4974044,3176046,63.9,2854268,57.4,321778,10.1
21180,August 2010,Iowa,2362644,1677309,71.0,1578729,66.8,98580,5.9
21181,August 2010,Kansas,2151699,1499249,69.7,1394978,64.8,104271,7.0
21182,August 2010,Kentucky,3352304,2051438,61.2,1847365,55.1,204073,9.9
21183,August 2010,Louisiana,3447833,2094171,60.7,1923376,55.8,170795,8.2
21184,August 2010,Maine,1074974,694797,64.6,638446,59.4,56351,8.1
21185,August 2010,Maryland,4508717,3082617,68.4,2848902,63.2,233715,7.6
21186,August 2010,Massachusetts,5247552,3476501,66.2,3194536,60.9,281965,8.1
21187,August 2010,Michigan,7724169,4777886,61.9,4197604,54.3,580282,12.1
21188,August 2010,Minnesota,4119619,2940138,71.4,2725971,66.2,214167,7.3
21189,August 2010,Mississippi,2235541,1336789,59.8,1203357,53.8,133432,10.0
21190,August 2010,Missouri,4629304,3056769,66.0,2767659,59.8,289110,9.5
21191,August 2010,Montana,779138,500619,64.3,464543,59.6,36076,7.2
21192,August 2010,Nebraska,1391969,993853,71.4,948999,68.2,44854,4.5
21193,August 2010,Nevada,2078917,1359599,65.4,1174110,56.5,185489,13.6
21194,August 2010,New Hampshire,1053694,737475,70.0,695472,66.0,42003,5.7
21195,August 2010,New Jersey,6887272,4551948,66.1,4124659,59.9,427289,9.4
21196,August 2010,New Mexico,1570872,937851,59.7,860864,54.8,76987,8.2
21197,August 2010,New York,15380202,9593332,62.4,8779428,57.1,813904,8.5
21198,August 2010,North Carolina,7339090,4613366,62.9,4130990,56.3,482376,10.5
21199,August 2010,North Dakota,525299,379763,72.3,365670,69.6,14093,3.7
21200,August 2010,Ohio,8971079,5829341,65.0,5252992,58.6,576349,9.9
21201,August 2010,Oklahoma,2846462,1768714,62.1,1651115,58.0,117599,6.6
21202,August 2010,Oregon,3035088,1986782,65.5,1778138,58.6,208644,10.5
21203,August 2010,Pennsylvania,10074710,6381818,63.3,5854796,58.1,527022,8.3
21204,August 2010,Rhode Island,842004,567424,67.4,503510,59.8,63914,11.3
21205,August 2010,South Carolina,3580891,2155740,60.2,1921853,53.7,233887,10.8
21206,August 2010,South Dakota,618301,441133,71.3,419628,67.9,21505,4.9
21207,August 2010,Tennessee,4935422,3094806,62.7,2809696,56.9,285110,9.2
21208,August 2010,Texas,18653882,12275032,65.8,11290591,60.5,984441,8.0
21209,August 2010,Utah,1963026,1356853,69.1,1250576,63.7,106277,7.8
21210,August 2010,Vermont,507230,359276,70.8,337710,66.6,21566,6.0
21211,August 2010,Virginia,6177335,4168725,67.5,3877131,62.8,291594,7.0
21212,August 2010,Washington,5251066,3505035,66.7,3161962,60.2,343073,9.8
21213,August 2010,West Virginia,1483192,810584,54.7,740714,49.9,69870,8.6
21214,August 2010,Wisconsin,4436413,3077421,69.4,2818765,63.5,258656,8.4
21215,August 2010,Wyoming,434197,303421,69.9,284841,65.6,18580,6.1
21216,September 2010,Alabama,3710521,2212523,59.6,1990948,53.7,221575,10.0
21217,September 2010,Alaska,520750,362510,69.6,334353,64.2,28157,7.8
21218,September 2010,Arizona,4867178,3073232,63.1,2762089,56.7,311143,10.1
21219,September 2010,Arkansas,2240270,1357956,60.6,1246675,55.6,111281,8.2
21220,September 2010,California,28695145,18358124,64.0,16110216,56.1,2247908,12.2
21221,September 2010,Colorado,3872941,2725176,70.4,2483000,64.1,242176,8.9
21222,September 2010,Connecticut,2815062,1918752,68.2,1742905,61.9,175847,9.2
21223,September 2010,Delaware,705028,436872,62.0,400796,56.8,36076,8.3
21224,September 2010,District of Columbia,507310,346809,68.4,314691,62.0,32118,9.3
21225,September 2010,Florida,15051343,9256982,61.5,8235424,54.7,1021558,11.0
21226,September 2010,Georgia,7317750,4691739,64.1,4197433,57.4,494306,10.5
21227,September 2010,Hawaii,1046054,653823,62.5,608354,58.2,45469,7.0
21228,September 2010,Idaho,1168841,760283,65.0,693038,59.3,67245,8.8
21229,September 2010,Illinois,9907277,6603128,66.6,5951512,60.1,651616,9.9
21230,September 2010,Indiana,4977365,3170732,63.7,2853388,57.3,317344,10.0
21231,September 2010,Iowa,2364052,1677717,71.0,1579134,66.8,98583,5.9
21232,September 2010,Kansas,2152770,1498527,69.6,1393989,64.8,104538,7.0
21233,September 2010,Kentucky,3354260,2053705,61.2,1848429,55.1,205276,10.0
21234,September 2010,Louisiana,3451012,2091694,60.6,1918710,55.6,172984,8.3
21235,September 2010,Maine,1075532,695496,64.7,639030,59.4,56466,8.1
21236,September 2010,Maryland,4513675,3085181,68.4,2850945,63.2,234236,7.6
21237,September 2010,Massachusetts,5252661,3474837,66.2,3195212,60.8,279625,8.0
21238,September 2010,Michigan,7727689,4761178,61.6,4190675,54.2,570503,12.0
21239,September 2010,Minnesota,4123086,2941269,71.3,2726480,66.1,214789,7.3
21240,September 2010,Mississippi,2236559,1342025,60.0,1207542,54.0,134483,10.0
21241,September 2010,Missouri,4631561,3056905,66.0,2766458,59.7,290447,9.5
21242,September 2010,Montana,779701,500334,64.2,464216,59.5,36118,7.2
21243,September 2010,Nebraska,1392940,994284,71.4,949521,68.2,44763,4.5
21244,September 2010,Nevada,2080594,1360805,65.4,1174463,56.4,186342,13.7
21245,September 2010,New Hampshire,1054266,737180,69.9,695336,66.0,41844,5.7
21246,September 2010,New Jersey,6892403,4549867,66.0,4121354,59.8,428513,9.4
21247,September 2010,New Mexico,1572096,935844,59.5,859656,54.7,76188,8.1
21248,September 2010,New York,15393723,9577587,62.2,8764345,56.9,813242,8.5
21249,September 2010,North Carolina,7347115,4609741,62.7,4128946,56.2,480795,10.4
21250,September 2010,North Dakota,525997,380374,72.3,366342,69.6,14032,3.7
21251,September 2010,Ohio,8974705,5824295,64.9,5250596,58.5,573699,9.9
21252,September 2010,Oklahoma,2848430,1767697,62.1,1650791,58.0,116906,6.6
21253,September 2010,Oregon,3038142,1989230,65.5,1781560,58.6,207670,10.4
21254,September 2010,Pennsylvania,10080348,6380096,63.3,5855882,58.1,524214,8.2
21255,September 2010,Rhode Island,842205,566704,67.3,503057,59.7,63647,11.2
21256,September 2010,South Carolina,3583866,2156437,60.2,1922440,53.6,233997,10.9
21257,September 2010,South Dakota,618827,441175,71.3,419549,67.8,21626,4.9
21258,September 2010,Tennessee,4939356,3101550,62.8,2813356,57.0,288194,9.3
21259,September 2010,Texas,18685311,12297212,65.8,11306452,60.5,990760,8.1
21260,September 2010,Utah,1965985,1355732,69.0,1250305,63.6,105427,7.8
21261,September 2010,Vermont,507534,359252,70.8,337779,66.6,21473,6.0
21262,September 2010,Virginia,6184015,4171404,67.5,3880460,62.7,290944,7.0
21263,September 2010,Washington,5256484,3499873,66.6,3157493,60.1,342380,9.8
21264,September 2010,West Virginia,1483580,811033,54.7,740150,49.9,70883,8.7
21265,September 2010,Wisconsin,4439062,3076644,69.3,2819440,63.5,257204,8.4
21266,September 2010,Wyoming,434446,303969,70.0,285423,65.7,18546,6.1
21267,October 2010,Alabama,3712613,2215139,59.7,1990369,53.6,224770,10.1
21268,October 2010,Alaska,521699,363144,69.6,334876,64.2,28268,7.8
21269,October 2010,Arizona,4873467,3067756,62.9,2758460,56.6,309296,10.1
21270,October 2010,Arkansas,2242055,1358740,60.6,1246341,55.6,112399,8.3
21271,October 2010,California,28730058,18362121,63.9,16108305,56.1,2253816,12.3
21272,October 2010,Colorado,3878740,2725408,70.3,2482187,64.0,243221,8.9
21273,October 2010,Connecticut,2817337,1919693,68.1,1742799,61.9,176894,9.2
21274,October 2010,Delaware,705851,437508,62.0,401654,56.9,35854,8.2
21275,October 2010,District of Columbia,508433,346825,68.2,314550,61.9,32275,9.3
21276,October 2010,Florida,15075080,9268067,61.5,8244529,54.7,1023538,11.0
21277,October 2010,Georgia,7325909,4698737,64.1,4199836,57.3,498901,10.6
21278,October 2010,Hawaii,1047101,655746,62.6,610345,58.3,45401,6.9
21279,October 2010,Idaho,1170034,760379,65.0,693396,59.3,66983,8.8
21280,October 2010,Illinois,9913186,6598069,66.6,5952925,60.1,645144,9.8
21281,October 2010,Indiana,4980761,3166143,63.6,2853952,57.3,312191,9.9
21282,October 2010,Iowa,2365475,1678395,71.0,1579883,66.8,98512,5.9
21283,October 2010,Kansas,2154013,1498125,69.6,1393254,64.7,104871,7.0
21284,October 2010,Kentucky,3356467,2056574,61.3,1850281,55.1,206293,10.0
21285,October 2010,Louisiana,3454435,2089158,60.5,1914750,55.4,174408,8.3
21286,October 2010,Maine,1076093,696286,64.7,639773,59.5,56513,8.1
21287,October 2010,Maryland,4518913,3087456,68.3,2853374,63.1,234082,7.6
21288,October 2010,Massachusetts,5257855,3474546,66.1,3196849,60.8,277697,8.0
21289,October 2010,Michigan,7731297,4745388,61.4,4185504,54.1,559884,11.8
21290,October 2010,Minnesota,4126600,2942146,71.3,2727688,66.1,214458,7.3
21291,October 2010,Mississippi,2237737,1344535,60.1,1209091,54.0,135444,10.1
21292,October 2010,Missouri,4634080,3057770,66.0,2766309,59.7,291461,9.5
21293,October 2010,Montana,780260,500103,64.1,463831,59.4,36272,7.3
21294,October 2010,Nebraska,1393971,994820,71.4,950047,68.2,44773,4.5
21295,October 2010,Nevada,2082418,1362445,65.4,1175584,56.5,186861,13.7
21296,October 2010,New Hampshire,1054833,736866,69.9,695327,65.9,41539,5.6
21297,October 2010,New Jersey,6897606,4549879,66.0,4119800,59.7,430079,9.5
21298,October 2010,New Mexico,1573410,933963,59.4,858795,54.6,75168,8.0
21299,October 2010,New York,15407452,9563891,62.1,8752287,56.8,811604,8.5
21300,October 2010,North Carolina,7356070,4609416,62.7,4128264,56.1,481152,10.4
21301,October 2010,North Dakota,526786,381116,72.3,367162,69.7,13954,3.7
21302,October 2010,Ohio,8978411,5820234,64.8,5250167,58.5,570067,9.8
21303,October 2010,Oklahoma,2850631,1766887,62.0,1650941,57.9,115946,6.6
21304,October 2010,Oregon,3041215,1991833,65.5,1785539,58.7,206294,10.4
21305,October 2010,Pennsylvania,10086145,6380163,63.3,5858306,58.1,521857,8.2
21306,October 2010,Rhode Island,842456,565780,67.2,502465,59.6,63315,11.2
21307,October 2010,South Carolina,3587338,2157730,60.1,1923333,53.6,234397,10.9
21308,October 2010,South Dakota,619382,441234,71.2,419429,67.7,21805,4.9
21309,October 2010,Tennessee,4943485,3109106,62.9,2816726,57.0,292380,9.4
21310,October 2010,Texas,18717998,12323904,65.8,11326471,60.5,997433,8.1
21311,October 2010,Utah,1968936,1354775,68.8,1250248,63.5,104527,7.7
21312,October 2010,Vermont,507869,359347,70.8,337959,66.5,21388,6.0
21313,October 2010,Virginia,6192002,4175430,67.4,3885597,62.8,289833,6.9
21314,October 2010,Washington,5262315,3494542,66.4,3152803,59.9,341739,9.8
21315,October 2010,West Virginia,1484052,811378,54.7,739783,49.8,71595,8.8
21316,October 2010,Wisconsin,4441788,3076808,69.3,2821200,63.5,255608,8.3
21317,October 2010,Wyoming,434758,304600,70.1,285972,65.8,18628,6.1
21318,November 2010,Alabama,3714051,2217545,59.7,1990270,53.6,227275,10.2
21319,November 2010,Alaska,522712,363800,69.6,335426,64.2,28374,7.8
21320,November 2010,Arizona,4879087,3062664,62.8,2755692,56.5,306972,10.0
21321,November 2010,Arkansas,2243412,1359844,60.6,1246324,55.6,113520,8.3
21322,November 2010,California,28762073,18365212,63.9,16114079,56.0,2251133,12.3
21323,November 2010,Colorado,3884159,2725575,70.2,2482569,63.9,243006,8.9
21324,November 2010,Connecticut,2819214,1920583,68.1,1742922,61.8,177661,9.3
21325,November 2010,Delaware,706571,438229,62.0,402670,57.0,35559,8.1
21326,November 2010,District of Columbia,509441,347414,68.2,314840,61.8,32574,9.4
21327,November 2010,Florida,15096318,9276191,61.4,8257764,54.7,1018427,11.0
21328,November 2010,Georgia,7333173,4704274,64.2,4203785,57.3,500489,10.6
21329,November 2010,Hawaii,1048418,657619,62.7,612429,58.4,45190,6.9
21330,November 2010,Idaho,1171016,760770,65.0,693979,59.3,66791,8.8
21331,November 2010,Illinois,9917512,6591482,66.5,5954456,60.0,637026,9.7
21332,November 2010,Indiana,4983262,3162275,63.5,2856852,57.3,305423,9.7
21333,November 2010,Iowa,2366463,1678737,70.9,1580655,66.8,98082,5.8
21334,November 2010,Kansas,2154940,1497897,69.5,1392963,64.6,104934,7.0
21335,November 2010,Kentucky,3358197,2059204,61.3,1852855,55.2,206349,10.0
21336,November 2010,Louisiana,3457315,2086945,60.4,1912139,55.3,174806,8.4
21337,November 2010,Maine,1076507,697017,64.7,640546,59.5,56471,8.1
21338,November 2010,Maryland,4523502,3089014,68.3,2856294,63.1,232720,7.5
21339,November 2010,Massachusetts,5262136,3474959,66.0,3199393,60.8,275566,7.9
21340,November 2010,Michigan,7733555,4729812,61.2,4183097,54.1,546715,11.6
21341,November 2010,Minnesota,4129339,2942245,71.3,2729932,66.1,212313,7.2
21342,November 2010,Mississippi,2238640,1345482,60.1,1209488,54.0,135994,10.1
21343,November 2010,Missouri,4635854,3058401,66.0,2767747,59.7,290654,9.5
21344,November 2010,Montana,780731,499959,64.0,463507,59.4,36452,7.3
21345,November 2010,Nebraska,1394758,995539,71.4,950702,68.2,44837,4.5
21346,November 2010,Nevada,2084008,1364404,65.5,1177569,56.5,186835,13.7
21347,November 2010,New Hampshire,1055253,736510,69.8,695498,65.9,41012,5.6
21348,November 2010,New Jersey,6901706,4551299,65.9,4120337,59.7,430962,9.5
21349,November 2010,New Mexico,1574561,932509,59.2,858547,54.5,73962,7.9
21350,November 2010,New York,15418635,9551431,61.9,8744834,56.7,806597,8.4
21351,November 2010,North Carolina,7364495,4611258,62.6,4129762,56.1,481496,10.4
21352,November 2010,North Dakota,527483,381964,72.4,368119,69.8,13845,3.6
21353,November 2010,Ohio,8980488,5814602,64.7,5252119,58.5,562483,9.7
21354,November 2010,Oklahoma,2852491,1766457,61.9,1651964,57.9,114493,6.5
21355,November 2010,Oregon,3043797,1994009,65.5,1790046,58.8,203963,10.2
21356,November 2010,Pennsylvania,10089929,6380798,63.2,5862475,58.1,518323,8.1
21357,November 2010,Rhode Island,842553,564740,67.0,501809,59.6,62931,11.1
21358,November 2010,South Carolina,3590386,2159330,60.1,1925054,53.6,234276,10.8
21359,November 2010,South Dakota,619851,441279,71.2,419273,67.6,22006,5.0
21360,November 2010,Tennessee,4946865,3115946,63.0,2820233,57.0,295713,9.5
21361,November 2010,Texas,18748632,12351634,65.9,11350972,60.5,1000662,8.1
21362,November 2010,Utah,1971642,1354026,68.7,1250532,63.4,103494,7.6
21363,November 2010,Vermont,508106,359482,70.7,338211,66.6,21271,5.9
21364,November 2010,Virginia,6199312,4180277,67.4,3892824,62.8,287453,6.9
21365,November 2010,Washington,5267543,3488162,66.2,3148027,59.8,340135,9.8
21366,November 2010,West Virginia,1484202,811476,54.7,739694,49.8,71782,8.8
21367,November 2010,Wisconsin,4443711,3077385,69.3,2824124,63.6,253261,8.2
21368,November 2010,Wyoming,434992,305218,70.2,286461,65.9,18757,6.1
21369,December 2010,Alabama,3715415,2218306,59.7,1990304,53.6,228002,10.3
21370,December 2010,Alaska,523683,364371,69.6,335950,64.2,28421,7.8
21371,December 2010,Arizona,4884498,3057057,62.6,2753511,56.4,303546,9.9
21372,December 2010,Arkansas,2244740,1361151,60.6,1246683,55.5,114468,8.4
21373,December 2010,California,28793006,18364493,63.8,16125892,56.0,2238601,12.2
21374,December 2010,Colorado,3889398,2725739,70.1,2484035,63.9,241704,8.9
21375,December 2010,Connecticut,2820935,1921281,68.1,1743364,61.8,177917,9.3
21376,December 2010,Delaware,707288,439063,62.1,403877,57.1,35186,8.0
21377,December 2010,District of Columbia,510472,348370,68.2,315322,61.8,33048,9.5
21378,December 2010,Florida,15117014,9280528,61.4,8273961,54.7,1006567,10.8
21379,December 2010,Georgia,7340276,4708131,64.1,4209434,57.3,498697,10.6
21380,December 2010,Hawaii,1049654,659367,62.8,614455,58.5,44912,6.8
21381,December 2010,Idaho,1171955,761301,65.0,694664,59.3,66637,8.8
21382,December 2010,Illinois,9921431,6582389,66.3,5954441,60.0,627948,9.5
21383,December 2010,Indiana,4985526,3159427,63.4,2862029,57.4,297398,9.4
21384,December 2010,Iowa,2367337,1678150,70.9,1580931,66.8,97219,5.8
21385,December 2010,Kansas,2155836,1497590,69.5,1393039,64.6,104551,7.0
21386,December 2010,Kentucky,3359814,2060696,61.3,1855585,55.2,205111,10.0
21387,December 2010,Louisiana,3460110,2084897,60.3,1910814,55.2,174083,8.3
21388,December 2010,Maine,1076832,697569,64.8,641170,59.5,56399,8.1
21389,December 2010,Maryland,4527956,3089859,68.2,2859358,63.1,230501,7.5
21390,December 2010,Massachusetts,5266206,3474994,66.0,3202241,60.8,272753,7.8
21391,December 2010,Michigan,7735472,4714537,60.9,4182818,54.1,531719,11.3
21392,December 2010,Minnesota,4131922,2941809,71.2,2733191,66.1,208618,7.1
21393,December 2010,Mississippi,2239433,1345586,60.1,1209414,54.0,136172,10.1
21394,December 2010,Missouri,4637401,3057994,65.9,2770483,59.7,287511,9.4
21395,December 2010,Montana,781156,499925,64.0,463359,59.3,36566,7.3
21396,December 2010,Nebraska,1395498,996477,71.4,951543,68.2,44934,4.5
21397,December 2010,Nevada,2085469,1366432,65.5,1180211,56.6,186221,13.6
21398,December 2010,New Hampshire,1055644,736148,69.7,695820,65.9,40328,5.5
21399,December 2010,New Jersey,6905559,4553174,65.9,4122269,59.7,430905,9.5
21400,December 2010,New Mexico,1575613,931524,59.1,858872,54.5,72652,7.8
21401,December 2010,New York,15429337,9539098,61.8,8740995,56.7,798103,8.4
21402,December 2010,North Carolina,7372663,4613405,62.6,4132989,56.1,480416,10.4
21403,December 2010,North Dakota,528164,382864,72.5,369132,69.9,13732,3.6
21404,December 2010,Ohio,8982276,5806257,64.6,5255372,58.5,550885,9.5
21405,December 2010,Oklahoma,2854173,1766175,61.9,1653805,57.9,112370,6.4
21406,December 2010,Oregon,3046195,1995337,65.5,1794730,58.9,200607,10.1
21407,December 2010,Pennsylvania,10093312,6380401,63.2,5867689,58.1,512712,8.0
21408,December 2010,Rhode Island,842610,563679,66.9,501190,59.5,62489,11.1
21409,December 2010,South Carolina,3593320,2161062,60.1,1927611,53.6,233451,10.8
21410,December 2010,South Dakota,620311,441300,71.1,419108,67.6,22192,5.0
21411,December 2010,Tennessee,4950029,3120787,63.0,2823808,57.0,296979,9.5
21412,December 2010,Texas,18778437,12376187,65.9,11377594,60.6,998593,8.1
21413,December 2010,Utah,1974255,1353411,68.6,1251055,63.4,102356,7.6
21414,December 2010,Vermont,508325,359583,70.7,338459,66.6,21124,5.9
21415,December 2010,Virginia,6206325,4184771,67.4,3900973,62.9,283798,6.8
21416,December 2010,Washington,5272547,3480699,66.0,3143385,59.6,337314,9.7
21417,December 2010,West Virginia,1484302,811158,54.6,739807,49.8,71351,8.8
21418,December 2010,Wisconsin,4445421,3077956,69.2,2827631,63.6,250325,8.1
21419,December 2010,Wyoming,435188,305701,70.2,286854,65.9,18847,6.2
21420,January 2011,Alabama,3716784,2217245,59.7,1990151,53.5,227094,10.2
21421,January 2011,Alaska,524436,364782,69.6,336406,64.1,28376,7.8
21422,January 2011,Arizona,4889838,3051635,62.4,2751937,56.3,299698,9.8
21423,January 2011,Arkansas,2246087,1362117,60.6,1246936,55.5,115181,8.5
21424,January 2011,California,28823709,18363014,63.7,16142515,56.0,2220499,12.1
21425,January 2011,Colorado,3894332,2726142,70.0,2486606,63.9,239536,8.8
21426,January 2011,Connecticut,2822725,1921839,68.1,1744160,61.8,177679,9.2
21427,January 2011,Delaware,707996,439961,62.1,405199,57.2,34762,7.9
21428,January 2011,District of Columbia,511461,349321,68.3,315627,61.7,33694,9.6
21429,January 2011,Florida,15137539,9283526,61.3,8292155,54.8,991371,10.7
21430,January 2011,Georgia,7347250,4711909,64.1,4216993,57.4,494916,10.5
21431,January 2011,Hawaii,1050436,660878,62.9,616210,58.7,44668,6.8
21432,January 2011,Idaho,1172901,761874,65.0,695383,59.3,66491,8.7
21433,January 2011,Illinois,9925670,6573539,66.2,5952822,60.0,620717,9.4
21434,January 2011,Indiana,4987983,3158887,63.3,2869164,57.5,289723,9.2
21435,January 2011,Iowa,2368295,1676439,70.8,1580360,66.7,96079,5.7
21436,January 2011,Kansas,2156493,1497002,69.4,1393260,64.6,103742,6.9
21437,January 2011,Kentucky,3361315,2060919,61.3,1858039,55.3,202880,9.8
21438,January 2011,Louisiana,3462777,2082966,60.2,1910437,55.2,172529,8.3
21439,January 2011,Maine,1077187,697917,64.8,641581,59.6,56336,8.1
21440,January 2011,Maryland,4532283,3090479,68.2,2862249,63.2,228230,7.4
21441,January 2011,Massachusetts,5270441,3474410,65.9,3205064,60.8,269346,7.8
21442,January 2011,Michigan,7737735,4701777,60.8,4183976,54.1,517801,11.0
21443,January 2011,Minnesota,4134606,2941435,71.1,2737393,66.2,204042,6.9
21444,January 2011,Mississippi,2240122,1345507,60.1,1209251,54.0,136256,10.1
21445,January 2011,Missouri,4639042,3057319,65.9,2774185,59.8,283134,9.3
21446,January 2011,Montana,781562,500012,64.0,463453,59.3,36559,7.3
21447,January 2011,Nebraska,1396181,997569,71.4,952553,68.2,45016,4.5
21448,January 2011,Nevada,2086919,1368322,65.6,1183161,56.7,185161,13.5
21449,January 2011,New Hampshire,1056057,735798,69.7,696173,65.9,39625,5.4
21450,January 2011,New Jersey,6909660,4555359,65.9,4125018,59.7,430341,9.4
21451,January 2011,New Mexico,1576602,930931,59.0,859575,54.5,71356,7.7
21452,January 2011,New York,15440492,9528314,61.7,8739920,56.6,788394,8.3
21453,January 2011,North Carolina,7379709,4615841,62.5,4137620,56.1,478221,10.4
21454,January 2011,North Dakota,528769,383753,72.6,370131,70.0,13622,3.5
21455,January 2011,Ohio,8984213,5797017,64.5,5258819,58.5,538198,9.3
21456,January 2011,Oklahoma,2855821,1766062,61.8,1656299,58.0,109763,6.2
21457,January 2011,Oregon,3048702,1995928,65.5,1799192,59.0,196736,9.9
21458,January 2011,Pennsylvania,10097065,6379705,63.2,5873507,58.2,506198,7.9
21459,January 2011,Rhode Island,842674,562727,66.8,500696,59.4,62031,11.0
21460,January 2011,South Carolina,3596172,2163248,60.2,1930858,53.7,232390,10.7
21461,January 2011,South Dakota,620695,441272,71.1,418997,67.5,22275,5.0
21462,January 2011,Tennessee,4953190,3124117,63.1,2827712,57.1,296405,9.5
21463,January 2011,Texas,18807982,12398361,65.9,11405419,60.6,992942,8.0
21464,January 2011,Utah,1976842,1352758,68.4,1251698,63.3,101060,7.5
21465,January 2011,Vermont,508571,359600,70.7,338684,66.6,20916,5.8
21466,January 2011,Virginia,6212242,4188985,67.4,3909237,62.9,279748,6.7
21467,January 2011,Washington,5277156,3473305,65.8,3139432,59.5,333873,9.6
21468,January 2011,West Virginia,1484434,810420,54.6,740067,49.9,70353,8.7
21469,January 2011,Wisconsin,4447227,3078616,69.2,2831223,63.7,247393,8.0
21470,January 2011,Wyoming,435373,305969,70.3,287153,66.0,18816,6.1
21471,February 2011,Alabama,3717718,2214781,59.6,1989525,53.5,225256,10.2
21472,February 2011,Alaska,525051,365003,69.5,336768,64.1,28235,7.7
21473,February 2011,Arizona,4894620,3047219,62.3,2750390,56.2,296829,9.7
21474,February 2011,Arkansas,2247114,1362339,60.6,1246677,55.5,115662,8.5
21475,February 2011,California,28850558,18362012,63.6,16160153,56.0,2201859,12.0
21476,February 2011,Colorado,3898921,2726295,69.9,2489803,63.9,236492,8.7
21477,February 2011,Connecticut,2824144,1921980,68.1,1744996,61.8,176984,9.2
21478,February 2011,Delaware,708598,440818,62.2,406489,57.4,34329,7.8
21479,February 2011,District of Columbia,512423,349978,68.3,315513,61.6,34465,9.8
21480,February 2011,Florida,15155898,9285256,61.3,8308758,54.8,976498,10.5
21481,February 2011,Georgia,7353185,4716445,64.1,4225541,57.5,490904,10.4
21482,February 2011,Hawaii,1050959,661975,63.0,617480,58.8,44495,6.7
21483,February 2011,Idaho,1173694,762426,65.0,696138,59.3,66288,8.7
21484,February 2011,Illinois,9928629,6566762,66.1,5949580,59.9,617182,9.4
21485,February 2011,Indiana,4990032,3160522,63.3,2876584,57.6,283938,9.0
21486,February 2011,Iowa,2368966,1673701,70.7,1578838,66.6,94863,5.7
21487,February 2011,Kansas,2156924,1495829,69.4,1393342,64.6,102487,6.9
21488,February 2011,Kentucky,3362455,2059995,61.3,1859617,55.3,200378,9.7
21489,February 2011,Louisiana,3465131,2080850,60.1,1910324,55.1,170526,8.2
21490,February 2011,Maine,1077435,698122,64.8,641876,59.6,56246,8.1
21491,February 2011,Maryland,4536132,3091021,68.1,2864605,63.2,226416,7.3
21492,February 2011,Massachusetts,5274134,3472847,65.8,3207200,60.8,265647,7.6
21493,February 2011,Michigan,7739227,4691995,60.6,4184968,54.1,507027,10.8
21494,February 2011,Minnesota,4136965,2941838,71.1,2741696,66.3,200142,6.8
21495,February 2011,Mississippi,2240595,1345328,60.0,1209035,54.0,136293,10.1
21496,February 2011,Missouri,4640131,3056187,65.9,2778184,59.9,278003,9.1
21497,February 2011,Montana,781885,500123,64.0,463721,59.3,36402,7.3
21498,February 2011,Nebraska,1396749,998640,71.5,953632,68.3,45008,4.5
21499,February 2011,Nevada,2088143,1369845,65.6,1185981,56.8,183864,13.4
21500,February 2011,New Hampshire,1056336,735494,69.6,696432,65.9,39062,5.3
21501,February 2011,New Jersey,6912964,4557018,65.9,4127495,59.7,429523,9.4
21502,February 2011,New Mexico,1577427,930489,59.0,860328,54.5,70161,7.5
21503,February 2011,New York,15449999,9517986,61.6,8738380,56.6,779606,8.2
21504,February 2011,North Carolina,7385726,4618086,62.5,4142264,56.1,475822,10.3
21505,February 2011,North Dakota,529354,384575,72.6,371059,70.1,13516,3.5
21506,February 2011,Ohio,8985348,5788374,64.4,5260723,58.5,527651,9.1
21507,February 2011,Oklahoma,2857070,1765950,61.8,1658841,58.1,107109,6.1
21508,February 2011,Oregon,3050927,1995957,65.4,1802805,59.1,193152,9.7
21509,February 2011,Pennsylvania,10099767,6379241,63.2,5878342,58.2,500899,7.9
21510,February 2011,Rhode Island,842659,561956,66.7,500342,59.4,61614,11.0
21511,February 2011,South Carolina,3598334,2165830,60.2,1934318,53.8,231512,10.7
21512,February 2011,South Dakota,621085,441179,71.0,418972,67.5,22207,5.0
21513,February 2011,Tennessee,4955846,3126043,63.1,2831472,57.1,294571,9.4
21514,February 2011,Texas,18835184,12418190,65.9,11431874,60.7,986316,7.9
21515,February 2011,Utah,1979356,1351854,68.3,1252350,63.3,99504,7.4
21516,February 2011,Vermont,508727,359462,70.7,338839,66.6,20623,5.7
21517,February 2011,Virginia,6217482,4192419,67.4,3916211,63.0,276208,6.6
21518,February 2011,Washington,5281305,3466972,65.6,3136312,59.4,330660,9.5
21519,February 2011,West Virginia,1484419,809255,54.5,740310,49.9,68945,8.5
21520,February 2011,Wisconsin,4448703,3079198,69.2,2834085,63.7,245113,8.0
21521,February 2011,Wyoming,435554,306064,70.3,287421,66.0,18643,6.1
21522,March 2011,Alabama,3718774,2211546,59.5,1988337,53.5,223209,10.1
21523,March 2011,Alaska,526010,365077,69.4,337045,64.1,28032,7.7
21524,March 2011,Arizona,4899468,3043638,62.1,2748304,56.1,295334,9.7
21525,March 2011,Arkansas,2248259,1361797,60.6,1245986,55.4,115811,8.5
21526,March 2011,California,28877787,18360392,63.6,16174823,56.0,2185569,11.9
21527,March 2011,Colorado,3903863,2725870,69.8,2492959,63.9,232911,8.5
21528,March 2011,Connecticut,2825589,1921262,68.0,1745441,61.8,175821,9.2
21529,March 2011,Delaware,709211,441523,62.3,407596,57.5,33927,7.7
21530,March 2011,District of Columbia,513387,350284,68.2,315013,61.4,35271,10.1
21531,March 2011,Florida,15174529,9284110,61.2,8320238,54.8,963872,10.4
21532,March 2011,Georgia,7359821,4721391,64.2,4233713,57.5,487678,10.3
21533,March 2011,Hawaii,1052020,662537,63.0,618118,58.8,44419,6.7
21534,March 2011,Idaho,1174556,762885,65.0,696898,59.3,65987,8.6
21535,March 2011,Illinois,9931775,6562927,66.1,5944798,59.9,618129,9.4
21536,March 2011,Indiana,4992007,3163109,63.4,2882053,57.7,281056,8.9
21537,March 2011,Iowa,2369687,1670235,70.5,1576542,66.5,93693,5.6
21538,March 2011,Kansas,2157624,1494025,69.2,1393176,64.6,100849,6.8
21539,March 2011,Kentucky,3363887,2058006,61.2,1859950,55.3,198056,9.6
21540,March 2011,Louisiana,3467617,2078080,59.9,1909919,55.1,168161,8.1
21541,March 2011,Maine,1077683,698290,64.8,642192,59.6,56098,8.0
21542,March 2011,Maryland,4540133,3091247,68.1,2866135,63.1,225112,7.3
21543,March 2011,Massachusetts,5277824,3470079,65.7,3208279,60.8,261800,7.5
21544,March 2011,Michigan,7740562,4684462,60.5,4184534,54.1,499928,10.7
21545,March 2011,Minnesota,4139314,2943124,71.1,2745212,66.3,197912,6.7
21546,March 2011,Mississippi,2241192,1344971,60.0,1208728,53.9,136243,10.1
21547,March 2011,Missouri,4641452,3054008,65.8,2781464,59.9,272544,8.9
21548,March 2011,Montana,782250,500168,63.9,464042,59.3,36126,7.2
21549,March 2011,Nebraska,1397392,999604,71.5,954698,68.3,44906,4.5
21550,March 2011,Nevada,2089419,1370856,65.6,1188271,56.9,182585,13.3
21551,March 2011,New Hampshire,1056652,735262,69.6,696494,65.9,38768,5.3
21552,March 2011,New Jersey,6916107,4557107,65.9,4128833,59.7,428274,9.4
21553,March 2011,New Mexico,1578231,930022,58.9,860844,54.5,69178,7.4
21554,March 2011,New York,15459037,9506231,61.5,8733288,56.5,772943,8.1
21555,March 2011,North Carolina,7393058,4619330,62.5,4145282,56.1,474048,10.3
21556,March 2011,North Dakota,529988,385333,72.7,371889,70.2,13444,3.5
21557,March 2011,Ohio,8986497,5781009,64.3,5259952,58.5,521057,9.0
21558,March 2011,Oklahoma,2858565,1765628,61.8,1660769,58.1,104859,5.9
21559,March 2011,Oregon,3053077,1995613,65.4,1805065,59.1,190548,9.5
21560,March 2011,Pennsylvania,10102380,6378192,63.1,5880105,58.2,498087,7.8
21561,March 2011,Rhode Island,842647,561290,66.6,500025,59.3,61265,10.9
21562,March 2011,South Carolina,3601100,2168282,60.2,1937403,53.8,230879,10.6
21563,March 2011,South Dakota,621484,441026,71.0,419051,67.4,21975,5.0
21564,March 2011,Tennessee,4958720,3126059,63.0,2834304,57.2,291755,9.3
21565,March 2011,Texas,18862867,12434400,65.9,11453932,60.7,980468,7.9
21566,March 2011,Utah,1981925,1350661,68.1,1252983,63.2,97678,7.2
21567,March 2011,Vermont,508907,359114,70.6,338856,66.6,20258,5.6
21568,March 2011,Virginia,6224329,4194471,67.4,3920687,63.0,273784,6.5
21569,March 2011,Washington,5285924,3462169,65.5,3134099,59.3,328070,9.5
21570,March 2011,West Virginia,1484422,807674,54.4,740350,49.9,67324,8.3
21571,March 2011,Wisconsin,4450156,3079171,69.2,2835621,63.7,243550,7.9
21572,March 2011,Wyoming,435752,306066,70.2,287721,66.0,18345,6.0
21573,April 2011,Alabama,3719975,2208494,59.4,1986912,53.4,221582,10.0
21574,April 2011,Alaska,526679,365121,69.3,337303,64.0,27818,7.6
21575,April 2011,Arizona,4904551,3040387,62.0,2745380,56.0,295007,9.7
21576,April 2011,Arkansas,2249499,1360729,60.5,1245118,55.4,115611,8.5
21577,April 2011,California,28906296,18360297,63.5,16185015,56.0,2175282,11.8
21578,April 2011,Colorado,3908660,2725243,69.7,2495652,63.8,229591,8.4
21579,April 2011,Connecticut,2827216,1919579,67.9,1745305,61.7,174274,9.1
21580,April 2011,Delaware,709841,442053,62.3,408447,57.5,33606,7.6
21581,April 2011,District of Columbia,514373,350390,68.1,314391,61.1,35999,10.3
21582,April 2011,Florida,15193787,9280607,61.1,8325905,54.8,954702,10.3
21583,April 2011,Georgia,7366241,4727041,64.2,4240677,57.6,486364,10.3
21584,April 2011,Hawaii,1052581,662598,62.9,618126,58.7,44472,6.7
21585,April 2011,Idaho,1175484,763277,64.9,697709,59.4,65568,8.6
21586,April 2011,Illinois,9935578,6563289,66.1,5938760,59.8,624529,9.5
21587,April 2011,Indiana,4994501,3166405,63.4,2884769,57.8,281636,8.9
21588,April 2011,Iowa,2370575,1666505,70.3,1573767,66.4,92738,5.6
21589,April 2011,Kansas,2158201,1491929,69.1,1392856,64.5,99073,6.6
21590,April 2011,Kentucky,3365283,2055557,61.1,1859186,55.2,196371,9.6
21591,April 2011,Louisiana,3470151,2074660,59.8,1909053,55.0,165607,8.0
21592,April 2011,Maine,1078026,698498,64.8,642590,59.6,55908,8.0
21593,April 2011,Maryland,4544189,3091373,68.0,2866735,63.1,224638,7.3
21594,April 2011,Massachusetts,5281958,3466650,65.6,3208436,60.7,258214,7.4
21595,April 2011,Michigan,7742631,4679264,60.4,4182433,54.0,496831,10.6
21596,April 2011,Minnesota,4142031,2945087,71.1,2747838,66.3,197249,6.7
21597,April 2011,Mississippi,2241793,1344614,60.0,1208346,53.9,136268,10.1
21598,April 2011,Missouri,4642924,3050784,65.7,2783078,59.9,267706,8.8
21599,April 2011,Montana,782642,500186,63.9,464387,59.3,35799,7.2
21600,April 2011,Nebraska,1398062,1000483,71.6,955737,68.4,44746,4.5
21601,April 2011,Nevada,2090762,1371469,65.6,1189900,56.9,181569,13.2
21602,April 2011,New Hampshire,1057023,735163,69.6,696357,65.9,38806,5.3
21603,April 2011,New Jersey,6919912,4556028,65.8,4128987,59.7,427041,9.4
21604,April 2011,New Mexico,1579053,929680,58.9,861100,54.5,68580,7.4
21605,April 2011,New York,15469564,9493559,61.4,8723458,56.4,770101,8.1
21606,April 2011,North Carolina,7399475,4620259,62.4,4145987,56.0,474272,10.3
21607,April 2011,North Dakota,530586,386114,72.8,372677,70.2,13437,3.5
21608,April 2011,Ohio,8988405,5775861,64.3,5256742,58.5,519119,9.0
21609,April 2011,Oklahoma,2860029,1765413,61.7,1662020,58.1,103393,5.9
21610,April 2011,Oregon,3055525,1995145,65.3,1805872,59.1,189273,9.5
21611,April 2011,Pennsylvania,10105922,6377273,63.1,5878324,58.2,498949,7.8
21612,April 2011,Rhode Island,842696,560646,66.5,499638,59.3,61008,10.9
21613,April 2011,South Carolina,3603527,2170590,60.2,1939862,53.8,230728,10.6
21614,April 2011,South Dakota,621907,440858,70.9,419228,67.4,21630,4.9
21615,April 2011,Tennessee,4961747,3124545,63.0,2835688,57.2,288857,9.2
21616,April 2011,Texas,18891059,12448436,65.9,11470598,60.7,977838,7.9
21617,April 2011,Utah,1984621,1349388,68.0,1253673,63.2,95715,7.1
21618,April 2011,Vermont,509131,358632,70.4,338757,66.5,19875,5.5
21619,April 2011,Virginia,6229783,4195672,67.3,3922364,63.0,273308,6.5
21620,April 2011,Washington,5290299,3458969,65.4,3132796,59.2,326173,9.4
21621,April 2011,West Virginia,1484535,805973,54.3,740138,49.9,65835,8.2
21622,April 2011,Wisconsin,4452005,3078538,69.1,2835798,63.7,242740,7.9
21623,April 2011,Wyoming,435937,306051,70.2,288070,66.1,17981,5.9
21624,May 2011,Alabama,3721250,2206536,59.3,1985926,53.4,220610,10.0
21625,May 2011,Alaska,527429,365247,69.3,337610,64.0,27637,7.6
21626,May 2011,Arizona,4909719,3037670,61.9,2742239,55.9,295431,9.7
21627,May 2011,Arkansas,2250826,1359781,60.4,1244596,55.3,115185,8.5
21628,May 2011,California,28935106,18367442,63.5,16194332,56.0,2173110,11.8
21629,May 2011,Colorado,3913707,2725485,69.6,2498260,63.8,227225,8.3
21630,May 2011,Connecticut,2828980,1917323,67.8,1744842,61.7,172481,9.0
21631,May 2011,Delaware,710507,442477,62.3,409083,57.6,33394,7.5
21632,May 2011,District of Columbia,515354,350399,68.0,313874,60.9,36525,10.4
21633,May 2011,Florida,15213572,9278592,61.0,8329364,54.7,949228,10.2
21634,May 2011,Georgia,7373100,4734686,64.2,4246820,57.6,487866,10.3
21635,May 2011,Hawaii,1053309,662280,62.9,617623,58.6,44657,6.7
21636,May 2011,Idaho,1176497,763681,64.9,698664,59.4,65017,8.5
21637,May 2011,Illinois,9939744,6569329,66.1,5933281,59.7,636048,9.7
21638,May 2011,Indiana,4997112,3171288,63.5,2885793,57.7,285495,9.0
21639,May 2011,Iowa,2371629,1663044,70.1,1570898,66.2,92146,5.5
21640,May 2011,Kansas,2158963,1490149,69.0,1392637,64.5,97512,6.5
21641,May 2011,Kentucky,3366941,2053682,61.0,1858070,55.2,195612,9.5
21642,May 2011,Louisiana,3472765,2071476,59.6,1908068,54.9,163408,7.9
21643,May 2011,Maine,1078440,698778,64.8,643077,59.6,55701,8.0
21644,May 2011,Maryland,4548302,3092081,68.0,2866875,63.0,225206,7.3
21645,May 2011,Massachusetts,5286290,3463870,65.5,3208618,60.7,255252,7.4
21646,May 2011,Michigan,7744882,4677237,60.4,4180118,54.0,497119,10.6
21647,May 2011,Minnesota,4144900,2947426,71.1,2749971,66.3,197455,6.7
21648,May 2011,Mississippi,2242446,1344472,60.0,1208033,53.9,136439,10.1
21649,May 2011,Missouri,4644701,3047588,65.6,2783392,59.9,264196,8.7
21650,May 2011,Montana,783050,500285,63.9,464791,59.4,35494,7.1
21651,May 2011,Nebraska,1398820,1001361,71.6,956782,68.4,44579,4.5
21652,May 2011,Nevada,2092093,1371958,65.6,1191123,56.9,180835,13.2
21653,May 2011,New Hampshire,1057484,735239,69.5,696096,65.8,39143,5.3
21654,May 2011,New Jersey,6923769,4555600,65.8,4129075,59.6,426525,9.4
21655,May 2011,New Mexico,1579914,929629,58.8,861139,54.5,68490,7.4
21656,May 2011,New York,15480168,9483635,61.3,8711503,56.3,772132,8.1
21657,May 2011,North Carolina,7406586,4622639,62.4,4145350,56.0,477289,10.3
21658,May 2011,North Dakota,531241,386995,72.8,373491,70.3,13504,3.5
21659,May 2011,Ohio,8990592,5774028,64.2,5252741,58.4,521287,9.0
21660,May 2011,Oklahoma,2861716,1765957,61.7,1663035,58.1,102922,5.8
21661,May 2011,Oregon,3058131,1994847,65.2,1805535,59.0,189312,9.5
21662,May 2011,Pennsylvania,10109768,6378414,63.1,5874930,58.1,503484,7.9
21663,May 2011,Rhode Island,842766,560052,66.5,499151,59.2,60901,10.9
21664,May 2011,South Carolina,3606297,2173259,60.3,1941840,53.8,231419,10.6
21665,May 2011,South Dakota,622337,440727,70.8,419481,67.4,21246,4.8
21666,May 2011,Tennessee,4964917,3123126,62.9,2836330,57.1,286796,9.2
21667,May 2011,Texas,18919706,12464746,65.9,11484860,60.7,979886,7.9
21668,May 2011,Utah,1987400,1348372,67.8,1254595,63.1,93777,7.0
21669,May 2011,Vermont,509379,358156,70.3,338583,66.5,19573,5.5
21670,May 2011,Virginia,6235868,4197759,67.3,3922591,62.9,275168,6.6
21671,May 2011,Washington,5295062,3457455,65.3,3132444,59.2,325011,9.4
21672,May 2011,West Virginia,1484746,804653,54.2,739845,49.8,64808,8.1
21673,May 2011,Wisconsin,4454070,3078037,69.1,2835461,63.7,242576,7.9
21674,May 2011,Wyoming,436173,306102,70.2,288452,66.1,17650,5.8
21675,June 2011,Alabama,3722566,2205399,59.2,1985894,53.3,219505,10.0
21676,June 2011,Alaska,528408,365500,69.2,337993,64.0,27507,7.5
21677,June 2011,Arizona,4915042,3035585,61.8,2740189,55.8,295396,9.7
21678,June 2011,Arkansas,2252173,1359520,60.4,1244978,55.3,114542,8.4
21679,June 2011,California,28965185,18383605,63.5,16209240,56.0,2174365,11.8
21680,June 2011,Colorado,3919027,2727538,69.6,2501595,63.8,225943,8.3
21681,June 2011,Connecticut,2830767,1915006,67.6,1744519,61.6,170487,8.9
21682,June 2011,Delaware,711187,442907,62.3,409638,57.6,33269,7.5
21683,June 2011,District of Columbia,516355,350403,67.9,313644,60.7,36759,10.5
21684,June 2011,Florida,15233780,9280695,60.9,8336498,54.7,944197,10.2
21685,June 2011,Georgia,7380378,4744120,64.3,4253512,57.6,490608,10.3
21686,June 2011,Hawaii,1054458,661708,62.8,616779,58.5,44929,6.8
21687,June 2011,Idaho,1177493,764152,64.9,699823,59.4,64329,8.4
21688,June 2011,Illinois,9944023,6579893,66.2,5930717,59.6,649176,9.9
21689,June 2011,Indiana,4999579,3177867,63.6,2886780,57.7,291087,9.2
21690,June 2011,Iowa,2372613,1660285,70.0,1568386,66.1,91899,5.5
21691,June 2011,Kansas,2159898,1489125,68.9,1392802,64.5,96323,6.5
21692,June 2011,Kentucky,3368676,2052956,60.9,1857634,55.1,195322,9.5
21693,June 2011,Louisiana,3475492,2069314,59.5,1907671,54.9,161643,7.8
21694,June 2011,Maine,1078840,699095,64.8,643643,59.7,55452,7.9
21695,June 2011,Maryland,4552581,3093578,68.0,2867381,63.0,226197,7.3
21696,June 2011,Massachusetts,5290539,3462711,65.5,3210071,60.7,252640,7.3
21697,June 2011,Michigan,7746918,4678195,60.4,4180411,54.0,497784,10.6
21698,June 2011,Minnesota,4147758,2949387,71.1,2752143,66.4,197244,6.7
21699,June 2011,Mississippi,2243206,1344528,59.9,1207954,53.8,136574,10.2
21700,June 2011,Missouri,4646570,3045445,65.5,2783829,59.9,261616,8.6
21701,June 2011,Montana,783520,500562,63.9,465336,59.4,35226,7.0
21702,June 2011,Nebraska,1399623,1002264,71.6,957893,68.4,44371,4.4
21703,June 2011,Nevada,2093556,1372579,65.6,1192333,57.0,180246,13.1
21704,June 2011,New Hampshire,1057890,735486,69.5,695842,65.8,39644,5.4
21705,June 2011,New Jersey,6927579,4557176,65.8,4130621,59.6,426555,9.4
21706,June 2011,New Mexico,1580922,929808,58.8,860961,54.5,68847,7.4
21707,June 2011,New York,15490639,9480227,61.2,8702587,56.2,777640,8.2
21708,June 2011,North Carolina,7414555,4626858,62.4,4145399,55.9,481459,10.4
21709,June 2011,North Dakota,531942,387988,72.9,374372,70.4,13616,3.5
21710,June 2011,Ohio,8992582,5774385,64.2,5250245,58.4,524140,9.1
21711,June 2011,Oklahoma,2863540,1767483,61.7,1664294,58.1,103189,5.8
21712,June 2011,Oregon,3060624,1994642,65.2,1804653,59.0,189989,9.5
21713,June 2011,Pennsylvania,10113403,6382416,63.1,5872911,58.1,509505,8.0
21714,June 2011,Rhode Island,842836,559558,66.4,498569,59.2,60989,10.9
21715,June 2011,South Carolina,3609414,2176264,60.3,1943742,53.9,232522,10.7
21716,June 2011,South Dakota,622796,440642,70.8,419761,67.4,20881,4.7
21717,June 2011,Tennessee,4968179,3122863,62.9,2837671,57.1,285192,9.1
21718,June 2011,Texas,18949279,12485494,65.9,11501815,60.7,983679,7.9
21719,June 2011,Utah,1990200,1347853,67.7,1255940,63.1,91913,6.8
21720,June 2011,Vermont,509611,357806,70.2,338394,66.4,19412,5.4
21721,June 2011,Virginia,6242929,4202228,67.3,3923950,62.9,278278,6.6
21722,June 2011,Washington,5300194,3457160,65.2,3133149,59.1,324011,9.4
21723,June 2011,West Virginia,1484907,804111,54.2,739808,49.8,64303,8.0
21724,June 2011,Wisconsin,4456019,3078180,69.1,2835790,63.6,242390,7.9
21725,June 2011,Wyoming,436382,306270,70.2,288849,66.2,17421,5.7
21726,July 2011,Alabama,3724246,2204490,59.2,1987195,53.4,217295,9.9
21727,July 2011,Alaska,529277,365887,69.1,338432,63.9,27455,7.5
21728,July 2011,Arizona,4920810,3034074,61.7,2740390,55.7,293684,9.7
21729,July 2011,Arkansas,2253736,1360317,60.4,1246599,55.3,113718,8.4
21730,July 2011,California,28996653,18407886,63.5,16235500,56.0,2172386,11.8
21731,July 2011,Colorado,3924566,2731838,69.6,2506281,63.9,225557,8.3
21732,July 2011,Connecticut,2832753,1913148,67.5,1744791,61.6,168357,8.8
21733,July 2011,Delaware,711893,443436,62.3,410268,57.6,33168,7.5
21734,July 2011,District of Columbia,517387,350477,67.7,313785,60.6,36692,10.5
21735,July 2011,Florida,15255374,9288470,60.9,8352288,54.7,936182,10.1
21736,July 2011,Georgia,7387369,4754219,64.4,4262111,57.7,492108,10.4
21737,July 2011,Hawaii,1055415,661013,62.6,615789,58.3,45224,6.8
21738,July 2011,Idaho,1178608,764838,64.9,701287,59.5,63551,8.3
21739,July 2011,Illinois,9948961,6592480,66.3,5932875,59.6,659605,10.0
21740,July 2011,Indiana,5002695,3185643,63.7,2889288,57.8,296355,9.3
21741,July 2011,Iowa,2373889,1658330,69.9,1566490,66.0,91840,5.5
21742,July 2011,Kansas,2160945,1488961,68.9,1393396,64.5,95565,6.4
21743,July 2011,Kentucky,3370648,2053577,60.9,1858686,55.1,194891,9.5
21744,July 2011,Louisiana,3478533,2068547,59.5,1908367,54.9,160180,7.7
21745,July 2011,Maine,1079314,699417,64.8,644275,59.7,55142,7.9
21746,July 2011,Maryland,4557297,3095695,67.9,2869031,63.0,226664,7.3
21747,July 2011,Massachusetts,5295412,3463633,65.4,3213681,60.7,249952,7.2
21748,July 2011,Michigan,7749945,4681303,60.4,4185550,54.0,495753,10.6
21749,July 2011,Minnesota,4151066,2950563,71.1,2755094,66.4,195469,6.6
21750,July 2011,Mississippi,2244105,1344424,59.9,1208189,53.8,136235,10.1
21751,July 2011,Missouri,4648586,3044731,65.5,2785616,59.9,259115,8.5
21752,July 2011,Montana,784041,501016,63.9,466076,59.4,34940,7.0
21753,July 2011,Nebraska,1400539,1003308,71.6,959144,68.5,44164,4.4
21754,July 2011,Nevada,2095191,1373493,65.6,1193897,57.0,179596,13.1
21755,July 2011,New Hampshire,1058427,735882,69.5,695758,65.7,40124,5.5
21756,July 2011,New Jersey,6932150,4561230,65.8,4134490,59.6,426740,9.4
21757,July 2011,New Mexico,1581988,930174,58.8,860671,54.4,69503,7.5
21758,July 2011,New York,15502829,9486165,61.2,8701473,56.1,784692,8.3
21759,July 2011,North Carolina,7422523,4632545,62.4,4148330,55.9,484215,10.5
21760,July 2011,North Dakota,532662,389060,73.0,375345,70.5,13715,3.5
21761,July 2011,Ohio,8995704,5775030,64.2,5251205,58.4,523825,9.1
21762,July 2011,Oklahoma,2865340,1770025,61.8,1666276,58.2,103749,5.9
21763,July 2011,Oregon,3063488,1994457,65.1,1804031,58.9,190426,9.5
21764,July 2011,Pennsylvania,10118299,6389493,63.1,5875164,58.1,514329,8.0
21765,July 2011,Rhode Island,843003,559187,66.3,497918,59.1,61269,11.0
21766,July 2011,South Carolina,3612064,2179012,60.3,1945895,53.9,233117,10.7
21767,July 2011,South Dakota,623313,440627,70.7,420059,67.4,20568,4.7
21768,July 2011,Tennessee,4971962,3124288,62.8,2841152,57.1,283136,9.1
21769,July 2011,Texas,18979835,12510889,65.9,11526050,60.7,984839,7.9
21770,July 2011,Utah,1993202,1347981,67.6,1257868,63.1,90113,6.7
21771,July 2011,Vermont,509893,357628,70.1,338273,66.3,19355,5.4
21772,July 2011,Virginia,6250073,4209618,67.4,3928498,62.9,281120,6.7
21773,July 2011,Washington,5305631,3457441,65.2,3134999,59.1,322442,9.3
21774,July 2011,West Virginia,1485242,804494,54.2,740334,49.8,64160,8.0
21775,July 2011,Wisconsin,4458458,3079161,69.1,2837754,63.6,241407,7.8
21776,July 2011,Wyoming,436652,306582,70.2,289259,66.2,17323,5.7
21777,August 2011,Alabama,3726080,2202706,59.1,1989639,53.4,213067,9.7
21778,August 2011,Alaska,529928,366325,69.1,338848,63.9,27477,7.5
21779,August 2011,Arizona,4927914,3032960,61.5,2742980,55.7,289980,9.6
21780,August 2011,Arkansas,2254782,1361993,60.4,1249276,55.4,112717,8.3
21781,August 2011,California,29030413,18436089,63.5,16272656,56.1,2163433,11.7
21782,August 2011,Colorado,3930471,2737851,69.7,2512064,63.9,225787,8.2
21783,August 2011,Connecticut,2834319,1911831,67.5,1745675,61.6,166156,8.7
21784,August 2011,Delaware,712654,444069,62.3,411041,57.7,33028,7.4
21785,August 2011,District of Columbia,518371,350648,67.6,314255,60.6,36393,10.4
21786,August 2011,Florida,15275991,9300806,60.9,8376656,54.8,924150,9.9
21787,August 2011,Georgia,7396168,4763808,64.4,4272812,57.8,490996,10.3
21788,August 2011,Hawaii,1056425,660222,62.5,614761,58.2,45461,6.9
21789,August 2011,Idaho,1179827,765743,64.9,703015,59.6,62728,8.2
21790,August 2011,Illinois,9952852,6603943,66.4,5939511,59.7,664432,10.1
21791,August 2011,Indiana,5005211,3193257,63.8,2893693,57.8,299564,9.4
21792,August 2011,Iowa,2375161,1657051,69.8,1565320,65.9,91731,5.5
21793,August 2011,Kansas,2162346,1489304,68.9,1394198,64.5,95106,6.4
21794,August 2011,Kentucky,3372153,2055093,60.9,1861265,55.2,193828,9.4
21795,August 2011,Louisiana,3480892,2068989,59.4,1909945,54.9,159044,7.7
21796,August 2011,Maine,1079618,699732,64.8,644926,59.7,54806,7.8
21797,August 2011,Maryland,4561790,3098139,67.9,2871972,63.0,226167,7.3
21798,August 2011,Massachusetts,5300267,3466253,65.4,3219111,60.7,247142,7.1
21799,August 2011,Michigan,7753154,4685085,60.4,4195308,54.1,489777,10.5
21800,August 2011,Minnesota,4154153,2950646,71.0,2758898,66.4,191748,6.5
21801,August 2011,Mississippi,2244977,1343978,59.9,1208627,53.8,135351,10.1
21802,August 2011,Missouri,4650431,3044873,65.5,2789075,60.0,255798,8.4
21803,August 2011,Montana,784669,501574,63.9,467018,59.5,34556,6.9
21804,August 2011,Nebraska,1401626,1004521,71.7,960555,68.5,43966,4.4
21805,August 2011,Nevada,2098385,1374552,65.5,1195921,57.0,178631,13.0
21806,August 2011,New Hampshire,1059115,736403,69.5,695970,65.7,40433,5.5
21807,August 2011,New Jersey,6936623,4566927,65.8,4140177,59.7,426750,9.3
21808,August 2011,New Mexico,1582897,930567,58.8,860318,54.4,70249,7.5
21809,August 2011,New York,15512956,9500945,61.2,8708594,56.1,792351,8.3
21810,August 2011,North Carolina,7430833,4638876,62.4,4154816,55.9,484060,10.4
21811,August 2011,North Dakota,533680,390144,73.1,376405,70.5,13739,3.5
21812,August 2011,Ohio,8998118,5773898,64.2,5255540,58.4,518358,9.0
21813,August 2011,Oklahoma,2867765,1773419,61.8,1669161,58.2,104258,5.9
21814,August 2011,Oregon,3066268,1994112,65.0,1803997,58.8,190115,9.5
21815,August 2011,Pennsylvania,10122224,6398775,63.2,5882243,58.1,516532,8.1
21816,August 2011,Rhode Island,843352,558961,66.3,497262,59.0,61699,11.0
21817,August 2011,South Carolina,3615827,2180986,60.3,1948447,53.9,232539,10.7
21818,August 2011,South Dakota,623996,440691,70.6,420389,67.4,20302,4.6
21819,August 2011,Tennessee,4976357,3126729,62.8,2846814,57.2,279915,9.0
21820,August 2011,Texas,19011137,12538173,66.0,11557468,60.8,980705,7.8
21821,August 2011,Utah,1996074,1348691,67.6,1260385,63.1,88306,6.5
21822,August 2011,Vermont,509978,357560,70.1,338229,66.3,19331,5.4
21823,August 2011,Virginia,6257171,4218678,67.4,3936029,62.9,282649,6.7
21824,August 2011,Washington,5312185,3458076,65.1,3138052,59.1,320024,9.3
21825,August 2011,West Virginia,1485418,805556,54.2,741468,49.9,64088,8.0
21826,August 2011,Wisconsin,4460583,3080439,69.1,2841227,63.7,239212,7.8
21827,August 2011,Wyoming,437320,307001,70.2,289658,66.2,17343,5.6
21828,September 2011,Alabama,3728132,2198917,59.0,1992593,53.4,206324,9.4
21829,September 2011,Alaska,530499,366676,69.1,339160,63.9,27516,7.5
21830,September 2011,Arizona,4935290,3032042,61.4,2747441,55.7,284601,9.4
21831,September 2011,Arkansas,2255945,1363951,60.5,1252523,55.5,111428,8.2
21832,September 2011,California,29065497,18461927,63.5,16316061,56.1,2145866,11.6
21833,September 2011,Colorado,3936483,2744437,69.7,2518200,64.0,226237,8.2
21834,September 2011,Connecticut,2836009,1910755,67.4,1746903,61.6,163852,8.6
21835,September 2011,Delaware,713481,444727,62.3,411921,57.7,32806,7.4
21836,September 2011,District of Columbia,519341,350898,67.6,314926,60.6,35972,10.3
21837,September 2011,Florida,15297303,9314616,60.9,8406567,55.0,908049,9.7
21838,September 2011,Georgia,7405158,4771878,64.4,4284901,57.9,486977,10.2
21839,September 2011,Hawaii,1057156,659208,62.4,613689,58.1,45519,6.9
21840,September 2011,Idaho,1181155,766702,64.9,704790,59.7,61912,8.1
21841,September 2011,Illinois,9957437,6610989,66.4,5949295,59.7,661694,10.0
21842,September 2011,Indiana,5008071,3199028,63.9,2899629,57.9,299399,9.4
21843,September 2011,Iowa,2376645,1656336,69.7,1564954,65.8,91382,5.5
21844,September 2011,Kansas,2163709,1489593,68.8,1395030,64.5,94563,6.3
21845,September 2011,Kentucky,3373718,2056518,61.0,1864979,55.3,191539,9.3
21846,September 2011,Louisiana,3483389,2069983,59.4,1911840,54.9,158143,7.6
21847,September 2011,Maine,1080004,700037,64.8,645554,59.8,54483,7.8
21848,September 2011,Maryland,4566435,3100657,67.9,2875949,63.0,224708,7.2
21849,September 2011,Massachusetts,5305462,3469527,65.4,3225301,60.8,244226,7.0
21850,September 2011,Michigan,7756910,4687766,60.4,4207816,54.2,479950,10.2
21851,September 2011,Minnesota,4157502,2949489,70.9,2762924,66.5,186565,6.3
21852,September 2011,Mississippi,2245883,1343207,59.8,1209232,53.8,133975,10.0
21853,September 2011,Missouri,4652562,3044857,65.4,2794010,60.1,250847,8.2
21854,September 2011,Montana,785309,502148,63.9,468110,59.6,34038,6.8
21855,September 2011,Nebraska,1402775,1005810,71.7,962115,68.6,43695,4.3
21856,September 2011,Nevada,2101624,1375393,65.4,1198323,57.0,177070,12.9
21857,September 2011,New Hampshire,1059870,737009,69.5,696479,65.7,40530,5.5
21858,September 2011,New Jersey,6941606,4572793,65.9,4146653,59.7,426140,9.3
21859,September 2011,New Mexico,1583840,930760,58.8,859914,54.3,70846,7.6
21860,September 2011,New York,15524170,9521336,61.3,8721554,56.2,799782,8.4
21861,September 2011,North Carolina,7438820,4644899,62.4,4164506,56.0,480393,10.3
21862,September 2011,North Dakota,534660,391160,73.2,377505,70.6,13655,3.5
21863,September 2011,Ohio,9001123,5769214,64.1,5261969,58.5,507245,8.8
21864,September 2011,Oklahoma,2870295,1777402,61.9,1673050,58.3,104352,5.9
21865,September 2011,Oregon,3069282,1993268,64.9,1804394,58.8,188874,9.5
21866,September 2011,Pennsylvania,10126812,6408564,63.3,5893142,58.2,515422,8.0
21867,September 2011,Rhode Island,843721,558926,66.2,496721,58.9,62205,11.1
21868,September 2011,South Carolina,3619694,2181994,60.3,1951575,53.9,230419,10.6
21869,September 2011,South Dakota,624713,440813,70.6,420740,67.3,20073,4.6
21870,September 2011,Tennessee,4980908,3128516,62.8,2853571,57.3,274945,8.8
21871,September 2011,Texas,19043370,12562867,66.0,11592874,60.9,969993,7.7
21872,September 2011,Utah,1999051,1349818,67.5,1263369,63.2,86449,6.4
21873,September 2011,Vermont,510093,357501,70.1,338220,66.3,19281,5.4
21874,September 2011,Virginia,6263741,4227345,67.5,3945096,63.0,282249,6.7
21875,September 2011,Washington,5318745,3459142,65.0,3142610,59.1,316532,9.2
21876,September 2011,West Virginia,1485653,806802,54.3,743018,50.0,63784,7.9
21877,September 2011,Wisconsin,4463041,3081117,69.0,2845317,63.8,235800,7.7
21878,September 2011,Wyoming,438045,307425,70.2,290022,66.2,17403,5.7
21879,October 2011,Alabama,3730172,2193291,58.8,1995331,53.5,197960,9.0
21880,October 2011,Alaska,531257,366859,69.1,339342,63.9,27517,7.5
21881,October 2011,Arizona,4942557,3031234,61.3,2752767,55.7,278467,9.2
21882,October 2011,Arkansas,2257063,1365660,60.5,1255728,55.6,109932,8.0
21883,October 2011,California,29100986,18481109,63.5,16359672,56.2,2121437,11.5
21884,October 2011,Colorado,3942715,2750277,69.8,2523717,64.0,226560,8.2
21885,October 2011,Connecticut,2837685,1909728,67.3,1748159,61.6,161569,8.5
21886,October 2011,Delaware,714316,445322,62.3,412809,57.8,32513,7.3
21887,October 2011,District of Columbia,520326,351288,67.5,315746,60.7,35542,10.1
21888,October 2011,Florida,15318643,9326979,60.9,8437925,55.1,889054,9.5
21889,October 2011,Georgia,7414875,4778084,64.4,4297025,58.0,481059,10.1
21890,October 2011,Hawaii,1058438,657897,62.2,612521,57.9,45376,6.9
21891,October 2011,Idaho,1182456,767579,64.9,706444,59.7,61135,8.0
21892,October 2011,Illinois,9962007,6611838,66.4,5960203,59.8,651635,9.9
21893,October 2011,Indiana,5010683,3202015,63.9,2906222,58.0,295793,9.2
21894,October 2011,Iowa,2378003,1656036,69.6,1565346,65.8,90690,5.5
21895,October 2011,Kansas,2165257,1489501,68.8,1395785,64.5,93716,6.3
21896,October 2011,Kentucky,3375446,2057166,60.9,1869247,55.4,187919,9.1
21897,October 2011,Louisiana,3485884,2070931,59.4,1913517,54.9,157414,7.6
21898,October 2011,Maine,1080362,700335,64.8,646109,59.8,54226,7.7
21899,October 2011,Maryland,4571173,3103191,67.9,2880494,63.0,222697,7.2
21900,October 2011,Massachusetts,5310412,3472273,65.4,3230979,60.8,241294,6.9
21901,October 2011,Michigan,7760274,4688248,60.4,4220674,54.4,467574,10.0
21902,October 2011,Minnesota,4160669,2947613,70.8,2766525,66.5,181088,6.1
21903,October 2011,Mississippi,2246903,1341803,59.7,1209848,53.8,131955,9.8
21904,October 2011,Missouri,4654778,3044159,65.4,2799733,60.1,244426,8.0
21905,October 2011,Montana,785983,502636,63.9,469230,59.7,33406,6.6
21906,October 2011,Nebraska,1403931,1007072,71.7,963766,68.6,43306,4.3
21907,October 2011,Nevada,2104854,1375745,65.4,1200974,57.1,174771,12.7
21908,October 2011,New Hampshire,1060631,737613,69.5,697158,65.7,40455,5.5
21909,October 2011,New Jersey,6946195,4577450,65.9,4152800,59.8,424650,9.3
21910,October 2011,New Mexico,1584818,930768,58.7,859611,54.2,71157,7.6
21911,October 2011,New York,15534572,9543711,61.4,8736516,56.2,807195,8.5
21912,October 2011,North Carolina,7447896,4650085,62.4,4176228,56.1,473857,10.2
21913,October 2011,North Dakota,535723,392024,73.2,378566,70.7,13458,3.4
21914,October 2011,Ohio,9003703,5760967,64.0,5268990,58.5,491977,8.5
21915,October 2011,Oklahoma,2872976,1781588,62.0,1677833,58.4,103755,5.8
21916,October 2011,Oregon,3072133,1991813,64.8,1804859,58.7,186954,9.4
21917,October 2011,Pennsylvania,10130887,6417731,63.3,5906149,58.3,511582,8.0
21918,October 2011,Rhode Island,844134,559077,66.2,496418,58.8,62659,11.2
21919,October 2011,South Carolina,3624218,2182409,60.2,1955385,54.0,227024,10.4
21920,October 2011,South Dakota,625456,440931,70.5,421072,67.3,19859,4.5
21921,October 2011,Tennessee,4985521,3128135,62.7,2859767,57.4,268368,8.6
21922,October 2011,Texas,19076135,12582374,66.0,11628674,61.0,953700,7.6
21923,October 2011,Utah,2002013,1351199,67.5,1266619,63.3,84580,6.3
21924,October 2011,Vermont,510218,357373,70.0,338215,66.3,19158,5.4
21925,October 2011,Virginia,6271809,4233999,67.5,3954022,63.0,279977,6.6
21926,October 2011,Washington,5325672,3461153,65.0,3148737,59.1,312416,9.0
21927,October 2011,West Virginia,1485887,807723,54.4,744664,50.1,63059,7.8
21928,October 2011,Wisconsin,4465254,3080722,69.0,2849043,63.8,231679,7.5
21929,October 2011,Wyoming,438763,307757,70.1,290332,66.2,17425,5.7
21930,November 2011,Alabama,3731644,2186335,58.6,1997246,53.5,189089,8.6
21931,November 2011,Alaska,531740,366844,69.0,339398,63.8,27446,7.5
21932,November 2011,Arizona,4949165,3030271,61.2,2757700,55.7,272571,9.0
21933,November 2011,Arkansas,2257893,1366313,60.5,1258015,55.7,108298,7.9
21934,November 2011,California,29132825,18489447,63.5,16396794,56.3,2092653,11.3
21935,November 2011,Colorado,3948102,2754113,69.8,2527589,64.0,226524,8.2
21936,November 2011,Connecticut,2838967,1908451,67.2,1748916,61.6,159535,8.4
21937,November 2011,Delaware,714955,445777,62.4,413575,57.8,32202,7.2
21938,November 2011,District of Columbia,521190,351902,67.5,316729,60.8,35173,10.0
21939,November 2011,Florida,15337568,9334508,60.9,8465438,55.2,869070,9.3
21940,November 2011,Georgia,7423192,4781837,64.4,4307505,58.0,474332,9.9
21941,November 2011,Hawaii,1059173,656316,62.0,611242,57.7,45074,6.9
21942,November 2011,Idaho,1183592,768213,64.9,707813,59.8,60400,7.9
21943,November 2011,Illinois,9965343,6605805,66.3,5969807,59.9,635998,9.6
21944,November 2011,Indiana,5012858,3201209,63.9,2911729,58.1,289480,9.0
21945,November 2011,Iowa,2379081,1655845,69.6,1566263,65.8,89582,5.4
21946,November 2011,Kansas,2166329,1488863,68.7,1396313,64.5,92550,6.2
21947,November 2011,Kentucky,3376576,2056412,60.9,1873315,55.5,183097,8.9
21948,November 2011,Louisiana,3487859,2071370,59.4,1914670,54.9,156700,7.6
21949,November 2011,Maine,1080579,700617,64.8,646574,59.8,54043,7.7
21950,November 2011,Maryland,4575125,3105475,67.9,2884942,63.1,220533,7.1
21951,November 2011,Massachusetts,5314854,3473592,65.4,3235153,60.9,238439,6.9
21952,November 2011,Michigan,7762890,4685490,60.4,4231243,54.5,454247,9.7
21953,November 2011,Minnesota,4163407,2945429,70.7,2769210,66.5,176219,6.0
21954,November 2011,Mississippi,2247459,1339527,59.6,1210197,53.8,129330,9.7
21955,November 2011,Missouri,4656285,3042107,65.3,2804880,60.2,237227,7.8
21956,November 2011,Montana,786502,502954,63.9,470237,59.8,32717,6.5
21957,November 2011,Nebraska,1404890,1008200,71.8,965397,68.7,42803,4.2
21958,November 2011,Nevada,2107834,1375441,65.3,1203644,57.1,171797,12.5
21959,November 2011,New Hampshire,1061228,738103,69.6,697841,65.8,40262,5.5
21960,November 2011,New Jersey,6950144,4579959,65.9,4157197,59.8,422762,9.2
21961,November 2011,New Mexico,1585524,930568,58.7,859530,54.2,71038,7.6
21962,November 2011,New York,15543515,9562510,61.5,8748504,56.3,814006,8.5
21963,November 2011,North Carolina,7454875,4653103,62.4,4187931,56.2,465172,10.0
21964,November 2011,North Dakota,536628,392693,73.2,379527,70.7,13166,3.4
21965,November 2011,Ohio,9005341,5750052,63.9,5274910,58.6,475142,8.3
21966,November 2011,Oklahoma,2875094,1785444,62.1,1683016,58.5,102428,5.7
21967,November 2011,Oregon,3074682,1989605,64.7,1804848,58.7,184757,9.3
21968,November 2011,Pennsylvania,10133858,6424755,63.4,5918716,58.4,506039,7.9
21969,November 2011,Rhode Island,844418,559300,66.2,496393,58.8,62907,11.2
21970,November 2011,South Carolina,3627768,2182445,60.2,1959639,54.0,222806,10.2
21971,November 2011,South Dakota,626080,441021,70.4,421389,67.3,19632,4.5
21972,November 2011,Tennessee,4989371,3124159,62.6,2863611,57.4,260548,8.3
21973,November 2011,Texas,19106040,12594608,65.9,11660707,61.0,933901,7.4
21974,November 2011,Utah,2004723,1352773,67.5,1269973,63.3,82800,6.1
21975,November 2011,Vermont,510258,357092,70.0,338179,66.3,18913,5.3
21976,November 2011,Virginia,6277691,4236996,67.5,3960885,63.1,276111,6.5
21977,November 2011,Washington,5331482,3464012,65.0,3155902,59.2,308110,8.9
21978,November 2011,West Virginia,1485913,807925,54.4,746031,50.2,61894,7.7
21979,November 2011,Wisconsin,4467057,3078927,68.9,2851605,63.8,227322,7.4
21980,November 2011,Wyoming,439405,307944,70.1,290592,66.1,17352,5.6
21981,December 2011,Alabama,3733188,2179075,58.4,1998090,53.5,180985,8.3
21982,December 2011,Alaska,532146,366674,68.9,339373,63.8,27301,7.4
21983,December 2011,Arizona,4955682,3029294,61.1,2761310,55.7,267984,8.8
21984,December 2011,Arkansas,2258747,1365422,60.5,1258774,55.7,106648,7.8
21985,December 2011,California,29164274,18486653,63.4,16423914,56.3,2062739,11.2
21986,December 2011,Colorado,3953475,2755211,69.7,2529433,64.0,225778,8.2
21987,December 2011,Connecticut,2840256,1906593,67.1,1748647,61.6,157946,8.3
21988,December 2011,Delaware,715669,446079,62.3,414139,57.9,31940,7.2
21989,December 2011,District of Columbia,522100,352823,67.6,317962,60.9,34861,9.9
21990,December 2011,Florida,15356436,9336389,60.8,8486105,55.3,850284,9.1
21991,December 2011,Georgia,7431479,4783117,64.4,4315397,58.1,467720,9.8
21992,December 2011,Hawaii,1059768,654557,61.8,609940,57.6,44617,6.8
21993,December 2011,Idaho,1184718,768550,64.9,708822,59.8,59728,7.8
21994,December 2011,Illinois,9968736,6594308,66.1,5976406,60.0,617902,9.4
21995,December 2011,Indiana,5015051,3196276,63.7,2914603,58.1,281673,8.8
21996,December 2011,Iowa,2380178,1655530,69.6,1567422,65.9,88108,5.3
21997,December 2011,Kansas,2167279,1487729,68.6,1396598,64.4,91131,6.1
21998,December 2011,Kentucky,3377645,2054227,60.8,1876666,55.6,177561,8.6
21999,December 2011,Louisiana,3489832,2071368,59.4,1915529,54.9,155839,7.5
22000,December 2011,Maine,1080819,700893,64.8,646996,59.9,53897,7.7
22001,December 2011,Maryland,4579137,3107187,67.9,2888674,63.1,218513,7.0
22002,December 2011,Massachusetts,5319302,3473394,65.3,3237614,60.9,235780,6.8
22003,December 2011,Michigan,7765540,4679866,60.3,4238039,54.6,441827,9.4
22004,December 2011,Minnesota,4166196,2943191,70.6,2770778,66.5,172413,5.9
22005,December 2011,Mississippi,2248086,1336341,59.4,1210116,53.8,126225,9.4
22006,December 2011,Missouri,4657828,3038534,65.2,2808573,60.3,229961,7.6
22007,December 2011,Montana,787009,503131,63.9,471075,59.9,32056,6.4
22008,December 2011,Nebraska,1405790,1009155,71.8,966920,68.8,42235,4.2
22009,December 2011,Nevada,2110772,1374611,65.1,1206169,57.1,168442,12.3
22010,December 2011,New Hampshire,1061861,738371,69.5,698353,65.8,40018,5.4
22011,December 2011,New Jersey,6954116,4580274,65.9,4158972,59.8,421302,9.2
22012,December 2011,New Mexico,1586133,930015,58.6,859620,54.2,70395,7.6
22013,December 2011,New York,15552477,9574444,61.6,8754959,56.3,819485,8.6
22014,December 2011,North Carolina,7461552,4653712,62.4,4198153,56.3,455559,9.8
22015,December 2011,North Dakota,537517,393205,73.2,380385,70.8,12820,3.3
22016,December 2011,Ohio,9007070,5737855,63.7,5278780,58.6,459075,8.0
22017,December 2011,Oklahoma,2877171,1788652,62.2,1688127,58.7,100525,5.6
22018,December 2011,Oregon,3077196,1986580,64.6,1804002,58.6,182578,9.2
22019,December 2011,Pennsylvania,10136939,6428949,63.4,5928933,58.5,500016,7.8
22020,December 2011,Rhode Island,844683,559436,66.2,496594,58.8,62842,11.2
22021,December 2011,South Carolina,3631320,2182210,60.1,1963918,54.1,218292,10.0
22022,December 2011,South Dakota,626672,441098,70.4,421695,67.3,19403,4.4
22023,December 2011,Tennessee,4993262,3116606,62.4,2864164,57.4,252442,8.1
22024,December 2011,Texas,19135539,12599720,65.8,11686379,61.1,913341,7.2
22025,December 2011,Utah,2007452,1354655,67.5,1273494,63.4,81161,6.0
22026,December 2011,Vermont,510317,356626,69.9,338085,66.2,18541,5.2
22027,December 2011,Virginia,6283409,4235857,67.4,3964606,63.1,271251,6.4
22028,December 2011,Washington,5337157,3467287,65.0,3163381,59.3,303906,8.8
22029,December 2011,West Virginia,1485953,807497,54.3,746935,50.3,60562,7.5
22030,December 2011,Wisconsin,4468864,3076083,68.8,2852907,63.8,223176,7.3
22031,December 2011,Wyoming,440024,307983,70.0,290823,66.1,17160,5.6
22032,January 2012,Alabama,3734808,2173177,58.2,1998157,53.5,175020,8.1
22033,January 2012,Alaska,532571,366425,68.8,339328,63.7,27097,7.4
22034,January 2012,Arizona,4962287,3028300,61.0,2763459,55.7,264841,8.7
22035,January 2012,Arkansas,2259611,1363322,60.3,1258194,55.7,105128,7.7
22036,January 2012,California,29196406,18478244,63.3,16442867,56.3,2035377,11.0
22037,January 2012,Colorado,3958843,2754132,69.6,2529588,63.9,224544,8.2
22038,January 2012,Connecticut,2841605,1904057,67.0,1747131,61.5,156926,8.2
22039,January 2012,Delaware,716393,446257,62.3,414481,57.9,31776,7.1
22040,January 2012,District of Columbia,523056,354177,67.7,319618,61.1,34559,9.8
22041,January 2012,Florida,15375480,9335794,60.7,8501196,55.3,834598,8.9
22042,January 2012,Georgia,7440116,4783176,64.3,4321220,58.1,461956,9.7
22043,January 2012,Hawaii,1060258,652737,61.6,608722,57.4,44015,6.7
22044,January 2012,Idaho,1185823,768709,64.8,709573,59.8,59136,7.7
22045,January 2012,Illinois,9972375,6581090,66.0,5979812,60.0,601278,9.1
22046,January 2012,Indiana,5017290,3188316,63.5,2914437,58.1,273879,8.6
22047,January 2012,Iowa,2381279,1655012,69.5,1568570,65.9,86442,5.2
22048,January 2012,Kansas,2168258,1486440,68.6,1396822,64.4,89618,6.0
22049,January 2012,Kentucky,3378666,2051531,60.7,1879304,55.6,172227,8.4
22050,January 2012,Louisiana,3491925,2071658,59.3,1916726,54.9,154932,7.5
22051,January 2012,Maine,1081033,701198,64.9,647429,59.9,53769,7.7
22052,January 2012,Maryland,4583152,3108528,67.8,2891475,63.1,217053,7.0
22053,January 2012,Massachusetts,5323783,3472361,65.2,3238875,60.8,233486,6.7
22054,January 2012,Michigan,7768331,4673008,60.2,4240922,54.6,432086,9.2
22055,January 2012,Minnesota,4168977,2941312,70.6,2771438,66.5,169874,5.8
22056,January 2012,Mississippi,2248805,1332527,59.3,1209512,53.8,123015,9.2
22057,January 2012,Missouri,4659472,3033914,65.1,2810674,60.3,223240,7.4
22058,January 2012,Montana,787544,503294,63.9,471779,59.9,31515,6.3
22059,January 2012,Nebraska,1406705,1009980,71.8,968337,68.8,41643,4.1
22060,January 2012,Nevada,2113694,1373690,65.0,1208579,57.2,165111,12.0
22061,January 2012,New Hampshire,1062471,738461,69.5,698642,65.8,39819,5.4
22062,January 2012,New Jersey,6958194,4579827,65.8,4158773,59.8,421054,9.2
22063,January 2012,New Mexico,1586786,929176,58.6,859841,54.2,69335,7.5
22064,January 2012,New York,15561756,9581121,61.6,8757122,56.3,823999,8.6
22065,January 2012,North Carolina,7468406,4653376,62.3,4206727,56.3,446649,9.6
22066,January 2012,North Dakota,538425,393660,73.1,381180,70.8,12480,3.2
22067,January 2012,Ohio,9008864,5726309,63.6,5281141,58.6,445168,7.8
22068,January 2012,Oklahoma,2879259,1791292,62.2,1692991,58.8,98301,5.5
22069,January 2012,Oregon,3079711,1982713,64.4,1802207,58.5,180506,9.1
22070,January 2012,Pennsylvania,10140079,6431325,63.4,5936304,58.5,495021,7.7
22071,January 2012,Rhode Island,844981,559376,66.2,496950,58.8,62426,11.2
22072,January 2012,South Carolina,3635054,2182119,60.0,1968013,54.1,214106,9.8
22073,January 2012,South Dakota,627295,441209,70.3,422007,67.3,19202,4.4
22074,January 2012,Tennessee,4997098,3107367,62.2,2861807,57.3,245560,7.9
22075,January 2012,Texas,19165587,12600830,65.7,11705732,61.1,895098,7.1
22076,January 2012,Utah,2010152,1357156,67.5,1277412,63.5,79744,5.9
22077,January 2012,Vermont,510373,356060,69.8,337924,66.2,18136,5.1
22078,January 2012,Virginia,6288793,4231959,67.3,3965563,63.1,266396,6.3
22079,January 2012,Washington,5342823,3470587,65.0,3170602,59.3,299985,8.6
22080,January 2012,West Virginia,1486022,806904,54.3,747452,50.3,59452,7.4
22081,January 2012,Wisconsin,4470744,3073271,68.7,2853474,63.8,219797,7.2
22082,January 2012,Wyoming,440585,307909,69.9,291027,66.1,16882,5.5
22083,February 2012,Alabama,3736025,2170249,58.1,1998044,53.5,172205,7.9
22084,February 2012,Alaska,533184,366158,68.7,339301,63.6,26857,7.3
22085,February 2012,Arizona,4968219,3027474,60.9,2764958,55.7,262516,8.7
22086,February 2012,Arkansas,2260222,1360430,60.2,1256572,55.6,103858,7.6
22087,February 2012,California,29225293,18472694,63.2,16459497,56.3,2013197,10.9
22088,February 2012,Colorado,3964104,2752543,69.4,2529062,63.8,223481,8.1
22089,February 2012,Connecticut,2842610,1901053,66.9,1744475,61.4,156578,8.2
22090,February 2012,Delaware,717032,446336,62.2,414607,57.8,31729,7.1
22091,February 2012,District of Columbia,523924,355916,67.9,321716,61.4,34200,9.6
22092,February 2012,Florida,15392660,9337939,60.7,8514717,55.3,823222,8.8
22093,February 2012,Georgia,7448252,4784093,64.2,4326397,58.1,457696,9.6
22094,February 2012,Hawaii,1061228,650981,61.3,607650,57.3,43331,6.7
22095,February 2012,Idaho,1186856,768779,64.8,710196,59.8,58583,7.6
22096,February 2012,Illinois,9974787,6571177,65.9,5981308,60.0,589869,9.0
22097,February 2012,Indiana,5018870,3179585,63.4,2911957,58.0,267628,8.4
22098,February 2012,Iowa,2382046,1654386,69.5,1569426,65.9,84960,5.1
22099,February 2012,Kansas,2169239,1485381,68.5,1397111,64.4,88270,5.9
22100,February 2012,Kentucky,3379604,2049670,60.6,1881633,55.7,168037,8.2
22101,February 2012,Louisiana,3493742,2073080,59.3,1918815,54.9,154265,7.4
22102,February 2012,Maine,1081118,701539,64.9,647863,59.9,53676,7.7
22103,February 2012,Maryland,4586993,3109961,67.8,2893448,63.1,216513,7.0
22104,February 2012,Massachusetts,5327623,3471702,65.2,3240019,60.8,231683,6.7
22105,February 2012,Michigan,7770013,4667565,60.1,4241203,54.6,426362,9.1
22106,February 2012,Minnesota,4171249,2940126,70.5,2771941,66.5,168185,5.7
22107,February 2012,Mississippi,2249359,1328706,59.1,1208386,53.7,120320,9.1
22108,February 2012,Missouri,4660529,3029635,65.0,2811627,60.3,218008,7.2
22109,February 2012,Montana,787985,503616,63.9,472467,60.0,31149,6.2
22110,February 2012,Nebraska,1407512,1010781,71.8,969660,68.9,41121,4.1
22111,February 2012,Nevada,2116447,1373171,64.9,1210993,57.2,162178,11.8
22112,February 2012,New Hampshire,1062951,738519,69.5,698761,65.7,39758,5.4
22113,February 2012,New Jersey,6961298,4580547,65.8,4157820,59.7,422727,9.2
22114,February 2012,New Mexico,1587302,928263,58.5,860138,54.2,68125,7.3
22115,February 2012,New York,15568840,9586612,61.6,8758084,56.3,828528,8.6
22116,February 2012,North Carolina,7475390,4654035,62.3,4214099,56.4,439936,9.5
22117,February 2012,North Dakota,539371,394174,73.1,381964,70.8,12210,3.1
22118,February 2012,Ohio,9009540,5717633,63.5,5283067,58.6,434566,7.6
22119,February 2012,Oklahoma,2881233,1793798,62.3,1697668,58.9,96130,5.4
22120,February 2012,Oregon,3081864,1978231,64.2,1799565,58.4,178666,9.0
22121,February 2012,Pennsylvania,10141805,6434181,63.4,5941533,58.6,492648,7.7
22122,February 2012,Rhode Island,845209,559086,66.1,497366,58.8,61720,11.0
22123,February 2012,South Carolina,3638617,2182773,60.0,1971778,54.2,210995,9.7
22124,February 2012,South Dakota,627866,441386,70.3,422317,67.3,19069,4.3
22125,February 2012,Tennessee,5000649,3099614,62.0,2858152,57.2,241462,7.8
22126,February 2012,Texas,19193943,12603733,65.7,11721887,61.1,881846,7.0
22127,February 2012,Utah,2012745,1360331,67.6,1281733,63.7,78598,5.8
22128,February 2012,Vermont,510382,355564,69.7,337735,66.2,17829,5.0
22129,February 2012,Virginia,6295383,4227576,67.2,3964867,63.0,262709,6.2
22130,February 2012,Washington,5348467,3473802,64.9,3177049,59.4,296753,8.5
22131,February 2012,West Virginia,1485869,806692,54.3,747779,50.3,58913,7.3
22132,February 2012,Wisconsin,4472040,3071805,68.7,2853968,63.8,217837,7.1
22133,February 2012,Wyoming,441245,307765,69.7,291172,66.0,16593,5.4
22134,March 2012,Alabama,3737476,2170701,58.1,1997949,53.5,172752,8.0
22135,March 2012,Alaska,533483,365907,68.6,339291,63.6,26616,7.3
22136,March 2012,Arizona,4974408,3027314,60.9,2766197,55.6,261117,8.6
22137,March 2012,Arkansas,2261005,1357024,60.0,1254064,55.5,102960,7.6
22138,March 2012,California,29253812,18474388,63.2,16476663,56.3,1997725,10.8
22139,March 2012,Colorado,3969225,2751340,69.3,2528560,63.7,222780,8.1
22140,March 2012,Connecticut,2843761,1897790,66.7,1740795,61.2,156995,8.3
22141,March 2012,Delaware,717669,446320,62.2,414526,57.8,31794,7.1
22142,March 2012,District of Columbia,524801,357875,68.2,324111,61.8,33764,9.4
22143,March 2012,Florida,15410155,9343664,60.6,8527026,55.3,816638,8.7
22144,March 2012,Georgia,7456320,4786203,64.2,4331046,58.1,455157,9.5
22145,March 2012,Hawaii,1061553,649380,61.2,606805,57.2,42575,6.6
22146,March 2012,Idaho,1187951,768782,64.7,710756,59.8,58026,7.5
22147,March 2012,Illinois,9977902,6567040,65.8,5981313,59.9,585727,8.9
22148,March 2012,Indiana,5021075,3171742,63.2,2907822,57.9,263920,8.3
22149,March 2012,Iowa,2383134,1653639,69.4,1569640,65.9,83999,5.1
22150,March 2012,Kansas,2170082,1484558,68.4,1397295,64.4,87263,5.9
22151,March 2012,Kentucky,3380534,2049449,60.6,1883676,55.7,165773,8.1
22152,March 2012,Louisiana,3495584,2075571,59.4,1921592,55.0,153979,7.4
22153,March 2012,Maine,1081341,701851,64.9,648248,59.9,53603,7.6
22154,March 2012,Maryland,4590753,3111600,67.8,2894610,63.1,216990,7.0
22155,March 2012,Massachusetts,5331965,3472122,65.1,3241435,60.8,230687,6.6
22156,March 2012,Michigan,7772627,4664770,60.0,4239532,54.5,425238,9.1
22157,March 2012,Minnesota,4174069,2939631,70.4,2772639,66.4,166992,5.7
22158,March 2012,Mississippi,2249852,1325478,58.9,1206726,53.6,118752,9.0
22159,March 2012,Missouri,4662033,3026396,64.9,2811472,60.3,214924,7.1
22160,March 2012,Montana,788496,504198,63.9,473238,60.0,30960,6.1
22161,March 2012,Nebraska,1408415,1011635,71.8,970874,68.9,40761,4.0
22162,March 2012,Nevada,2119256,1373279,64.8,1213419,57.3,159860,11.6
22163,March 2012,New Hampshire,1063594,738719,69.5,698832,65.7,39887,5.4
22164,March 2012,New Jersey,6964952,4582440,65.8,4155993,59.7,426447,9.3
22165,March 2012,New Mexico,1587754,927370,58.4,860339,54.2,67031,7.2
22166,March 2012,New York,15576996,9591657,61.6,8757816,56.2,833841,8.7
22167,March 2012,North Carolina,7481383,4656332,62.2,4219648,56.4,436684,9.4
22168,March 2012,North Dakota,540205,394788,73.1,382755,70.9,12033,3.0
22169,March 2012,Ohio,9011175,5712035,63.4,5284062,58.6,427973,7.5
22170,March 2012,Oklahoma,2883182,1796310,62.3,1701839,59.0,94471,5.3
22171,March 2012,Oregon,3084341,1973317,64.0,1796114,58.2,177203,9.0
22172,March 2012,Pennsylvania,10144710,6438829,63.5,5944629,58.6,494200,7.7
22173,March 2012,Rhode Island,845431,558645,66.1,497791,58.9,60854,10.9
22174,March 2012,South Carolina,3641940,2184266,60.0,1974823,54.2,209443,9.6
22175,March 2012,South Dakota,628443,441604,70.3,422584,67.2,19020,4.3
22176,March 2012,Tennessee,5004385,3095423,61.9,2854380,57.0,241043,7.8
22177,March 2012,Texas,19221925,12611236,65.6,11736127,61.1,875109,6.9
22178,March 2012,Utah,2015497,1363728,67.7,1286115,63.8,77613,5.7
22179,March 2012,Vermont,510435,355263,69.6,337573,66.1,17690,5.0
22180,March 2012,Virginia,6300677,4223386,67.0,3962491,62.9,260895,6.2
22181,March 2012,Washington,5353870,3476293,64.9,3181677,59.4,294616,8.5
22182,March 2012,West Virginia,1485896,807060,54.3,747980,50.3,59080,7.3
22183,March 2012,Wisconsin,4473848,3071871,68.7,2854197,63.8,217674,7.1
22184,March 2012,Wyoming,441864,307605,69.6,291232,65.9,16373,5.3
22185,April 2012,Alabama,3738873,2173301,58.1,1997920,53.4,175381,8.1
22186,April 2012,Alaska,533987,365649,68.5,339247,63.5,26402,7.2
22187,April 2012,Arizona,4980654,3027619,60.8,2767531,55.6,260088,8.6
22188,April 2012,Arkansas,2261761,1353406,59.8,1250988,55.3,102418,7.6
22189,April 2012,California,29283876,18480818,63.1,16496074,56.3,1984744,10.7
22190,April 2012,Colorado,3974559,2750712,69.2,2528512,63.6,222200,8.1
22191,April 2012,Connecticut,2844915,1894278,66.6,1736266,61.0,158012,8.3
22192,April 2012,Delaware,718364,446198,62.1,414272,57.7,31926,7.2
22193,April 2012,District of Columbia,525657,359861,68.5,326567,62.1,33294,9.3
22194,April 2012,Florida,15427825,9351008,60.6,8537711,55.3,813297,8.7
22195,April 2012,Georgia,7464754,4787780,64.1,4334976,58.1,452804,9.5
22196,April 2012,Hawaii,1062249,648004,61.0,606292,57.1,41712,6.4
22197,April 2012,Idaho,1189078,768761,64.7,711329,59.8,57432,7.5
22198,April 2012,Illinois,9980923,6567372,65.8,5980357,59.9,587015,8.9
22199,April 2012,Indiana,5023102,3165417,63.0,2902880,57.8,262537,8.3
22200,April 2012,Iowa,2384110,1652667,69.3,1569155,65.8,83512,5.1
22201,April 2012,Kansas,2171119,1483742,68.3,1397324,64.4,86418,5.8
22202,April 2012,Kentucky,3381661,2050796,60.6,1885257,55.7,165539,8.1
22203,April 2012,Louisiana,3497460,2078081,59.4,1924525,55.0,153556,7.4
22204,April 2012,Maine,1081521,702059,64.9,648582,60.0,53477,7.6
22205,April 2012,Maryland,4594530,3113159,67.8,2895270,63.0,217889,7.0
22206,April 2012,Massachusetts,5336208,3473518,65.1,3243151,60.8,230367,6.6
22207,April 2012,Michigan,7774938,4663599,60.0,4236729,54.5,426870,9.2
22208,April 2012,Minnesota,4176708,2939742,70.4,2773408,66.4,166334,5.7
22209,April 2012,Mississippi,2250371,1322927,58.8,1204608,53.5,118319,8.9
22210,April 2012,Missouri,4663502,3023540,64.8,2810596,60.3,212944,7.0
22211,April 2012,Montana,788974,504977,64.0,474093,60.1,30884,6.1
22212,April 2012,Nebraska,1409325,1012540,71.8,971999,69.0,40541,4.0
22213,April 2012,Nevada,2122083,1373957,64.7,1215881,57.3,158076,11.5
22214,April 2012,New Hampshire,1064145,739195,69.5,699024,65.7,40171,5.4
22215,April 2012,New Jersey,6968510,4584234,65.8,4153426,59.6,430808,9.4
22216,April 2012,New Mexico,1588304,926402,58.3,860239,54.2,66163,7.1
22217,April 2012,New York,15585106,9594584,61.6,8756373,56.2,838211,8.7
22218,April 2012,North Carolina,7488325,4659384,62.2,4223431,56.4,435953,9.4
22219,April 2012,North Dakota,541095,395496,73.1,383552,70.9,11944,3.0
22220,April 2012,Ohio,9012581,5707355,63.3,5283236,58.6,424119,7.4
22221,April 2012,Oklahoma,2885322,1798586,62.3,1705050,59.1,93536,5.2
22222,April 2012,Oregon,3086733,1967875,63.8,1791931,58.1,175944,8.9
22223,April 2012,Pennsylvania,10147230,6444694,63.5,5945882,58.6,498812,7.7
22224,April 2012,Rhode Island,845690,558234,66.0,498266,58.9,59968,10.7
22225,April 2012,South Carolina,3645608,2185696,60.0,1977014,54.2,208682,9.5
22226,April 2012,South Dakota,629070,441843,70.2,422801,67.2,19042,4.3
22227,April 2012,Tennessee,5008109,3094396,61.8,2851425,56.9,242971,7.9
22228,April 2012,Texas,19250802,12621391,65.6,11749382,61.0,872009,6.9
22229,April 2012,Utah,2018209,1366813,67.7,1290232,63.9,76581,5.6
22230,April 2012,Vermont,510463,355193,69.6,337472,66.1,17721,5.0
22231,April 2012,Virginia,6306544,4219059,66.9,3958783,62.8,260276,6.2
22232,April 2012,Washington,5359610,3477069,64.9,3183933,59.4,293136,8.4
22233,April 2012,West Virginia,1485870,807745,54.4,747982,50.3,59763,7.4
22234,April 2012,Wisconsin,4475492,3072550,68.7,2853844,63.8,218706,7.1
22235,April 2012,Wyoming,442497,307476,69.5,291207,65.8,16269,5.3
22236,May 2012,Alabama,3740285,2176682,58.2,1998414,53.4,178268,8.2
22237,May 2012,Alaska,534608,365425,68.4,339189,63.4,26236,7.2
22238,May 2012,Arizona,4986918,3028537,60.7,2769954,55.5,258583,8.5
22239,May 2012,Arkansas,2262539,1349774,59.7,1247651,55.1,102123,7.6
22240,May 2012,California,29313426,18491774,63.1,16522575,56.4,1969199,10.6
22241,May 2012,Colorado,3980079,2751221,69.1,2529773,63.6,221448,8.0
22242,May 2012,Connecticut,2846109,1890828,66.4,1731589,60.8,159239,8.4
22243,May 2012,Delaware,718995,445997,62.0,413923,57.6,32074,7.2
22244,May 2012,District of Columbia,526558,361825,68.7,328974,62.5,32851,9.1
22245,May 2012,Florida,15445584,9360799,60.6,8550238,55.4,810561,8.7
22246,May 2012,Georgia,7473337,4788509,64.1,4339280,58.1,449229,9.4
22247,May 2012,Hawaii,1063050,646905,60.9,606172,57.0,40733,6.3
22248,May 2012,Idaho,1190232,768829,64.6,712041,59.8,56788,7.4
22249,May 2012,Illinois,9984051,6571517,65.8,5980993,59.9,590524,9.0
22250,May 2012,Indiana,5025128,3161347,62.9,2898841,57.7,262506,8.3
22251,May 2012,Iowa,2385187,1651738,69.2,1568358,65.8,83380,5.0
22252,May 2012,Kansas,2172267,1483049,68.3,1397448,64.3,85601,5.8
22253,May 2012,Kentucky,3382876,2053571,60.7,1886909,55.8,166662,8.1
22254,May 2012,Louisiana,3499334,2079852,59.4,1927516,55.1,152336,7.3
22255,May 2012,Maine,1081742,702207,64.9,648947,60.0,53260,7.6
22256,May 2012,Maryland,4598356,3114818,67.7,2896228,63.0,218590,7.0
22257,May 2012,Massachusetts,5340517,3476254,65.1,3245796,60.8,230458,6.6
22258,May 2012,Michigan,7777264,4663931,60.0,4235014,54.5,428917,9.2
22259,May 2012,Minnesota,4179456,2940579,70.4,2774614,66.4,165965,5.6
22260,May 2012,Mississippi,2250995,1321106,58.7,1202397,53.4,118709,9.0
22261,May 2012,Missouri,4665065,3021371,64.8,2810192,60.2,211179,7.0
22262,May 2012,Montana,789522,505872,64.1,475038,60.2,30834,6.1
22263,May 2012,Nebraska,1410274,1013516,71.9,973082,69.0,40434,4.0
22264,May 2012,Nevada,2124940,1375065,64.7,1218477,57.3,156588,11.4
22265,May 2012,New Hampshire,1064780,739978,69.5,699439,65.7,40539,5.5
22266,May 2012,New Jersey,6971955,4585463,65.8,4151747,59.5,433716,9.5
22267,May 2012,New Mexico,1588838,925588,58.3,860026,54.1,65562,7.1
22268,May 2012,New York,15592852,9597583,61.6,8757979,56.2,839604,8.7
22269,May 2012,North Carolina,7495674,4663979,62.2,4227719,56.4,436260,9.4
22270,May 2012,North Dakota,542062,396309,73.1,384374,70.9,11935,3.0
22271,May 2012,Ohio,9014022,5703147,63.3,5281931,58.6,421216,7.4
22272,May 2012,Oklahoma,2887547,1800770,62.4,1707487,59.1,93283,5.2
22273,May 2012,Oregon,3089168,1962194,63.5,1787555,57.9,174639,8.9
22274,May 2012,Pennsylvania,10149888,6452177,63.6,5947225,58.6,504952,7.8
22275,May 2012,Rhode Island,845946,558003,66.0,498852,59.0,59151,10.6
22276,May 2012,South Carolina,3649463,2186565,59.9,1978892,54.2,207673,9.5
22277,May 2012,South Dakota,629700,442106,70.2,422989,67.2,19117,4.3
22278,May 2012,Tennessee,5011950,3096056,61.8,2850683,56.9,245373,7.9
22279,May 2012,Texas,19279641,12634585,65.5,11766133,61.0,868452,6.9
22280,May 2012,Utah,2021034,1369443,67.8,1293997,64.0,75446,5.5
22281,May 2012,Vermont,510540,355266,69.6,337429,66.1,17837,5.0
22282,May 2012,Virginia,6312939,4215862,66.8,3955951,62.7,259911,6.2
22283,May 2012,Washington,5365572,3476271,64.8,3184854,59.4,291417,8.4
22284,May 2012,West Virginia,1485904,808536,54.4,747879,50.3,60657,7.5
22285,May 2012,Wisconsin,4477216,3073221,68.6,2853486,63.7,219735,7.1
22286,May 2012,Wyoming,443133,307387,69.4,291112,65.7,16275,5.3
22287,June 2012,Alabama,3741900,2179696,58.3,1999858,53.4,179838,8.3
22288,June 2012,Alaska,535173,365279,68.3,339191,63.4,26088,7.1
22289,June 2012,Arizona,4993475,3029753,60.7,2773665,55.5,256088,8.5
22290,June 2012,Arkansas,2263429,1345970,59.5,1244049,55.0,101921,7.6
22291,June 2012,California,29344718,18506306,63.1,16558495,56.4,1947811,10.5
22292,June 2012,Colorado,3985740,2753000,69.1,2532746,63.5,220254,8.0
22293,June 2012,Connecticut,2847487,1887726,66.3,1727535,60.7,160191,8.5
22294,June 2012,Delaware,719703,445764,61.9,413567,57.5,32197,7.2
22295,June 2012,District of Columbia,527447,363859,69.0,331365,62.8,32494,8.9
22296,June 2012,Florida,15464262,9373314,60.6,8567330,55.4,805984,8.6
22297,June 2012,Georgia,7482135,4788789,64.0,4344755,58.1,444034,9.3
22298,June 2012,Hawaii,1063855,646109,60.7,606476,57.0,39633,6.1
22299,June 2012,Idaho,1191447,769041,64.5,712968,59.8,56073,7.3
22300,June 2012,Illinois,9987801,6577714,65.9,5984744,59.9,592970,9.0
22301,June 2012,Indiana,5027521,3159779,62.8,2897215,57.6,262564,8.3
22302,June 2012,Iowa,2386384,1651144,69.2,1567733,65.7,83411,5.1
22303,June 2012,Kansas,2173473,1482687,68.2,1397941,64.3,84746,5.7
22304,June 2012,Kentucky,3384183,2057239,60.8,1889104,55.8,168135,8.2
22305,June 2012,Louisiana,3501403,2080624,59.4,1930777,55.1,149847,7.2
22306,June 2012,Maine,1082033,702345,64.9,649410,60.0,52935,7.5
22307,June 2012,Maryland,4602451,3116856,67.7,2898073,63.0,218783,7.0
22308,June 2012,Massachusetts,5345179,3480397,65.1,3249583,60.8,230814,6.6
22309,June 2012,Michigan,7780037,4665410,60.0,4235749,54.4,429661,9.2
22310,June 2012,Minnesota,4182462,2942474,70.4,2776729,66.4,165745,5.6
22311,June 2012,Mississippi,2251676,1319609,58.6,1200361,53.3,119248,9.0
22312,June 2012,Missouri,4666887,3020302,64.7,2811126,60.2,209176,6.9
22313,June 2012,Montana,790087,506766,64.1,476037,60.3,30729,6.1
22314,June 2012,Nebraska,1411286,1014563,71.9,974158,69.0,40405,4.0
22315,June 2012,Nevada,2127904,1376318,64.7,1221283,57.4,155035,11.3
22316,June 2012,New Hampshire,1065440,740968,69.5,700079,65.7,40889,5.5
22317,June 2012,New Jersey,6975888,4586476,65.7,4152120,59.5,434356,9.5
22318,June 2012,New Mexico,1589485,925359,58.2,860128,54.1,65231,7.0
22319,June 2012,New York,15601736,9602266,61.5,8765976,56.2,836290,8.7
22320,June 2012,North Carolina,7502968,4670723,62.3,4234462,56.4,436261,9.3
22321,June 2012,North Dakota,543022,397207,73.1,385218,70.9,11989,3.0
22322,June 2012,Ohio,9016042,5699647,63.2,5281583,58.6,418064,7.3
22323,June 2012,Oklahoma,2889854,1803132,62.4,1709691,59.2,93441,5.2
22324,June 2012,Oregon,3091844,1956474,63.3,1783319,57.7,173155,8.9
22325,June 2012,Pennsylvania,10153173,6461050,63.6,5950592,58.6,510458,7.9
22326,June 2012,Rhode Island,846273,557986,65.9,499563,59.0,58423,10.5
22327,June 2012,South Carolina,3653337,2186785,59.9,1981245,54.2,205540,9.4
22328,June 2012,South Dakota,630386,442401,70.2,423183,67.1,19218,4.3
22329,June 2012,Tennessee,5016054,3099123,61.8,2852564,56.9,246559,8.0
22330,June 2012,Texas,19309587,12651081,65.5,11789580,61.1,861501,6.8
22331,June 2012,Utah,2023946,1371758,67.8,1297527,64.1,74231,5.4
22332,June 2012,Vermont,510599,355347,69.6,337423,66.1,17924,5.0
22333,June 2012,Virginia,6319368,4214807,66.7,3955826,62.6,258981,6.1
22334,June 2012,Washington,5371743,3474422,64.7,3185871,59.3,288551,8.3
22335,June 2012,West Virginia,1486005,809176,54.5,747721,50.3,61455,7.6
22336,June 2012,Wisconsin,4479269,3073578,68.6,2853821,63.7,219757,7.1
22337,June 2012,Wyoming,443833,307332,69.2,290981,65.6,16351,5.3
22338,July 2012,Alabama,3743583,2181117,58.3,2002056,53.5,179061,8.2
22339,July 2012,Alaska,535747,365206,68.2,339296,63.3,25910,7.1
22340,July 2012,Arizona,5000194,3030883,60.6,2778294,55.6,252589,8.3
22341,July 2012,Arkansas,2264392,1341588,59.2,1239998,54.8,101590,7.6
22342,July 2012,California,29376016,18522031,63.1,16602505,56.5,1919526,10.4
22343,July 2012,Colorado,3991536,2755737,69.0,2537362,63.6,218375,7.9
22344,July 2012,Connecticut,2848888,1885184,66.2,1724752,60.5,160432,8.5
22345,July 2012,Delaware,720427,445538,61.8,413259,57.4,32279,7.2
22346,July 2012,District of Columbia,528397,366001,69.3,333727,63.2,32274,8.8
22347,July 2012,Florida,15483337,9387003,60.6,8589132,55.5,797871,8.5
22348,July 2012,Georgia,7490630,4788888,63.9,4351369,58.1,437519,9.1
22349,July 2012,Hawaii,1064555,645600,60.6,607153,57.0,38447,6.0
22350,July 2012,Idaho,1192667,769362,64.5,714058,59.9,55304,7.2
22351,July 2012,Illinois,9991259,6584040,65.9,5991553,60.0,592487,9.0
22352,July 2012,Indiana,5030042,3160387,62.8,2898371,57.6,262016,8.3
22353,July 2012,Iowa,2387648,1651019,69.1,1567718,65.7,83301,5.0
22354,July 2012,Kansas,2174727,1482906,68.2,1399007,64.3,83899,5.7
22355,July 2012,Kentucky,3385661,2061007,60.9,1891934,55.9,169073,8.2
22356,July 2012,Louisiana,3503587,2080660,59.4,1934486,55.2,146174,7.0
22357,July 2012,Maine,1082332,702503,64.9,649989,60.1,52514,7.5
22358,July 2012,Maryland,4606657,3119340,67.7,2900954,63.0,218386,7.0
22359,July 2012,Massachusetts,5350008,3485409,65.1,3254117,60.8,231292,6.6
22360,July 2012,Michigan,7783060,4667492,60.0,4239436,54.5,428056,9.2
22361,July 2012,Minnesota,4185581,2945136,70.4,2779732,66.4,165404,5.6
22362,July 2012,Mississippi,2252360,1317728,58.5,1198413,53.2,119315,9.1
22363,July 2012,Missouri,4668719,3020759,64.7,2813834,60.3,206925,6.9
22364,July 2012,Montana,790689,507498,64.2,476991,60.3,30507,6.0
22365,July 2012,Nebraska,1412364,1015617,71.9,975232,69.0,40385,4.0
22366,July 2012,Nevada,2130938,1377379,64.6,1224257,57.5,153122,11.1
22367,July 2012,New Hampshire,1066153,741974,69.6,700822,65.7,41152,5.5
22368,July 2012,New Jersey,6980061,4587732,65.7,4154797,59.5,432935,9.4
22369,July 2012,New Mexico,1590202,925878,58.2,860752,54.1,65126,7.0
22370,July 2012,New York,15611141,9608455,61.5,8780838,56.2,827617,8.6
22371,July 2012,North Carolina,7510481,4679032,62.3,4243930,56.5,435102,9.3
22372,July 2012,North Dakota,543994,398143,73.2,386061,71.0,12082,3.0
22373,July 2012,Ohio,9018280,5696911,63.2,5282661,58.6,414250,7.3
22374,July 2012,Oklahoma,2892141,1805752,62.4,1712096,59.2,93656,5.2
22375,July 2012,Oregon,3094539,1950606,63.0,1779137,57.5,171469,8.8
22376,July 2012,Pennsylvania,10156802,6469778,63.7,5956532,58.6,513246,7.9
22377,July 2012,Rhode Island,846573,558147,65.9,500419,59.1,57728,10.3
22378,July 2012,South Carolina,3656765,2186911,59.8,1984885,54.3,202026,9.2
22379,July 2012,South Dakota,631058,442705,70.2,423437,67.1,19268,4.4
22380,July 2012,Tennessee,5020286,3101941,61.8,2856431,56.9,245510,7.9
22381,July 2012,Texas,19339626,12670049,65.5,11820135,61.1,849914,6.7
22382,July 2012,Utah,2026890,1373996,67.8,1300979,64.2,73017,5.3
22383,July 2012,Vermont,510691,355337,69.6,337423,66.1,17914,5.0
22384,July 2012,Virginia,6325843,4216026,66.6,3959188,62.6,256838,6.1
22385,July 2012,Washington,5377994,3472005,64.6,3188024,59.3,283981,8.2
22386,July 2012,West Virginia,1486170,809458,54.5,747538,50.3,61920,7.6
22387,July 2012,Wisconsin,4481396,3073583,68.6,2855276,63.7,218307,7.1
22388,July 2012,Wyoming,444498,307263,69.1,290838,65.4,16425,5.3
22389,August 2012,Alabama,3745648,2181066,58.2,2004772,53.5,176294,8.1
22390,August 2012,Alaska,535995,365197,68.1,339480,63.3,25717,7.0
22391,August 2012,Arizona,5006857,3031732,60.6,2783077,55.6,248655,8.2
22392,August 2012,Arkansas,2265482,1336800,59.0,1235720,54.5,101080,7.6
22393,August 2012,California,29407949,18540096,63.0,16651465,56.6,1888631,10.2
22394,August 2012,Colorado,3997766,2759167,69.0,2543095,63.6,216072,7.8
22395,August 2012,Connecticut,2850412,1883167,66.1,1723301,60.5,159866,8.5
22396,August 2012,Delaware,721179,445340,61.8,413013,57.3,32327,7.3
22397,August 2012,District of Columbia,529316,368205,69.6,335978,63.5,32227,8.8
22398,August 2012,Florida,15504103,9401895,60.6,8614461,55.6,787434,8.4
22399,August 2012,Georgia,7497322,4789528,63.9,4358490,58.1,431038,9.0
22400,August 2012,Hawaii,1065418,645340,60.6,608092,57.1,37248,5.8
22401,August 2012,Idaho,1194058,769680,64.5,715187,59.9,54493,7.1
22402,August 2012,Illinois,9995068,6590143,65.9,5999586,60.0,590557,9.0
22403,August 2012,Indiana,5033490,3163069,62.8,2901505,57.6,261564,8.3
22404,August 2012,Iowa,2389190,1651397,69.1,1568392,65.6,83005,5.0
22405,August 2012,Kansas,2175597,1483901,68.2,1400598,64.4,83303,5.6
22406,August 2012,Kentucky,3387733,2064542,60.9,1895210,55.9,169332,8.2
22407,August 2012,Louisiana,3505922,2080892,59.4,1938467,55.3,142425,6.8
22408,August 2012,Maine,1082679,702735,64.9,650687,60.1,52048,7.4
22409,August 2012,Maryland,4610546,3122375,67.7,2904721,63.0,217654,7.0
22410,August 2012,Massachusetts,5355355,3490901,65.2,3258848,60.9,232053,6.6
22411,August 2012,Michigan,7786715,4670977,60.0,4245751,54.5,425226,9.1
22412,August 2012,Minnesota,4189068,2948475,70.4,2783485,66.4,164990,5.6
22413,August 2012,Mississippi,2253435,1315097,58.4,1196279,53.1,118818,9.0
22414,August 2012,Missouri,4670974,3023006,64.7,2817607,60.3,205399,6.8
22415,August 2012,Montana,791387,507991,64.2,477822,60.4,30169,5.9
22416,August 2012,Nebraska,1413378,1016654,71.9,976300,69.1,40354,4.0
22417,August 2012,Nevada,2133943,1378208,64.6,1227229,57.5,150979,11.0
22418,August 2012,New Hampshire,1066730,742776,69.6,701475,65.8,41301,5.6
22419,August 2012,New Jersey,6984522,4590156,65.7,4159373,59.6,430783,9.4
22420,August 2012,New Mexico,1590862,927017,58.3,861828,54.2,65189,7.0
22421,August 2012,New York,15622055,9617913,61.6,8801370,56.3,816543,8.5
22422,August 2012,North Carolina,7518750,4688766,62.4,4255583,56.6,433183,9.2
22423,August 2012,North Dakota,545342,399078,73.2,386881,70.9,12197,3.1
22424,August 2012,Ohio,9022195,5696245,63.1,5284952,58.6,411293,7.2
22425,August 2012,Oklahoma,2894666,1808483,62.5,1714606,59.2,93877,5.2
22426,August 2012,Oregon,3097289,1944745,62.8,1774907,57.3,169838,8.7
22427,August 2012,Pennsylvania,10160158,6478052,63.8,5964269,58.7,513783,7.9
22428,August 2012,Rhode Island,846826,558414,65.9,501417,59.2,56997,10.2
22429,August 2012,South Carolina,3660799,2187515,59.8,1989646,54.4,197869,9.0
22430,August 2012,South Dakota,631751,442971,70.1,423775,67.1,19196,4.3
22431,August 2012,Tennessee,5024325,3104165,61.8,2861135,56.9,243030,7.8
22432,August 2012,Texas,19370958,12691669,65.5,11854807,61.2,836862,6.6
22433,August 2012,Utah,2030349,1376447,67.8,1304435,64.2,72012,5.2
22434,August 2012,Vermont,510890,355150,69.5,337388,66.0,17762,5.0
22435,August 2012,Virginia,6331644,4219676,66.6,3965800,62.6,253876,6.0
22436,August 2012,Washington,5383588,3469717,64.4,3191534,59.3,278183,8.0
22437,August 2012,West Virginia,1486227,809418,54.5,747379,50.3,62039,7.7
22438,August 2012,Wisconsin,4483900,3073682,68.5,2857759,63.7,215923,7.0
22439,August 2012,Wyoming,444912,307166,69.0,290725,65.3,16441,5.4
22440,September 2012,Alabama,3747843,2180876,58.2,2008050,53.6,172826,7.9
22441,September 2012,Alaska,536143,365256,68.1,339678,63.4,25578,7.0
22442,September 2012,Arizona,5013718,3032171,60.5,2787112,55.6,245059,8.1
22443,September 2012,Arkansas,2266632,1332413,58.8,1231885,54.3,100528,7.5
22444,September 2012,California,29441050,18563262,63.1,16702042,56.7,1861220,10.0
22445,September 2012,Colorado,4004100,2763026,69.0,2549191,63.7,213835,7.7
22446,September 2012,Connecticut,2852038,1881296,66.0,1722549,60.4,158747,8.4
22447,September 2012,Delaware,722012,445164,61.7,412814,57.2,32350,7.3
22448,September 2012,District of Columbia,530214,370337,69.8,338011,63.7,32326,8.7
22449,September 2012,Florida,15525397,9418399,60.7,8640972,55.7,777427,8.3
22450,September 2012,Georgia,7504167,4791180,63.8,4365122,58.2,426058,8.9
22451,September 2012,Hawaii,1066087,645309,60.5,609187,57.1,36122,5.6
22452,September 2012,Idaho,1195455,769874,64.4,716258,59.9,53616,7.0
22453,September 2012,Illinois,9999326,6596052,66.0,6006010,60.1,590042,8.9
22454,September 2012,Indiana,5037119,3167606,62.9,2905442,57.7,262164,8.3
22455,September 2012,Iowa,2390914,1652163,69.1,1569562,65.6,82601,5.0
22456,September 2012,Kansas,2176507,1485494,68.3,1402370,64.4,83124,5.6
22457,September 2012,Kentucky,3389881,2067604,61.0,1898510,56.0,169094,8.2
22458,September 2012,Louisiana,3508330,2082392,59.4,1942392,55.4,140000,6.7
22459,September 2012,Maine,1083058,703085,64.9,651471,60.2,51614,7.3
22460,September 2012,Maryland,4614544,3125936,67.7,2908979,63.0,216957,6.9
22461,September 2012,Massachusetts,5361008,3496582,65.2,3263317,60.9,233265,6.7
22462,September 2012,Michigan,7790713,4677098,60.0,4253618,54.6,423480,9.1
22463,September 2012,Minnesota,4192723,2952420,70.4,2787876,66.5,164544,5.6
22464,September 2012,Mississippi,2254542,1311692,58.2,1193750,52.9,117942,9.0
22465,September 2012,Missouri,4673304,3026333,64.8,2820827,60.4,205506,6.8
22466,September 2012,Montana,792136,508298,64.2,478528,60.4,29770,5.9
22467,September 2012,Nebraska,1414434,1017753,72.0,977347,69.1,40406,4.0
22468,September 2012,Nevada,2136978,1378948,64.5,1229993,57.6,148955,10.8
22469,September 2012,New Hampshire,1067321,743229,69.6,701908,65.8,41321,5.6
22470,September 2012,New Jersey,6989311,4594086,65.7,4164815,59.6,429271,9.3
22471,September 2012,New Mexico,1591548,928458,58.3,863079,54.2,65379,7.0
22472,September 2012,New York,15633625,9631758,61.6,8824815,56.4,806943,8.4
22473,September 2012,North Carolina,7526834,4699769,62.4,4268377,56.7,431392,9.2
22474,September 2012,North Dakota,546722,399994,73.2,387687,70.9,12307,3.1
22475,September 2012,Ohio,9026461,5699086,63.1,5287654,58.6,411432,7.2
22476,September 2012,Oklahoma,2897241,1810949,62.5,1716687,59.3,94262,5.2
22477,September 2012,Oregon,3100188,1939239,62.6,1770720,57.1,168519,8.7
22478,September 2012,Pennsylvania,10163969,6486259,63.8,5972524,58.8,513735,7.9
22479,September 2012,Rhode Island,847103,558651,65.9,502462,59.3,56189,10.1
22480,September 2012,South Carolina,3664964,2188492,59.7,1994465,54.4,194027,8.9
22481,September 2012,South Dakota,632490,443188,70.1,424200,67.1,18988,4.3
22482,September 2012,Tennessee,5028518,3106102,61.8,2865405,57.0,240697,7.7
22483,September 2012,Texas,19402938,12715945,65.5,11888879,61.3,827066,6.5
22484,September 2012,Utah,2033911,1379310,67.8,1307993,64.3,71317,5.2
22485,September 2012,Vermont,511123,354731,69.4,337260,66.0,17471,4.9
22486,September 2012,Virginia,6337388,4225316,66.7,3974214,62.7,251102,5.9
22487,September 2012,Washington,5389303,3468162,64.4,3196070,59.3,272092,7.8
22488,September 2012,West Virginia,1486351,809186,54.4,747295,50.3,61891,7.6
22489,September 2012,Wisconsin,4486624,3074429,68.5,2860850,63.8,213579,6.9
22490,September 2012,Wyoming,445365,307068,68.9,290689,65.3,16379,5.3
22491,October 2012,Alabama,3749870,2181018,58.2,2011534,53.6,169484,7.8
22492,October 2012,Alaska,536321,365327,68.1,339822,63.4,25505,7.0
22493,October 2012,Arizona,5020351,3031497,60.4,2789222,55.6,242275,8.0
22494,October 2012,Arkansas,2267682,1328909,58.6,1228964,54.2,99945,7.5
22495,October 2012,California,29472788,18586398,63.1,16748317,56.8,1838081,9.9
22496,October 2012,Colorado,4010352,2766298,69.0,2554638,63.7,211660,7.7
22497,October 2012,Connecticut,2853565,1878778,65.8,1721522,60.3,157256,8.4
22498,October 2012,Delaware,722762,444940,61.6,412600,57.1,32340,7.3
22499,October 2012,District of Columbia,531146,372198,70.1,339705,64.0,32493,8.7
22500,October 2012,Florida,15546107,9432438,60.7,8663920,55.7,768518,8.1
22501,October 2012,Georgia,7510957,4791998,63.8,4369522,58.2,422476,8.8
22502,October 2012,Hawaii,1066919,645403,60.5,610281,57.2,35122,5.4
22503,October 2012,Idaho,1196819,769801,64.3,717144,59.9,52657,6.8
22504,October 2012,Illinois,10003221,6599251,66.0,6007289,60.1,591962,9.0
22505,October 2012,Indiana,5040541,3172520,62.9,2908732,57.7,263788,8.3
22506,October 2012,Iowa,2392476,1653077,69.1,1570981,65.7,82096,5.0
22507,October 2012,Kansas,2177350,1487079,68.3,1403867,64.5,83212,5.6
22508,October 2012,Kentucky,3391977,2069503,61.0,1901055,56.0,168448,8.1
22509,October 2012,Louisiana,3510632,2085197,59.4,1945682,55.4,139515,6.7
22510,October 2012,Maine,1083408,703508,64.9,652278,60.2,51230,7.3
22511,October 2012,Maryland,4618483,3129327,67.8,2912948,63.1,216379,6.9
22512,October 2012,Massachusetts,5366378,3501337,65.2,3266628,60.9,234709,6.7
22513,October 2012,Michigan,7794339,4684580,60.1,4261214,54.7,423366,9.0
22514,October 2012,Minnesota,4196255,2955833,70.4,2792315,66.5,163518,5.5
22515,October 2012,Mississippi,2255635,1307510,58.0,1190608,52.8,116902,8.9
22516,October 2012,Missouri,4675516,3028386,64.8,2821739,60.4,206647,6.8
22517,October 2012,Montana,792831,508529,64.1,479170,60.4,29359,5.8
22518,October 2012,Nebraska,1415424,1018741,72.0,978283,69.1,40458,4.0
22519,October 2012,Nevada,2139913,1379538,64.5,1232349,57.6,147189,10.7
22520,October 2012,New Hampshire,1067896,743310,69.6,702080,65.7,41230,5.5
22521,October 2012,New Jersey,6993740,4597516,65.7,4169473,59.6,428043,9.3
22522,October 2012,New Mexico,1592159,929564,58.4,864022,54.3,65542,7.1
22523,October 2012,New York,15644379,9645555,61.7,8845696,56.5,799859,8.3
22524,October 2012,North Carolina,7534822,4709793,62.5,4280257,56.8,429536,9.1
22525,October 2012,North Dakota,548084,400894,73.1,388519,70.9,12375,3.1
22526,October 2012,Ohio,9030349,5703560,63.2,5288767,58.6,414793,7.3
22527,October 2012,Oklahoma,2899731,1812407,62.5,1717573,59.2,94834,5.2
22528,October 2012,Oregon,3102944,1933900,62.3,1766539,56.9,167361,8.7
22529,October 2012,Pennsylvania,10167276,6492311,63.9,5978763,58.8,513548,7.9
22530,October 2012,Rhode Island,847352,558715,65.9,503422,59.4,55293,9.9
22531,October 2012,South Carolina,3669166,2188992,59.7,1998136,54.5,190856,8.7
22532,October 2012,South Dakota,633217,443337,70.0,424686,67.1,18651,4.2
22533,October 2012,Tennessee,5032587,3106890,61.7,2867305,57.0,239585,7.7
22534,October 2012,Texas,19434278,12738355,65.5,11915952,61.3,822403,6.5
22535,October 2012,Utah,2037360,1382469,67.9,1311679,64.4,70790,5.1
22536,October 2012,Vermont,511324,354098,69.3,337000,65.9,17098,4.8
22537,October 2012,Virginia,6343418,4230738,66.7,3981872,62.8,248866,5.9
22538,October 2012,Washington,5394890,3466906,64.3,3200714,59.3,266192,7.7
22539,October 2012,West Virginia,1486421,808673,54.4,747207,50.3,61466,7.6
22540,October 2012,Wisconsin,4489147,3075396,68.5,2863615,63.8,211781,6.9
22541,October 2012,Wyoming,445777,306980,68.9,290753,65.2,16227,5.3
22542,November 2012,Alabama,3751744,2181645,58.2,2014832,53.7,166813,7.6
22543,November 2012,Alaska,536671,365360,68.1,339883,63.3,25477,7.0
22544,November 2012,Arizona,5026749,3029541,60.3,2788907,55.5,240634,7.9
22545,November 2012,Arkansas,2268620,1326628,58.5,1227266,54.1,99362,7.5
22546,November 2012,California,29504771,18605146,63.1,16786723,56.9,1818423,9.8
22547,November 2012,Colorado,4016559,2768164,68.9,2558745,63.7,209419,7.6
22548,November 2012,Connecticut,2854872,1875155,65.7,1719640,60.2,155515,8.3
22549,November 2012,Delaware,723515,444605,61.5,412320,57.0,32285,7.3
22550,November 2012,District of Columbia,531978,373663,70.2,341013,64.1,32650,8.7
22551,November 2012,Florida,15565868,9441024,60.7,8680395,55.8,760629,8.1
22552,November 2012,Georgia,7518023,4790509,63.7,4370629,58.1,419880,8.8
22553,November 2012,Hawaii,1068089,645533,60.4,611255,57.2,34278,5.3
22554,November 2012,Idaho,1198134,769414,64.2,717778,59.9,51636,6.7
22555,November 2012,Illinois,10006851,6597998,65.9,6001762,60.0,596236,9.0
22556,November 2012,Indiana,5043508,3176648,63.0,2910893,57.7,265755,8.4
22557,November 2012,Iowa,2393783,1654247,69.1,1572489,65.7,81758,4.9
22558,November 2012,Kansas,2178177,1488233,68.3,1404914,64.5,83319,5.6
22559,November 2012,Kentucky,3393944,2070146,61.0,1902389,56.1,167757,8.1
22560,November 2012,Louisiana,3512770,2088848,59.5,1947834,55.5,141014,6.8
22561,November 2012,Maine,1083662,703960,65.0,653061,60.3,50899,7.2
22562,November 2012,Maryland,4622160,3132092,67.8,2916116,63.1,215976,6.9
22563,November 2012,Massachusetts,5371316,3504465,65.2,3268252,60.8,236213,6.7
22564,November 2012,Michigan,7797258,4691792,60.2,4267199,54.7,424593,9.0
22565,November 2012,Minnesota,4199323,2958006,70.4,2796171,66.6,161835,5.5
22566,November 2012,Mississippi,2256687,1302896,57.7,1186901,52.6,115995,8.9
22567,November 2012,Missouri,4677459,3027506,64.7,2819833,60.3,207673,6.9
22568,November 2012,Montana,793507,508777,64.1,479779,60.5,28998,5.7
22569,November 2012,Nebraska,1416325,1019439,72.0,978999,69.1,40440,4.0
22570,November 2012,Nevada,2142839,1379951,64.4,1234261,57.6,145690,10.6
22571,November 2012,New Hampshire,1068397,743091,69.6,702013,65.7,41078,5.5
22572,November 2012,New Jersey,6997625,4598151,65.7,4172301,59.6,425850,9.3
22573,November 2012,New Mexico,1592795,929901,58.4,864319,54.3,65582,7.1
22574,November 2012,New York,15654109,9655584,61.7,8860603,56.6,794981,8.2
22575,November 2012,North Carolina,7543293,4716950,62.5,4289646,56.9,427304,9.1
22576,November 2012,North Dakota,549414,401779,73.1,389375,70.9,12404,3.1
22577,November 2012,Ohio,9033429,5707413,63.2,5287330,58.5,420083,7.4
22578,November 2012,Oklahoma,2902223,1812407,62.4,1716847,59.2,95560,5.3
22579,November 2012,Oregon,3105372,1928581,62.1,1762465,56.8,166116,8.6
22580,November 2012,Pennsylvania,10169493,6494440,63.9,5981227,58.8,513213,7.9
22581,November 2012,Rhode Island,847577,558557,65.9,504183,59.5,54374,9.7
22582,November 2012,South Carolina,3673671,2188449,59.6,1999979,54.4,188470,8.6
22583,November 2012,South Dakota,633855,443353,69.9,425088,67.1,18265,4.1
22584,November 2012,Tennessee,5036333,3106236,61.7,2865816,56.9,240420,7.7
22585,November 2012,Texas,19465773,12755964,65.5,11932919,61.3,823045,6.5
22586,November 2012,Utah,2040700,1385729,67.9,1315424,64.5,70305,5.1
22587,November 2012,Vermont,511484,353371,69.1,336655,65.8,16716,4.7
22588,November 2012,Virginia,6349696,4234388,66.7,3986946,62.8,247442,5.8
22589,November 2012,Washington,5400423,3465690,64.2,3204626,59.3,261064,7.5
22590,November 2012,West Virginia,1486341,807834,54.4,747059,50.3,60775,7.5
22591,November 2012,Wisconsin,4491255,3076462,68.5,2865210,63.8,211252,6.9
22592,November 2012,Wyoming,446177,306920,68.8,290901,65.2,16019,5.2
22593,December 2012,Alabama,3753376,2182661,58.2,2017815,53.8,164846,7.6
22594,December 2012,Alaska,536933,365333,68.0,339858,63.3,25475,7.0
22595,December 2012,Arizona,5032756,3026754,60.1,2786776,55.4,239978,7.9
22596,December 2012,Arkansas,2269370,1325703,58.4,1226880,54.1,98823,7.5
22597,December 2012,California,29534498,18616736,63.0,16817255,56.9,1799481,9.7
22598,December 2012,Colorado,4022450,2768370,68.8,2561350,63.7,207020,7.5
22599,December 2012,Connecticut,2856017,1870703,65.5,1716939,60.1,153764,8.2
22600,December 2012,Delaware,724198,444127,61.3,411957,56.9,32170,7.2
22601,December 2012,District of Columbia,532784,374704,70.3,341961,64.2,32743,8.7
22602,December 2012,Florida,15584429,9443197,60.6,8690289,55.8,752908,8.0
22603,December 2012,Georgia,7524560,4786110,63.6,4368574,58.1,417536,8.7
22604,December 2012,Hawaii,1069116,645678,60.4,612064,57.2,33614,5.2
22605,December 2012,Idaho,1199381,768790,64.1,718199,59.9,50591,6.6
22606,December 2012,Illinois,10009663,6592027,65.9,5990669,59.8,601358,9.1
22607,December 2012,Indiana,5046180,3179250,63.0,2912145,57.7,267105,8.4
22608,December 2012,Iowa,2394911,1655811,69.1,1574099,65.7,81712,4.9
22609,December 2012,Kansas,2178841,1488770,68.3,1405512,64.5,83258,5.6
22610,December 2012,Kentucky,3395675,2069797,61.0,1902547,56.0,167250,8.1
22611,December 2012,Louisiana,3514711,2092629,59.5,1948748,55.4,143881,6.9
22612,December 2012,Maine,1083841,704418,65.0,653833,60.3,50585,7.2
22613,December 2012,Maryland,4625597,3133899,67.8,2918293,63.1,215606,6.9
22614,December 2012,Massachusetts,5375898,3505939,65.2,3268333,60.8,237606,6.8
22615,December 2012,Michigan,7799734,4697631,60.2,4271672,54.8,425959,9.1
22616,December 2012,Minnesota,4202151,2958803,70.4,2799077,66.6,159726,5.4
22617,December 2012,Mississippi,2257569,1298275,57.5,1182929,52.4,115346,8.9
22618,December 2012,Missouri,4679118,3023527,64.6,2815590,60.2,207937,6.9
22619,December 2012,Montana,794078,509093,64.1,480377,60.5,28716,5.6
22620,December 2012,Nebraska,1417112,1019812,72.0,979480,69.1,40332,4.0
22621,December 2012,Nevada,2145588,1380159,64.3,1235804,57.6,144355,10.5
22622,December 2012,New Hampshire,1068827,742764,69.5,701898,65.7,40866,5.5
22623,December 2012,New Jersey,7001124,4594449,65.6,4172901,59.6,421548,9.2
22624,December 2012,New Mexico,1593289,929497,58.3,864032,54.2,65465,7.0
22625,December 2012,New York,15662814,9659771,61.7,8868947,56.6,790824,8.2
22626,December 2012,North Carolina,7551103,4719804,62.5,4295807,56.9,423997,9.0
22627,December 2012,North Dakota,550718,402642,73.1,390233,70.9,12409,3.1
22628,December 2012,Ohio,9035884,5709772,63.2,5284153,58.5,425619,7.5
22629,December 2012,Oklahoma,2904500,1811131,62.4,1714754,59.0,96377,5.3
22630,December 2012,Oregon,3107650,1923380,61.9,1758815,56.6,164565,8.6
22631,December 2012,Pennsylvania,10171141,6492123,63.8,5979822,58.8,512301,7.9
22632,December 2012,Rhode Island,847735,558181,65.8,504668,59.5,53513,9.6
22633,December 2012,South Carolina,3677821,2186741,59.5,2000091,54.4,186650,8.5
22634,December 2012,South Dakota,634499,443215,69.9,425308,67.0,17907,4.0
22635,December 2012,Tennessee,5039792,3104212,61.6,2861299,56.8,242913,7.8
22636,December 2012,Texas,19495727,12768962,65.5,11941642,61.3,827320,6.5
22637,December 2012,Utah,2043920,1388824,67.9,1319092,64.5,69732,5.0
22638,December 2012,Vermont,511597,352681,68.9,336295,65.7,16386,4.6
22639,December 2012,Virginia,6355373,4235476,66.6,3988734,62.8,246742,5.8
22640,December 2012,Washington,5405542,3464263,64.1,3207318,59.3,256945,7.4
22641,December 2012,West Virginia,1486157,806563,54.3,746816,50.3,59747,7.4
22642,December 2012,Wisconsin,4493070,3077345,68.5,2865352,63.8,211993,6.9
22643,December 2012,Wyoming,446560,306883,68.7,291091,65.2,15792,5.1
22644,January 2013,Alabama,3754816,2181055,58.1,2017941,53.7,163114,7.5
22645,January 2013,Alaska,537228,365252,68.0,339758,63.2,25494,7.0
22646,January 2013,Arizona,5038591,3023927,60.0,2783920,55.3,240007,7.9
22647,January 2013,Arkansas,2270019,1325721,58.4,1227306,54.1,98415,7.4
22648,January 2013,California,29563516,18615393,63.0,16835906,56.9,1779487,9.6
22649,January 2013,Colorado,4028167,2767274,68.7,2562697,63.6,204577,7.4
22650,January 2013,Connecticut,2856986,1866104,65.3,1713860,60.0,152244,8.2
22651,January 2013,Delaware,724894,443397,61.2,411523,56.8,31874,7.2
22652,January 2013,District of Columbia,533631,374653,70.2,341899,64.1,32754,8.7
22653,January 2013,Florida,15602313,9432835,60.5,8691192,55.7,741643,7.9
22654,January 2013,Georgia,7531039,4784092,63.5,4368873,58.0,415219,8.7
22655,January 2013,Hawaii,1070098,645877,60.4,612783,57.3,33094,5.1
22656,January 2013,Idaho,1200487,770127,64.2,718500,59.9,51627,6.7
22657,January 2013,Illinois,10012303,6582499,65.7,5976602,59.7,605897,9.2
22658,January 2013,Indiana,5048523,3182174,63.0,2912845,57.7,269329,8.5
22659,January 2013,Iowa,2395937,1657808,69.2,1575926,65.8,81882,4.9
22660,January 2013,Kansas,2179378,1486639,68.2,1403681,64.4,82958,5.6
22661,January 2013,Kentucky,3397192,2068663,60.9,1901562,56.0,167101,8.1
22662,January 2013,Louisiana,3516417,2095766,59.6,1948681,55.4,147085,7.0
22663,January 2013,Maine,1083946,704819,65.0,654594,60.4,50225,7.1
22664,January 2013,Maryland,4628757,3134588,67.7,2919421,63.1,215167,6.9
22665,January 2013,Massachusetts,5380256,3506305,65.2,3267341,60.7,238964,6.8
22666,January 2013,Michigan,7801777,4703361,60.3,4275441,54.8,427920,9.1
22667,January 2013,Minnesota,4204663,2958448,70.4,2801058,66.6,157390,5.3
22668,January 2013,Mississippi,2258359,1292358,57.2,1177409,52.1,114949,8.9
22669,January 2013,Missouri,4680579,3028433,64.7,2820950,60.3,207483,6.9
22670,January 2013,Montana,794665,509413,64.1,480899,60.5,28514,5.6
22671,January 2013,Nebraska,1417854,1019936,71.9,979763,69.1,40173,3.9
22672,January 2013,Nevada,2148205,1379414,64.2,1236301,57.6,143113,10.4
22673,January 2013,New Hampshire,1069174,742467,69.4,701920,65.7,40547,5.5
22674,January 2013,New Jersey,7004277,4594280,65.6,4178849,59.7,415431,9.0
22675,January 2013,New Mexico,1593684,928424,58.3,863259,54.2,65165,7.0
22676,January 2013,New York,15670889,9655271,61.6,8869350,56.6,785921,8.1
22677,January 2013,North Carolina,7558764,4706939,62.3,4287015,56.7,419924,8.9
22678,January 2013,North Dakota,551966,402891,73.0,390510,70.7,12381,3.1
22679,January 2013,Ohio,9037830,5710874,63.2,5280284,58.4,430590,7.5
22680,January 2013,Oklahoma,2906672,1807341,62.2,1711853,58.9,95488,5.3
22681,January 2013,Oregon,3109714,1918564,61.7,1755911,56.5,162653,8.5
22682,January 2013,Pennsylvania,10172150,6485609,63.8,5975489,58.7,510120,7.9
22683,January 2013,Rhode Island,847809,557653,65.8,504878,59.6,52775,9.5
22684,January 2013,South Carolina,3682063,2194191,59.6,2009163,54.6,185028,8.4
22685,January 2013,South Dakota,635123,442860,69.7,425254,67.0,17606,4.0
22686,January 2013,Tennessee,5042893,3100704,61.5,2854608,56.6,246096,7.9
22687,January 2013,Texas,19525212,12782095,65.5,11950350,61.2,831745,6.5
22688,January 2013,Utah,2047007,1391627,68.0,1322501,64.6,69126,5.0
22689,January 2013,Vermont,511709,352098,68.8,335962,65.7,16136,4.6
22690,January 2013,Virginia,6360562,4233882,66.6,3987394,62.7,246488,5.8
22691,January 2013,Washington,5410287,3465517,64.1,3208679,59.3,256838,7.4
22692,January 2013,West Virginia,1485866,804599,54.2,746201,50.2,58398,7.3
22693,January 2013,Wisconsin,4494599,3078665,68.5,2864372,63.7,214293,7.0
22694,January 2013,Wyoming,446874,306849,68.7,291304,65.2,15545,5.1
22695,February 2013,Alabama,3755795,2180812,58.1,2019734,53.8,161078,7.4
22696,February 2013,Alaska,537374,365142,67.9,339624,63.2,25518,7.0
22697,February 2013,Arizona,5043653,3021932,59.9,2781860,55.2,240072,7.9
22698,February 2013,Arkansas,2270306,1326140,58.4,1227981,54.1,98159,7.4
22699,February 2013,California,29588526,18614456,62.9,16856557,57.0,1757899,9.4
22700,February 2013,Colorado,4033429,2765868,68.6,2563642,63.6,202226,7.3
22701,February 2013,Connecticut,2857588,1862393,65.2,1711389,59.9,151004,8.1
22702,February 2013,Delaware,725438,442719,61.0,411093,56.7,31626,7.1
22703,February 2013,District of Columbia,534386,374866,70.1,342173,64.0,32693,8.7
22704,February 2013,Florida,15617740,9428334,60.4,8696035,55.7,732299,7.8
22705,February 2013,Georgia,7536381,4776080,63.4,4363850,57.9,412230,8.6
22706,February 2013,Hawaii,1070875,646236,60.3,613585,57.3,32651,5.1
22707,February 2013,Idaho,1201470,769533,64.0,718847,59.8,50686,6.6
22708,February 2013,Illinois,10013414,6571939,65.6,5963501,59.6,608438,9.3
22709,February 2013,Indiana,5050243,3181912,63.0,2914139,57.7,267773,8.4
22710,February 2013,Iowa,2396635,1660293,69.3,1578214,65.9,82079,4.9
22711,February 2013,Kansas,2179585,1486147,68.2,1403748,64.4,82399,5.5
22712,February 2013,Kentucky,3398318,2067151,60.8,1899823,55.9,167328,8.1
22713,February 2013,Louisiana,3517765,2097870,59.6,1948351,55.4,149519,7.1
22714,February 2013,Maine,1083860,705153,65.1,655387,60.5,49766,7.1
22715,February 2013,Maryland,4631476,3134392,67.7,2919922,63.0,214470,6.8
22716,February 2013,Massachusetts,5383924,3506639,65.1,3266350,60.7,240289,6.9
22717,February 2013,Michigan,7802793,4706912,60.3,4279951,54.9,426961,9.1
22718,February 2013,Minnesota,4206810,2957536,70.3,2802512,66.6,155024,5.2
22719,February 2013,Mississippi,2258888,1288530,57.0,1173985,52.0,114545,8.9
22720,February 2013,Missouri,4681244,3022164,64.6,2815634,60.1,206530,6.8
22721,February 2013,Montana,795095,509850,64.1,481468,60.6,28382,5.6
22722,February 2013,Nebraska,1418389,1019913,71.9,979931,69.1,39982,3.9
22723,February 2013,Nevada,2150613,1379565,64.1,1237734,57.6,141831,10.3
22724,February 2013,New Hampshire,1069405,742191,69.4,702103,65.7,40088,5.4
22725,February 2013,New Jersey,7006558,4584049,65.4,4176045,59.6,408004,8.9
22726,February 2013,New Mexico,1593934,926830,58.1,862128,54.1,64702,7.0
22727,February 2013,New York,15677030,9651505,61.6,8872227,56.6,779278,8.1
22728,February 2013,North Carolina,7565191,4702054,62.2,4288636,56.7,413418,8.8
22729,February 2013,North Dakota,553139,403668,73.0,391355,70.8,12313,3.1
22730,February 2013,Ohio,9038680,5711661,63.2,5277748,58.4,433913,7.6
22731,February 2013,Oklahoma,2908397,1805240,62.1,1709016,58.8,96224,5.3
22732,February 2013,Oregon,3111384,1914533,61.5,1754171,56.4,160362,8.4
22733,February 2013,Pennsylvania,10171849,6476720,63.7,5970873,58.7,505847,7.8
22734,February 2013,Rhode Island,847845,557115,65.7,504900,59.6,52215,9.4
22735,February 2013,South Carolina,3685483,2191419,59.5,2008325,54.5,183094,8.4
22736,February 2013,South Dakota,635618,442604,69.6,425231,66.9,17373,3.9
22737,February 2013,Tennessee,5045459,3096126,61.4,2847440,56.4,248686,8.0
22738,February 2013,Texas,19552095,12791417,65.4,11955951,61.1,835466,6.5
22739,February 2013,Utah,2049914,1394091,68.0,1325786,64.7,68305,4.9
22740,February 2013,Vermont,511748,351601,68.7,335640,65.6,15961,4.5
22741,February 2013,Virginia,6365171,4231342,66.5,3985091,62.6,246251,5.8
22742,February 2013,Washington,5414427,3463646,64.0,3209467,59.3,254179,7.3
22743,February 2013,West Virginia,1485410,802673,54.0,745783,50.2,56890,7.1
22744,February 2013,Wisconsin,4495614,3078497,68.5,2863492,63.7,215005,7.0
22745,February 2013,Wyoming,447150,306804,68.6,291528,65.2,15276,5.0
22746,March 2013,Alabama,3756992,2179552,58.0,2021069,53.8,158483,7.3
22747,March 2013,Alaska,537488,365061,67.9,339539,63.2,25522,7.0
22748,March 2013,Arizona,5048897,3021364,59.8,2781934,55.1,239430,7.9
22749,March 2013,Arkansas,2270819,1326434,58.4,1228455,54.1,97979,7.4
22750,March 2013,California,29613004,18614695,62.9,16880238,57.0,1734457,9.3
22751,March 2013,Colorado,4038774,2765227,68.5,2565296,63.5,199931,7.2
22752,March 2013,Connecticut,2858350,1860344,65.1,1710431,59.8,149913,8.1
22753,March 2013,Delaware,726019,442088,60.9,410795,56.6,31293,7.1
22754,March 2013,District of Columbia,535156,374843,70.0,342279,64.0,32564,8.7
22755,March 2013,Florida,15633537,9428809,60.3,8707601,55.7,721208,7.6
22756,March 2013,Georgia,7542026,4769314,63.2,4361032,57.8,408282,8.6
22757,March 2013,Hawaii,1071373,646805,60.4,614550,57.4,32255,5.0
22758,March 2013,Idaho,1202551,769256,64.0,719405,59.8,49851,6.5
22759,March 2013,Illinois,10015169,6563015,65.5,5955200,59.5,607815,9.3
22760,March 2013,Indiana,5052517,3181709,63.0,2917519,57.7,264190,8.3
22761,March 2013,Iowa,2397523,1663533,69.4,1581458,66.0,82075,4.9
22762,March 2013,Kansas,2179880,1485814,68.2,1404095,64.4,81719,5.5
22763,March 2013,Kentucky,3399654,2065749,60.8,1898143,55.8,167606,8.1
22764,March 2013,Louisiana,3519265,2099138,59.6,1948749,55.4,150389,7.2
22765,March 2013,Maine,1083949,705438,65.1,656261,60.5,49177,7.0
22766,March 2013,Maryland,4634233,3133730,67.6,2920462,63.0,213268,6.8
22767,March 2013,Massachusetts,5388019,3507938,65.1,3266573,60.6,241365,6.9
22768,March 2013,Michigan,7804541,4711042,60.4,4286557,54.9,424485,9.0
22769,March 2013,Minnesota,4209295,2956696,70.2,2803957,66.6,152739,5.2
22770,March 2013,Mississippi,2259448,1285054,56.9,1171222,51.8,113832,8.9
22771,March 2013,Missouri,4682423,3018206,64.5,2812786,60.1,205420,6.8
22772,March 2013,Montana,795623,510186,64.1,481898,60.6,28288,5.5
22773,March 2013,Nebraska,1419032,1019828,71.9,980071,69.1,39757,3.9
22774,March 2013,Nevada,2153010,1379976,64.1,1239648,57.6,140328,10.2
22775,March 2013,New Hampshire,1069731,741926,69.4,702439,65.7,39487,5.3
22776,March 2013,New Jersey,7009162,4574555,65.3,4174535,59.6,400020,8.7
22777,March 2013,New Mexico,1594061,925144,58.0,860995,54.0,64149,6.9
22778,March 2013,New York,15683823,9651758,61.5,8880955,56.6,770803,8.0
22779,March 2013,North Carolina,7571636,4696913,62.0,4291728,56.7,405185,8.6
22780,March 2013,North Dakota,554377,404388,72.9,392174,70.7,12214,3.0
22781,March 2013,Ohio,9040363,5713245,63.2,5278662,58.4,434583,7.6
22782,March 2013,Oklahoma,2910275,1803826,62.0,1707237,58.7,96589,5.4
22783,March 2013,Oregon,3113334,1911585,61.4,1753830,56.3,157755,8.3
22784,March 2013,Pennsylvania,10172417,6468145,63.6,5968960,58.7,499185,7.7
22785,March 2013,Rhode Island,847884,556680,65.7,504832,59.5,51848,9.3
22786,March 2013,South Carolina,3689090,2189284,59.3,2008920,54.5,180364,8.2
22787,March 2013,South Dakota,636181,442425,69.5,425222,66.8,17203,3.9
22788,March 2013,Tennessee,5048309,3091218,61.2,2841783,56.3,249435,8.1
22789,March 2013,Texas,19578818,12804276,65.4,11969681,61.1,834595,6.5
22790,March 2013,Utah,2052980,1396655,68.0,1329253,64.7,67402,4.8
22791,March 2013,Vermont,511838,351208,68.6,335359,65.5,15849,4.5
22792,March 2013,Virginia,6369536,4230364,66.4,3984797,62.6,245567,5.8
22793,March 2013,Washington,5418746,3462290,63.9,3210734,59.3,251556,7.3
22794,March 2013,West Virginia,1485108,800945,53.9,745534,50.2,55411,6.9
22795,March 2013,Wisconsin,4497024,3078567,68.5,2864048,63.7,214519,7.0
22796,March 2013,Wyoming,447490,306746,68.5,291757,65.2,14989,4.9
22797,April 2013,Alabama,3758360,2178107,58.0,2022206,53.8,155901,7.2
22798,April 2013,Alaska,537558,365073,67.9,339583,63.2,25490,7.0
22799,April 2013,Arizona,5054367,3023002,59.8,2784799,55.1,238203,7.9
22800,April 2013,Arkansas,2271426,1326202,58.4,1228419,54.1,97783,7.4
22801,April 2013,California,29639301,18622241,62.8,16910983,57.1,1711258,9.2
22802,April 2013,Colorado,4044208,2766087,68.4,2568489,63.5,197598,7.1
22803,April 2013,Connecticut,2859291,1860317,65.1,1711456,59.9,148861,8.0
22804,April 2013,Delaware,726664,441632,60.8,410760,56.5,30872,7.0
22805,April 2013,District of Columbia,535974,374688,69.9,342323,63.9,32365,8.6
22806,April 2013,Florida,15650178,9438181,60.3,8729119,55.8,709062,7.5
22807,April 2013,Georgia,7548022,4765488,63.1,4362061,57.8,403427,8.5
22808,April 2013,Hawaii,1071842,647585,60.4,615685,57.4,31900,4.9
22809,April 2013,Idaho,1203712,769331,63.9,720215,59.8,49116,6.4
22810,April 2013,Illinois,10017626,6558406,65.5,5953676,59.4,604730,9.2
22811,April 2013,Indiana,5055036,3182826,63.0,2923774,57.8,259052,8.1
22812,April 2013,Iowa,2398580,1667620,69.5,1585820,66.1,81800,4.9
22813,April 2013,Kansas,2180212,1485983,68.2,1404882,64.4,81101,5.5
22814,April 2013,Kentucky,3401099,2064835,60.7,1897226,55.8,167609,8.1
22815,April 2013,Louisiana,3520874,2100337,59.7,1950743,55.4,149594,7.1
22816,April 2013,Maine,1084092,705741,65.1,657244,60.6,48497,6.9
22817,April 2013,Maryland,4637215,3132990,67.6,2921598,63.0,211392,6.7
22818,April 2013,Massachusetts,5392366,3510733,65.1,3268819,60.6,241914,6.9
22819,April 2013,Michigan,7806647,4717423,60.4,4295938,55.0,421485,8.9
22820,April 2013,Minnesota,4212016,2956563,70.2,2805906,66.6,150657,5.1
22821,April 2013,Mississippi,2260137,1281875,56.7,1169180,51.7,112695,8.8
22822,April 2013,Missouri,4683797,3018139,64.4,2813392,60.1,204747,6.8
22823,April 2013,Montana,796141,510345,64.1,482166,60.6,28179,5.5
22824,April 2013,Nebraska,1419701,1019729,71.8,980226,69.0,39503,3.9
22825,April 2013,Nevada,2155519,1380739,64.1,1242168,57.6,138571,10.0
22826,April 2013,New Hampshire,1070101,741676,69.3,702866,65.7,38810,5.2
22827,April 2013,New Jersey,7012188,4567974,65.1,4175392,59.5,392582,8.6
22828,April 2013,New Mexico,1594326,923860,57.9,860204,54.0,63656,6.9
22829,April 2013,New York,15691572,9660078,61.6,8897969,56.7,762109,7.9
22830,April 2013,North Carolina,7578231,4694011,61.9,4298091,56.7,395920,8.4
22831,April 2013,North Dakota,555574,405056,72.9,392959,70.7,12097,3.0
22832,April 2013,Ohio,9042514,5717068,63.2,5283842,58.4,433226,7.6
22833,April 2013,Oklahoma,2912297,1803639,61.9,1707121,58.6,96518,5.4
22834,April 2013,Oregon,3115423,1909970,61.3,1754910,56.3,155060,8.1
22835,April 2013,Pennsylvania,10173518,6462138,63.5,5971194,58.7,490944,7.6
22836,April 2013,Rhode Island,847973,556398,65.6,504748,59.5,51650,9.3
22837,April 2013,South Carolina,3692840,2188745,59.3,2011747,54.5,176998,8.1
22838,April 2013,South Dakota,636763,442384,69.5,425312,66.8,17072,3.9
22839,April 2013,Tennessee,5051422,3087054,61.1,2838906,56.2,248148,8.0
22840,April 2013,Texas,19606642,12823913,65.4,11994866,61.2,829047,6.5
22841,April 2013,Utah,2056158,1399488,68.1,1332981,64.8,66507,4.8
22842,April 2013,Vermont,511933,350902,68.5,335131,65.5,15771,4.5
22843,April 2013,Virginia,6373907,4232476,66.4,3988103,62.6,244373,5.8
22844,April 2013,Washington,5423159,3462153,63.8,3213298,59.3,248855,7.2
22845,April 2013,West Virginia,1484868,799753,53.9,745613,50.2,54140,6.8
22846,April 2013,Wisconsin,4498713,3079492,68.5,2866689,63.7,212803,6.9
22847,April 2013,Wyoming,447801,306679,68.5,291974,65.2,14705,4.8
22848,May 2013,Alabama,3759895,2176524,57.9,2022526,53.8,153998,7.1
22849,May 2013,Alaska,538053,365154,67.9,339715,63.1,25439,7.0
22850,May 2013,Arizona,5060111,3025925,59.8,2788992,55.1,236933,7.8
22851,May 2013,Arkansas,2272121,1325281,58.3,1227772,54.0,97509,7.4
22852,May 2013,California,29667569,18634480,62.8,16942752,57.1,1691728,9.1
22853,May 2013,Colorado,4050295,2767770,68.3,2572419,63.5,195351,7.1
22854,May 2013,Connecticut,2860376,1861705,65.1,1713811,59.9,147894,7.9
22855,May 2013,Delaware,727312,441417,60.7,411042,56.5,30375,6.9
22856,May 2013,District of Columbia,536787,374435,69.8,342266,63.8,32169,8.6
22857,May 2013,Florida,15668134,9451917,60.3,8754618,55.9,697299,7.4
22858,May 2013,Georgia,7554918,4763632,63.1,4365206,57.8,398426,8.4
22859,May 2013,Hawaii,1073161,648595,60.4,616980,57.5,31615,4.9
22860,May 2013,Idaho,1204938,769668,63.9,721176,59.9,48492,6.3
22861,May 2013,Illinois,10020486,6556908,65.4,5955695,59.4,601213,9.2
22862,May 2013,Indiana,5057594,3184914,63.0,2931401,58.0,253513,8.0
22863,May 2013,Iowa,2399718,1671900,69.7,1590692,66.3,81208,4.9
22864,May 2013,Kansas,2181044,1486465,68.2,1405879,64.5,80586,5.4
22865,May 2013,Kentucky,3402940,2063856,60.6,1896406,55.7,167450,8.1
22866,May 2013,Louisiana,3522782,2101514,59.7,1953900,55.5,147614,7.0
22867,May 2013,Maine,1084234,706045,65.1,658276,60.7,47769,6.8
22868,May 2013,Maryland,4640536,3132238,67.5,2922988,63.0,209250,6.7
22869,May 2013,Massachusetts,5396872,3514060,65.1,3272148,60.6,241912,6.9
22870,May 2013,Michigan,7808729,4724984,60.5,4305660,55.1,419324,8.9
22871,May 2013,Minnesota,4214804,2957110,70.2,2808169,66.6,148941,5.0
22872,May 2013,Mississippi,2261048,1278524,56.5,1167311,51.6,111213,8.7
22873,May 2013,Missouri,4685577,3020703,64.5,2816017,60.1,204686,6.8
22874,May 2013,Montana,796739,510327,64.1,482291,60.5,28036,5.5
22875,May 2013,Nebraska,1420567,1019559,71.8,980340,69.0,39219,3.8
22876,May 2013,Nevada,2158238,1381585,64.0,1244919,57.7,136666,9.9
22877,May 2013,New Hampshire,1070533,741427,69.3,703277,65.7,38150,5.1
22878,May 2013,New Jersey,7015215,4563611,65.1,4176838,59.5,386773,8.5
22879,May 2013,New Mexico,1594706,923102,57.9,859685,53.9,63417,6.9
22880,May 2013,New York,15699326,9672985,61.6,8917413,56.8,755572,7.8
22881,May 2013,North Carolina,7586754,4693173,61.9,4306304,56.8,386869,8.2
22882,May 2013,North Dakota,556950,405653,72.8,393686,70.7,11967,3.0
22883,May 2013,Ohio,9044755,5721942,63.3,5290204,58.5,431738,7.5
22884,May 2013,Oklahoma,2914664,1804215,61.9,1708011,58.6,96204,5.3
22885,May 2013,Oregon,3117543,1909278,61.2,1756713,56.3,152565,8.0
22886,May 2013,Pennsylvania,10174833,6457576,63.5,5974768,58.7,482808,7.5
22887,May 2013,Rhode Island,848110,556300,65.6,504724,59.5,51576,9.3
22888,May 2013,South Carolina,3697315,2189813,59.2,2016341,54.5,173472,7.9
22889,May 2013,South Dakota,637395,442478,69.4,425520,66.8,16958,3.8
22890,May 2013,Tennessee,5054864,3082793,61.0,2837130,56.1,245663,8.0
22891,May 2013,Texas,19636146,12846262,65.4,12024923,61.2,821339,6.4
22892,May 2013,Utah,2059368,1402385,68.1,1336692,64.9,65693,4.7
22893,May 2013,Vermont,512061,350653,68.5,334953,65.4,15700,4.5
22894,May 2013,Virginia,6380609,4236360,66.4,3993156,62.6,243204,5.7
22895,May 2013,Washington,5428554,3462821,63.8,3216430,59.3,246391,7.1
22896,May 2013,West Virginia,1484649,798997,53.8,745774,50.2,53223,6.7
22897,May 2013,Wisconsin,4500477,3080726,68.5,2870274,63.8,210452,6.8
22898,May 2013,Wyoming,448201,306617,68.4,292152,65.2,14465,4.7
22899,June 2013,Alabama,3761696,2174765,57.8,2021523,53.7,153242,7.0
22900,June 2013,Alaska,537981,365262,67.9,339843,63.2,25419,7.0
22901,June 2013,Arizona,5066195,3028952,59.8,2792987,55.1,235965,7.8
22902,June 2013,Arkansas,2273057,1324000,58.2,1226874,54.0,97126,7.3
22903,June 2013,California,29696502,18645876,62.8,16968882,57.1,1676994,9.0
22904,June 2013,Colorado,4056074,2769223,68.3,2576118,63.5,193105,7.0
22905,June 2013,Connecticut,2861683,1863418,65.1,1716463,60.0,146955,7.9
22906,June 2013,Delaware,728016,441465,60.6,411635,56.5,29830,6.8
22907,June 2013,District of Columbia,537628,374101,69.6,342076,63.6,32025,8.6
22908,June 2013,Florida,15686902,9464347,60.3,8777249,56.0,687098,7.3
22909,June 2013,Georgia,7561513,4761816,63.0,4368131,57.8,393685,8.3
22910,June 2013,Hawaii,1073421,649820,60.5,618374,57.6,31446,4.8
22911,June 2013,Idaho,1206273,770199,63.8,722261,59.9,47938,6.2
22912,June 2013,Illinois,10024340,6556074,65.4,5957303,59.4,598771,9.1
22913,June 2013,Indiana,5060925,3187584,63.0,2939083,58.1,248501,7.8
22914,June 2013,Iowa,2401245,1675671,69.8,1595295,66.4,80376,4.8
22915,June 2013,Kansas,2181618,1486898,68.2,1406811,64.5,80087,5.4
22916,June 2013,Kentucky,3404821,2062221,60.6,1894931,55.7,167290,8.1
22917,June 2013,Louisiana,3524710,2102566,59.7,1957422,55.5,145144,6.9
22918,June 2013,Maine,1084557,706309,65.1,659246,60.8,47063,6.7
22919,June 2013,Maryland,4643891,3131551,67.4,2924211,63.0,207340,6.6
22920,June 2013,Massachusetts,5402153,3516697,65.1,3275355,60.6,241342,6.9
22921,June 2013,Michigan,7812094,4732138,60.6,4313404,55.2,418734,8.8
22922,June 2013,Minnesota,4218257,2957938,70.1,2810445,66.6,147493,5.0
22923,June 2013,Mississippi,2261953,1274902,56.4,1165168,51.5,109734,8.6
22924,June 2013,Missouri,4687674,3023445,64.5,2818684,60.1,204761,6.8
22925,June 2013,Montana,797401,510270,64.0,482407,60.5,27863,5.5
22926,June 2013,Nebraska,1421488,1019251,71.7,980370,69.0,38881,3.8
22927,June 2013,Nevada,2160930,1382208,64.0,1247511,57.7,134697,9.7
22928,June 2013,New Hampshire,1071072,741194,69.2,703602,65.7,37592,5.1
22929,June 2013,New Jersey,7019191,4559345,65.0,4177318,59.5,382027,8.4
22930,June 2013,New Mexico,1595066,922686,57.8,859209,53.9,63477,6.9
22931,June 2013,New York,15709080,9685182,61.7,8932756,56.9,752426,7.8
22932,June 2013,North Carolina,7593608,4693545,61.8,4314695,56.8,378850,8.1
22933,June 2013,North Dakota,558241,406196,72.8,394364,70.6,11832,2.9
22934,June 2013,Ohio,9048293,5726408,63.3,5294634,58.5,431774,7.5
22935,June 2013,Oklahoma,2917022,1804808,61.9,1708896,58.6,95912,5.3
22936,June 2013,Oregon,3120197,1908985,61.2,1758586,56.4,150399,7.9
22937,June 2013,Pennsylvania,10177709,6452910,63.4,5976455,58.7,476455,7.4
22938,June 2013,Rhode Island,848307,556409,65.6,504847,59.5,51562,9.3
22939,June 2013,South Carolina,3701346,2191736,59.2,2021573,54.6,170163,7.8
22940,June 2013,South Dakota,638072,442689,69.4,425837,66.7,16852,3.8
22941,June 2013,Tennessee,5058576,3077449,60.8,2834469,56.0,242980,7.9
22942,June 2013,Texas,19665794,12866183,65.4,12052275,61.3,813908,6.3
22943,June 2013,Utah,2062826,1405140,68.1,1340161,65.0,64979,4.6
22944,June 2013,Vermont,512259,350450,68.4,334828,65.4,15622,4.5
22945,June 2013,Virginia,6385262,4240390,66.4,3997692,62.6,242698,5.7
22946,June 2013,Washington,5433488,3463764,63.7,3219285,59.2,244479,7.1
22947,June 2013,West Virginia,1484665,798464,53.8,745717,50.2,52747,6.6
22948,June 2013,Wisconsin,4502945,3081531,68.4,2873381,63.8,208150,6.8
22949,June 2013,Wyoming,448597,306561,68.3,292274,65.2,14287,4.7
22950,July 2013,Alabama,3763574,2173167,57.7,2019444,53.7,153723,7.1
22951,July 2013,Alaska,538372,365373,67.9,339939,63.1,25434,7.0
22952,July 2013,Arizona,5072430,3031474,59.8,2796196,55.1,235278,7.8
22953,July 2013,Arkansas,2274017,1322766,58.2,1226174,53.9,96592,7.3
22954,July 2013,California,29726450,18652081,62.7,16987525,57.1,1664556,8.9
22955,July 2013,Colorado,4062317,2769763,68.2,2579207,63.5,190556,6.9
22956,July 2013,Connecticut,2863064,1864609,65.1,1718658,60.0,145951,7.8
22957,July 2013,Delaware,728737,441767,60.6,412491,56.6,29276,6.6
22958,July 2013,District of Columbia,538523,373806,69.4,341917,63.5,31889,8.5
22959,July 2013,Florida,15706162,9471902,60.3,8793877,56.0,678025,7.2
22960,July 2013,Georgia,7568310,4758794,62.9,4369634,57.7,389160,8.2
22961,July 2013,Hawaii,1074394,651268,60.6,619844,57.7,31424,4.8
22962,July 2013,Idaho,1207609,770775,63.8,723471,59.9,47304,6.1
22963,July 2013,Illinois,10027840,6553792,65.4,5956577,59.4,597215,9.1
22964,July 2013,Indiana,5064133,3190762,63.0,2946803,58.2,243959,7.6
22965,July 2013,Iowa,2402669,1678587,69.9,1599183,66.6,79404,4.7
22966,July 2013,Kansas,2182487,1487012,68.1,1407581,64.5,79431,5.3
22967,July 2013,Kentucky,3406878,2059502,60.5,1892618,55.6,166884,8.1
22968,July 2013,Louisiana,3526927,2103477,59.6,1960947,55.6,142530,6.8
22969,July 2013,Maine,1084853,706447,65.1,660040,60.8,46407,6.6
22970,July 2013,Maryland,4647560,3130720,67.4,2925103,62.9,205617,6.6
22971,July 2013,Massachusetts,5407292,3517932,65.1,3277961,60.6,239971,6.8
22972,July 2013,Michigan,7815246,4737307,60.6,4318219,55.3,419088,8.8
22973,July 2013,Minnesota,4221587,2958811,70.1,2812690,66.6,146121,4.9
22974,July 2013,Mississippi,2262994,1271083,56.2,1162748,51.4,108335,8.5
22975,July 2013,Missouri,4689810,3024493,64.5,2820140,60.1,204353,6.8
22976,July 2013,Montana,798071,510389,64.0,482699,60.5,27690,5.4
22977,July 2013,Nebraska,1422464,1018741,71.6,980287,68.9,38454,3.8
22978,July 2013,Nevada,2163774,1382407,63.9,1249781,57.8,132626,9.6
22979,July 2013,New Hampshire,1071617,741005,69.1,703834,65.7,37171,5.0
22980,July 2013,New Jersey,7023032,4552908,64.8,4176414,59.5,376494,8.3
22981,July 2013,New Mexico,1595575,922517,57.8,858771,53.8,63746,6.9
22982,July 2013,New York,15718739,9692150,61.7,8941331,56.9,750819,7.7
22983,July 2013,North Carolina,7602156,4694477,61.8,4322873,56.9,371604,7.9
22984,July 2013,North Dakota,559609,406698,72.7,394991,70.6,11707,2.9
22985,July 2013,Ohio,9051710,5729085,63.3,5296371,58.5,432714,7.6
22986,July 2013,Oklahoma,2919480,1804774,61.8,1709059,58.5,95715,5.3
22987,July 2013,Oregon,3122696,1908801,61.1,1760355,56.4,148446,7.8
22988,July 2013,Pennsylvania,10180339,6446904,63.3,5974715,58.7,472189,7.3
22989,July 2013,Rhode Island,848539,556682,65.6,505112,59.5,51570,9.3
22990,July 2013,South Carolina,3705551,2193371,59.2,2026367,54.7,167004,7.6
22991,July 2013,South Dakota,638761,442951,69.3,426207,66.7,16744,3.8
22992,July 2013,Tennessee,5062451,3070706,60.7,2830075,55.9,240631,7.8
22993,July 2013,Texas,19696339,12881306,65.4,12073900,61.3,807406,6.3
22994,July 2013,Utah,2066293,1407731,68.1,1343422,65.0,64309,4.6
22995,July 2013,Vermont,512452,350269,68.4,334747,65.3,15522,4.4
22996,July 2013,Virginia,6391322,4243329,66.4,4000637,62.6,242692,5.7
22997,July 2013,Washington,5439064,3464802,63.7,3221747,59.2,243055,7.0
22998,July 2013,West Virginia,1484663,797952,53.7,745311,50.2,52641,6.6
22999,July 2013,Wisconsin,4505245,3081684,68.4,2875314,63.8,206370,6.7
23000,July 2013,Wyoming,449010,306532,68.3,292348,65.1,14184,4.6
23001,August 2013,Alabama,3765189,2171405,57.7,2016769,53.6,154636,7.1
23002,August 2013,Alaska,538852,365454,67.8,340011,63.1,25443,7.0
23003,August 2013,Arizona,5080252,3032939,59.7,2798714,55.1,234225,7.7
23004,August 2013,Arkansas,2275006,1321408,58.1,1225720,53.9,95688,7.2
23005,August 2013,California,29759097,18647231,62.7,17000090,57.1,1647141,8.8
23006,August 2013,Colorado,4069142,2769026,68.0,2581863,63.4,187163,6.8
23007,August 2013,Connecticut,2864063,1864989,65.1,1720349,60.1,144640,7.8
23008,August 2013,Delaware,729650,442276,60.6,413528,56.7,28748,6.5
23009,August 2013,District of Columbia,539175,373615,69.3,341931,63.4,31684,8.5
23010,August 2013,Florida,15731856,9472085,60.2,8804454,56.0,667631,7.0
23011,August 2013,Georgia,7576678,4753285,62.7,4369676,57.7,383609,8.1
23012,August 2013,Hawaii,1075573,652939,60.7,621437,57.8,31502,4.8
23013,August 2013,Idaho,1209179,771321,63.8,724848,59.9,46473,6.0
23014,August 2013,Illinois,10029928,6547571,65.3,5954206,59.4,593365,9.1
23015,August 2013,Indiana,5066813,3192815,63.0,2954613,58.3,238202,7.5
23016,August 2013,Iowa,2403975,1680556,69.9,1602276,66.7,78280,4.7
23017,August 2013,Kansas,2183780,1486564,68.1,1408273,64.5,78291,5.3
23018,August 2013,Kentucky,3408502,2055073,60.3,1889503,55.4,165570,8.1
23019,August 2013,Louisiana,3529167,2103643,59.6,1964537,55.7,139106,6.6
23020,August 2013,Maine,1085208,706313,65.1,660549,60.9,45764,6.5
23021,August 2013,Maryland,4650752,3129141,67.3,2925572,62.9,203569,6.5
23022,August 2013,Massachusetts,5411979,3517355,65.0,3280063,60.6,237292,6.7
23023,August 2013,Michigan,7818370,4737880,60.6,4320513,55.3,417367,8.8
23024,August 2013,Minnesota,4224477,2959293,70.1,2814962,66.6,144331,4.9
23025,August 2013,Mississippi,2263775,1267008,56.0,1160254,51.3,106754,8.4
23026,August 2013,Missouri,4691880,3022915,64.4,2820313,60.1,202602,6.7
23027,August 2013,Montana,798741,510712,63.9,483211,60.5,27501,5.4
23028,August 2013,Nebraska,1423439,1017998,71.5,980104,68.9,37894,3.7
23029,August 2013,Nevada,2167426,1382095,63.8,1251766,57.8,130329,9.4
23030,August 2013,New Hampshire,1072318,740857,69.1,704023,65.7,36834,5.0
23031,August 2013,New Jersey,7026664,4542657,64.6,4174222,59.4,368435,8.1
23032,August 2013,New Mexico,1596138,922566,57.8,858535,53.8,64031,6.9
23033,August 2013,New York,15726368,9687837,61.6,8942726,56.9,745111,7.7
23034,August 2013,North Carolina,7611271,4693963,61.7,4330674,56.9,363289,7.7
23035,August 2013,North Dakota,560660,407135,72.6,395535,70.5,11600,2.8
23036,August 2013,Ohio,9055299,5727598,63.3,5296246,58.5,431352,7.5
23037,August 2013,Oklahoma,2921606,1803680,61.7,1708323,58.5,95357,5.3
23038,August 2013,Oregon,3126116,1908410,61.0,1762092,56.4,146318,7.7
23039,August 2013,Pennsylvania,10183109,6437449,63.2,5970378,58.6,467071,7.3
23040,August 2013,Rhode Island,848941,556982,65.6,505429,59.5,51553,9.3
23041,August 2013,South Carolina,3710009,2193690,59.1,2030507,54.7,163183,7.4
23042,August 2013,South Dakota,639246,443230,69.3,426610,66.7,16620,3.7
23043,August 2013,Tennessee,5066709,3061555,60.4,2824144,55.7,237411,7.8
23044,August 2013,Texas,19731229,12889379,65.3,12090790,61.3,798589,6.2
23045,August 2013,Utah,2069283,1410108,68.1,1346638,65.1,63470,4.5
23046,August 2013,Vermont,512560,350093,68.3,334713,65.3,15380,4.4
23047,August 2013,Virginia,6397214,4243935,66.3,4001894,62.6,242041,5.7
23048,August 2013,Washington,5446307,3465091,63.6,3223955,59.2,241136,7.0
23049,August 2013,West Virginia,1484532,797285,53.7,744561,50.2,52724,6.6
23050,August 2013,Wisconsin,4507226,3080854,68.4,2876301,63.8,204553,6.6
23051,August 2013,Wyoming,449135,306522,68.2,292385,65.1,14137,4.6
23052,September 2013,Alabama,3766913,2169270,57.6,2013925,53.5,155345,7.2
23053,September 2013,Alaska,538916,365511,67.8,340073,63.1,25438,7.0
23054,September 2013,Arizona,5088177,3033776,59.6,2801365,55.1,232411,7.7
23055,September 2013,Arkansas,2276090,1319612,58.0,1225301,53.8,94311,7.1
23056,September 2013,California,29791651,18632088,62.5,17010624,57.1,1621464,8.7
23057,September 2013,Colorado,4075686,2767659,67.9,2584827,63.4,182832,6.6
23058,September 2013,Connecticut,2865167,1865002,65.1,1722150,60.1,142852,7.7
23059,September 2013,Delaware,730610,442934,60.6,414644,56.8,28290,6.4
23060,September 2013,District of Columbia,539839,373517,69.2,342135,63.4,31382,8.4
23061,September 2013,Florida,15757609,9467499,60.1,8812072,55.9,655427,6.9
23062,September 2013,Georgia,7585025,4745704,62.6,4369134,57.6,376570,7.9
23063,September 2013,Hawaii,1076242,654749,60.8,623139,57.9,31610,4.8
23064,September 2013,Idaho,1210795,771895,63.8,726443,60.0,45452,5.9
23065,September 2013,Illinois,10032503,6538493,65.2,5952790,59.3,585703,9.0
23066,September 2013,Indiana,5069756,3192847,63.0,2962355,58.4,230492,7.2
23067,September 2013,Iowa,2405460,1681833,69.9,1604751,66.7,77082,4.6
23068,September 2013,Kansas,2184880,1485783,68.0,1409064,64.5,76719,5.2
23069,September 2013,Kentucky,3410095,2049298,60.1,1885919,55.3,163379,8.0
23070,September 2013,Louisiana,3531415,2102914,59.5,1968399,55.7,134515,6.4
23071,September 2013,Maine,1085663,705866,65.0,660735,60.9,45131,6.4
23072,September 2013,Maryland,4653961,3126736,67.2,2925718,62.9,201018,6.4
23073,September 2013,Massachusetts,5416938,3515673,64.9,3282306,60.6,233367,6.6
23074,September 2013,Michigan,7821999,4734194,60.5,4322206,55.3,411988,8.7
23075,September 2013,Minnesota,4227615,2959346,70.0,2817257,66.6,142089,4.8
23076,September 2013,Mississippi,2264537,1262896,55.8,1157885,51.1,105011,8.3
23077,September 2013,Missouri,4694053,3020000,64.3,2820028,60.1,199972,6.6
23078,September 2013,Montana,799417,511146,63.9,483891,60.5,27255,5.3
23079,September 2013,Nebraska,1424460,1017086,71.4,979887,68.8,37199,3.7
23080,September 2013,Nevada,2171075,1381434,63.6,1253656,57.7,127778,9.2
23081,September 2013,New Hampshire,1073025,740755,69.0,704241,65.6,36514,4.9
23082,September 2013,New Jersey,7030649,4529217,64.4,4171484,59.3,357733,7.9
23083,September 2013,New Mexico,1596596,922837,57.8,858644,53.8,64193,7.0
23084,September 2013,New York,15734795,9671445,61.5,8938974,56.8,732471,7.6
23085,September 2013,North Carolina,7619224,4690536,61.6,4337411,56.9,353125,7.5
23086,September 2013,North Dakota,561657,407517,72.6,395998,70.5,11519,2.8
23087,September 2013,Ohio,9059334,5721899,63.2,5296165,58.5,425734,7.4
23088,September 2013,Oklahoma,2923721,1801696,61.6,1707017,58.4,94679,5.3
23089,September 2013,Oregon,3129673,1907949,61.0,1763894,56.4,144055,7.6
23090,September 2013,Pennsylvania,10186461,6424324,63.1,5965324,58.6,459000,7.1
23091,September 2013,Rhode Island,849344,557190,65.6,505754,59.5,51436,9.2
23092,September 2013,South Carolina,3714387,2192758,59.0,2034334,54.8,158424,7.2
23093,September 2013,South Dakota,639715,443529,69.3,427061,66.8,16468,3.7
23094,September 2013,Tennessee,5070980,3050317,60.2,2817923,55.6,232394,7.6
23095,September 2013,Texas,19765865,12892798,65.2,12106935,61.3,785863,6.1
23096,September 2013,Utah,2072335,1412304,68.2,1349876,65.1,62428,4.4
23097,September 2013,Vermont,512671,349922,68.3,334732,65.3,15190,4.3
23098,September 2013,Virginia,6402148,4242422,66.3,4002314,62.5,240108,5.7
23099,September 2013,Washington,5453224,3464302,63.5,3226128,59.2,238174,6.9
23100,September 2013,West Virginia,1484536,796583,53.7,743643,50.1,52940,6.6
23101,September 2013,Wisconsin,4509511,3079146,68.3,2877163,63.8,201983,6.6
23102,September 2013,Wyoming,449230,306498,68.2,292395,65.1,14103,4.6
23103,October 2013,Alabama,3768585,2167625,57.5,2011611,53.4,156014,7.2
23104,October 2013,Alaska,539069,365552,67.8,340102,63.1,25450,7.0
23105,October 2013,Arizona,5095935,3035645,59.6,2805357,55.1,230288,7.6
23106,October 2013,Arkansas,2277119,1317651,57.9,1224973,53.8,92678,7.0
23107,October 2013,California,29823453,18617976,62.4,17024977,57.1,1592999,8.6
23108,October 2013,Colorado,4082232,2767060,67.8,2588943,63.4,178117,6.4
23109,October 2013,Connecticut,2866181,1865500,65.1,1724658,60.2,140842,7.5
23110,October 2013,Delaware,731513,443679,60.7,415741,56.8,27938,6.3
23111,October 2013,District of Columbia,540504,373482,69.1,342472,63.4,31010,8.3
23112,October 2013,Florida,15783064,9466257,60.0,8821673,55.9,644584,6.8
23113,October 2013,Georgia,7593431,4739064,62.4,4369491,57.5,369573,7.8
23114,October 2013,Hawaii,1076810,656561,61.0,624895,58.0,31666,4.8
23115,October 2013,Idaho,1212380,772545,63.7,728225,60.1,44320,5.7
23116,October 2013,Illinois,10035029,6531285,65.1,5955019,59.3,576266,8.8
23117,October 2013,Indiana,5072639,3192201,62.9,2970053,58.6,222148,7.0
23118,October 2013,Iowa,2406861,1682991,69.9,1606869,66.8,76122,4.5
23119,October 2013,Kansas,2185925,1485261,67.9,1410137,64.5,75124,5.1
23120,October 2013,Kentucky,3411615,2043395,59.9,1882493,55.2,160902,7.9
23121,October 2013,Louisiana,3533573,2102349,59.5,1972749,55.8,129600,6.2
23122,October 2013,Maine,1086031,705193,64.9,660665,60.8,44528,6.3
23123,October 2013,Maryland,4657107,3124293,67.1,2925915,62.8,198378,6.3
23124,October 2013,Massachusetts,5421841,3514864,64.8,3285781,60.6,229083,6.5
23125,October 2013,Michigan,7825442,4730318,60.4,4325650,55.3,404668,8.6
23126,October 2013,Minnesota,4230713,2959868,70.0,2819676,66.6,140192,4.7
23127,October 2013,Mississippi,2265303,1259333,55.6,1155823,51.0,103510,8.2
23128,October 2013,Missouri,4696226,3018648,64.3,2820136,60.1,198512,6.6
23129,October 2013,Montana,800054,511592,63.9,484636,60.6,26956,5.3
23130,October 2013,Nebraska,1425436,1016348,71.3,979736,68.7,36612,3.6
23131,October 2013,Nevada,2174622,1381065,63.5,1255762,57.7,125303,9.1
23132,October 2013,New Hampshire,1073754,740709,69.0,704550,65.6,36159,4.9
23133,October 2013,New Jersey,7034492,4516243,64.2,4169309,59.3,346934,7.7
23134,October 2013,New Mexico,1597030,923343,57.8,859094,53.8,64249,7.0
23135,October 2013,New York,15742803,9650536,61.3,8934550,56.8,715986,7.4
23136,October 2013,North Carolina,7627076,4685769,61.4,4343095,56.9,342674,7.3
23137,October 2013,North Dakota,562666,407874,72.5,396414,70.5,11460,2.8
23138,October 2013,Ohio,9063235,5715124,63.1,5298160,58.5,416964,7.3
23139,October 2013,Oklahoma,2925873,1799409,61.5,1705549,58.3,93860,5.2
23140,October 2013,Oregon,3133168,1908135,60.9,1765905,56.4,142230,7.5
23141,October 2013,Pennsylvania,10189564,6411110,62.9,5962001,58.5,449109,7.0
23142,October 2013,Rhode Island,849718,557269,65.6,506084,59.6,51185,9.2
23143,October 2013,South Carolina,3718812,2191562,58.9,2038170,54.8,153392,7.0
23144,October 2013,South Dakota,640168,443854,69.3,427557,66.8,16297,3.7
23145,October 2013,Tennessee,5075207,3039438,59.9,2813191,55.4,226247,7.4
23146,October 2013,Texas,19800157,12899050,65.1,12126701,61.2,772349,6.0
23147,October 2013,Utah,2075376,1414439,68.2,1353091,65.2,61348,4.3
23148,October 2013,Vermont,512811,349740,68.2,334774,65.3,14966,4.3
23149,October 2013,Virginia,6406879,4240822,66.2,4003108,62.5,237714,5.6
23150,October 2013,Washington,5459917,3463476,63.4,3228657,59.1,234819,6.8
23151,October 2013,West Virginia,1484463,796163,53.6,742819,50.0,53344,6.7
23152,October 2013,Wisconsin,4511691,3077519,68.2,2878666,63.8,198853,6.5
23153,October 2013,Wyoming,449338,306442,68.2,292400,65.1,14042,4.6
23154,November 2013,Alabama,3770047,2167180,57.5,2010357,53.3,156823,7.2
23155,November 2013,Alaska,539087,365597,67.8,340104,63.1,25493,7.0
23156,November 2013,Arizona,5103462,3039532,59.6,2811745,55.1,227787,7.5
23157,November 2013,Arkansas,2278007,1315812,57.8,1224887,53.8,90925,6.9
23158,November 2013,California,29854638,18614669,62.4,17048438,57.1,1566231,8.4
23159,November 2013,Colorado,4088396,2768743,67.7,2595010,63.5,173733,6.3
23160,November 2013,Connecticut,2867091,1867073,65.1,1728285,60.3,138788,7.4
23161,November 2013,Delaware,732361,444459,60.7,416768,56.9,27691,6.2
23162,November 2013,District of Columbia,541108,373445,69.0,342832,63.4,30613,8.2
23163,November 2013,Florida,15807290,9474475,59.9,8837186,55.9,637289,6.7
23164,November 2013,Georgia,7601718,4735656,62.3,4372080,57.5,363576,7.7
23165,November 2013,Hawaii,1077210,658284,61.1,626679,58.2,31605,4.8
23166,November 2013,Idaho,1213922,773304,63.7,730153,60.1,43151,5.6
23167,November 2013,Illinois,10037422,6529007,65.0,5962789,59.4,566218,8.7
23168,November 2013,Indiana,5075376,3192528,62.9,2978018,58.7,214510,6.7
23169,November 2013,Iowa,2408190,1684516,69.9,1609032,66.8,75484,4.5
23170,November 2013,Kansas,2186741,1485381,67.9,1411634,64.6,73747,5.0
23171,November 2013,Kentucky,3412905,2038240,59.7,1879846,55.1,158394,7.8
23172,November 2013,Louisiana,3535475,2102929,59.5,1977783,55.9,125146,6.0
23173,November 2013,Maine,1086404,704399,64.8,660416,60.8,43983,6.2
23174,November 2013,Maryland,4659881,3122467,67.0,2926606,62.8,195861,6.3
23175,November 2013,Massachusetts,5426585,3516363,64.8,3291319,60.7,225044,6.4
23176,November 2013,Michigan,7828632,4729736,60.4,4332412,55.3,397324,8.4
23177,November 2013,Minnesota,4233650,2961337,69.9,2822308,66.7,139029,4.7
23178,November 2013,Mississippi,2265865,1256621,55.5,1154236,50.9,102385,8.1
23179,November 2013,Missouri,4698330,3020515,64.3,2821486,60.1,199029,6.6
23180,November 2013,Montana,800636,511924,63.9,485311,60.6,26613,5.2
23181,November 2013,Nebraska,1426302,1015997,71.2,979703,68.7,36294,3.6
23182,November 2013,Nevada,2178110,1381503,63.4,1258373,57.8,123130,8.9
23183,November 2013,New Hampshire,1074456,740742,68.9,705001,65.6,35741,4.8
23184,November 2013,New Jersey,7038038,4507052,64.0,4169278,59.2,337774,7.5
23185,November 2013,New Mexico,1597368,923958,57.8,859733,53.8,64225,7.0
23186,November 2013,New York,15750281,9631855,61.2,8933068,56.7,698787,7.3
23187,November 2013,North Carolina,7634281,4681782,61.3,4348539,57.0,333243,7.1
23188,November 2013,North Dakota,563546,408253,72.4,396865,70.4,11388,2.8
23189,November 2013,Ohio,9066725,5709479,63.0,5303537,58.5,405942,7.1
23190,November 2013,Oklahoma,2927900,1797259,61.4,1704363,58.2,92896,5.2
23191,November 2013,Oregon,3136540,1909513,60.9,1768430,56.4,141083,7.4
23192,November 2013,Pennsylvania,10192195,6401238,62.8,5962844,58.5,438394,6.8
23193,November 2013,Rhode Island,850055,557240,65.6,506472,59.6,50768,9.1
23194,November 2013,South Carolina,3723184,2191109,58.9,2042499,54.9,148610,6.8
23195,November 2013,South Dakota,640593,444225,69.3,428094,66.8,16131,3.6
23196,November 2013,Tennessee,5079154,3030812,59.7,2811106,55.3,219706,7.2
23197,November 2013,Texas,19833763,12912799,65.1,12153454,61.3,759345,5.9
23198,November 2013,Utah,2078337,1416452,68.2,1356215,65.3,60237,4.3
23199,November 2013,Vermont,512915,349505,68.1,334766,65.3,14739,4.2
23200,November 2013,Virginia,6410722,4240890,66.2,4005444,62.5,235446,5.6
23201,November 2013,Washington,5466226,3463397,63.4,3231944,59.1,231453,6.7
23202,November 2013,West Virginia,1484401,796140,53.6,742286,50.0,53854,6.8
23203,November 2013,Wisconsin,4513781,3076633,68.2,2881455,63.8,195178,6.3
23204,November 2013,Wyoming,449421,306338,68.2,292432,65.1,13906,4.5
23205,December 2013,Alabama,3771243,2167665,57.5,2010100,53.3,157565,7.3
23206,December 2013,Alaska,539288,365674,67.8,340129,63.1,25545,7.0
23207,December 2013,Arizona,5110548,3045046,59.6,2820238,55.2,224808,7.4
23208,December 2013,Arkansas,2278723,1314233,57.7,1225176,53.8,89057,6.8
23209,December 2013,California,29884234,18623953,62.3,17081350,57.2,1542603,8.3
23210,December 2013,Colorado,4094556,2772991,67.7,2603132,63.6,169859,6.1
23211,December 2013,Connecticut,2867739,1869727,65.2,1733041,60.4,136686,7.3
23212,December 2013,Delaware,733183,445267,60.7,417747,57.0,27520,6.2
23213,December 2013,District of Columbia,541659,373370,68.9,343140,63.3,30230,8.1
23214,December 2013,Florida,15830608,9492133,60.0,8858395,56.0,633738,6.7
23215,December 2013,Georgia,7609920,4735546,62.2,4376785,57.5,358761,7.6
23216,December 2013,Hawaii,1078085,659842,61.2,628445,58.3,31397,4.8
23217,December 2013,Idaho,1215369,774133,63.7,732112,60.2,42021,5.4
23218,December 2013,Illinois,10039050,6530529,65.1,5975241,59.5,555288,8.5
23219,December 2013,Indiana,5077554,3194641,62.9,2986237,58.8,208404,6.5
23220,December 2013,Iowa,2409230,1686595,70.0,1611506,66.9,75089,4.5
23221,December 2013,Kansas,2187591,1486214,67.9,1413550,64.6,72664,4.9
23222,December 2013,Kentucky,3414030,2034037,59.6,1878144,55.0,155893,7.7
23223,December 2013,Louisiana,3537247,2104957,59.5,1983169,56.1,121788,5.8
23224,December 2013,Maine,1086628,703514,64.7,660016,60.7,43498,6.2
23225,December 2013,Maryland,4662501,3121406,66.9,2927943,62.8,193463,6.2
23226,December 2013,Massachusetts,5430671,3520340,64.8,3298878,60.7,221462,6.3
23227,December 2013,Michigan,7830900,4732893,60.4,4341899,55.4,390994,8.3
23228,December 2013,Minnesota,4236052,2963292,70.0,2825014,66.7,138278,4.7
23229,December 2013,Mississippi,2266424,1254595,55.4,1153056,50.9,101539,8.1
23230,December 2013,Missouri,4700053,3025140,64.4,2824308,60.1,200832,6.6
23231,December 2013,Montana,801198,512004,63.9,485779,60.6,26225,5.1
23232,December 2013,Nebraska,1427141,1015897,71.2,979743,68.7,36154,3.6
23233,December 2013,Nevada,2181485,1382896,63.4,1261619,57.8,121277,8.8
23234,December 2013,New Hampshire,1075039,740786,68.9,705512,65.6,35274,4.8
23235,December 2013,New Jersey,7040882,4502856,64.0,4172420,59.3,330436,7.3
23236,December 2013,New Mexico,1597644,924484,57.9,860377,53.9,64107,6.9
23237,December 2013,New York,15756127,9617388,61.0,8934768,56.7,682620,7.1
23238,December 2013,North Carolina,7641843,4679576,61.2,4354118,57.0,325458,7.0
23239,December 2013,North Dakota,564510,408710,72.4,397430,70.4,11280,2.8
23240,December 2013,Ohio,9069253,5704631,62.9,5311621,58.6,393010,6.9
23241,December 2013,Oklahoma,2929785,1795219,61.3,1703571,58.1,91648,5.1
23242,December 2013,Oregon,3139544,1912046,60.9,1771555,56.4,140491,7.3
23243,December 2013,Pennsylvania,10193742,6395638,62.7,5968052,58.5,427586,6.7
23244,December 2013,Rhode Island,850351,557167,65.5,507012,59.6,50155,9.0
23245,December 2013,South Carolina,3727685,2191798,58.8,2047455,54.9,144343,6.6
23246,December 2013,South Dakota,640994,444624,69.4,428645,66.9,15979,3.6
23247,December 2013,Tennessee,5082734,3024807,59.5,2811443,55.3,213364,7.1
23248,December 2013,Texas,19866461,12932783,65.1,12186304,61.3,746479,5.8
23249,December 2013,Utah,2081129,1418146,68.1,1359114,65.3,59032,4.2
23250,December 2013,Vermont,512967,349195,68.1,334664,65.2,14531,4.2
23251,December 2013,Virginia,6415682,4242889,66.1,4009409,62.5,233480,5.5
23252,December 2013,Washington,5472570,3464000,63.3,3235814,59.1,228186,6.6
23253,December 2013,West Virginia,1484072,796384,53.7,742039,50.0,54345,6.8
23254,December 2013,Wisconsin,4515283,3076376,68.1,2885410,63.9,190966,6.2
23255,December 2013,Wyoming,449481,306198,68.1,292523,65.1,13675,4.5
23256,January 2014,Alabama,3772518,2168428,57.5,2010645,53.3,157783,7.3
23257,January 2014,Alaska,539487,365799,67.8,340224,63.1,25575,7.0
23258,January 2014,Arizona,5117659,3051457,59.6,2829996,55.3,221461,7.3
23259,January 2014,Arkansas,2279430,1313049,57.6,1226020,53.8,87029,6.6
23260,January 2014,California,29914547,18642581,62.3,17122261,57.2,1520320,8.2
23261,January 2014,Colorado,4100687,2778846,67.8,2612888,63.7,165958,6.0
23262,January 2014,Connecticut,2868483,1873154,65.3,1738645,60.6,134509,7.2
23263,January 2014,Delaware,734071,446172,60.8,418789,57.1,27383,6.1
23264,January 2014,District of Columbia,542265,373353,68.9,343463,63.3,29890,8.0
23265,January 2014,Florida,15854114,9515399,60.0,8883210,56.0,632189,6.6
23266,January 2014,Georgia,7618338,4737586,62.2,4382938,57.5,354648,7.5
23267,January 2014,Hawaii,1078914,661200,61.3,630133,58.4,31067,4.7
23268,January 2014,Idaho,1216806,774988,63.7,733960,60.3,41028,5.3
23269,January 2014,Illinois,10040889,6532335,65.1,5990177,59.7,542158,8.3
23270,January 2014,Indiana,5079682,3198517,63.0,2994730,59.0,203787,6.4
23271,January 2014,Iowa,2410273,1689281,70.1,1614459,67.0,74822,4.4
23272,January 2014,Kansas,2188432,1487673,68.0,1415867,64.7,71806,4.8
23273,January 2014,Kentucky,3415140,2030525,59.5,1877381,55.0,153144,7.5
23274,January 2014,Louisiana,3539059,2108395,59.6,1988535,56.2,119860,5.7
23275,January 2014,Maine,1086860,702570,64.6,659552,60.7,43018,6.1
23276,January 2014,Maryland,4665182,3121011,66.9,2930007,62.8,191004,6.1
23277,January 2014,Massachusetts,5434875,3526237,64.9,3308128,60.9,218109,6.2
23278,January 2014,Michigan,7833276,4738279,60.5,4353038,55.6,385241,8.1
23279,January 2014,Minnesota,4238489,2965153,70.0,2827708,66.7,137445,4.6
23280,January 2014,Mississippi,2267054,1252974,55.3,1152240,50.8,100734,8.0
23281,January 2014,Missouri,4701791,3030983,64.5,2828584,60.2,202399,6.7
23282,January 2014,Montana,801713,511775,63.8,485985,60.6,25790,5.0
23283,January 2014,Nebraska,1427838,1015794,71.1,979776,68.6,36018,3.5
23284,January 2014,Nevada,2184842,1384977,63.4,1265389,57.9,119588,8.6
23285,January 2014,New Hampshire,1075573,740783,68.9,706007,65.6,34776,4.7
23286,January 2014,New Jersey,7043888,4502712,63.9,4178772,59.3,323940,7.2
23287,January 2014,New Mexico,1597959,924850,57.9,860948,53.9,63902,6.9
23288,January 2014,New York,15762373,9606919,60.9,8939132,56.7,667787,7.0
23289,January 2014,North Carolina,7649497,4679168,61.2,4360205,57.0,318963,6.8
23290,January 2014,North Dakota,565389,409306,72.4,398149,70.4,11157,2.7
23291,January 2014,Ohio,9071775,5699647,62.8,5321251,58.7,378396,6.6
23292,January 2014,Oklahoma,2931676,1793116,61.2,1703171,58.1,89945,5.0
23293,January 2014,Oregon,3142513,1915298,60.9,1775307,56.5,139991,7.3
23294,January 2014,Pennsylvania,10195300,6393561,62.7,5976665,58.6,416896,6.5
23295,January 2014,Rhode Island,850625,557079,65.5,507750,59.7,49329,8.9
23296,January 2014,South Carolina,3732229,2193665,58.8,2052961,55.0,140704,6.4
23297,January 2014,South Dakota,641366,444999,69.4,429129,66.9,15870,3.6
23298,January 2014,Tennessee,5086285,3021159,59.4,2813563,55.3,207596,6.9
23299,January 2014,Texas,19899636,12955047,65.1,12222667,61.4,732380,5.7
23300,January 2014,Utah,2083875,1419460,68.1,1361710,65.3,57750,4.1
23301,January 2014,Vermont,513014,348833,68.0,334484,65.2,14349,4.1
23302,January 2014,Virginia,6420146,4246094,66.1,4014443,62.5,231651,5.5
23303,January 2014,Washington,5478775,3464903,63.2,3239971,59.1,224932,6.5
23304,January 2014,West Virginia,1483761,796570,53.7,741941,50.0,54629,6.9
23305,January 2014,Wisconsin,4516792,3076484,68.1,2889979,64.0,186505,6.1
23306,January 2014,Wyoming,449486,306067,68.1,292681,65.1,13386,4.4
23307,February 2014,Alabama,3773514,2168827,57.5,2011609,53.3,157218,7.2
23308,February 2014,Alaska,539444,365976,67.8,340390,63.1,25586,7.0
23309,February 2014,Arizona,5124376,3058184,59.7,2840089,55.4,218095,7.1
23310,February 2014,Arkansas,2279945,1312338,57.6,1227436,53.8,84902,6.5
23311,February 2014,California,29941643,18664989,62.3,17167589,57.3,1497400,8.0
23312,February 2014,Colorado,4106392,2784943,67.8,2623470,63.9,161473,5.8
23313,February 2014,Connecticut,2868960,1876886,65.4,1744568,60.8,132318,7.0
23314,February 2014,Delaware,734794,447249,60.9,420011,57.2,27238,6.1
23315,February 2014,District of Columbia,542863,373536,68.8,343909,63.4,29627,7.9
23316,February 2014,Florida,15875855,9538905,60.1,8908499,56.1,630406,6.6
23317,February 2014,Georgia,7625842,4740450,62.2,4389483,57.6,350967,7.4
23318,February 2014,Hawaii,1079219,662407,61.4,631717,58.5,30690,4.6
23319,February 2014,Idaho,1218154,775841,63.7,735622,60.4,40219,5.2
23320,February 2014,Illinois,10041870,6531571,65.0,6005169,59.8,526402,8.1
23321,February 2014,Indiana,5081660,3203714,63.0,3003201,59.1,200513,6.3
23322,February 2014,Iowa,2411183,1692269,70.2,1617743,67.1,74526,4.4
23323,February 2014,Kansas,2188992,1489497,68.0,1418388,64.8,71109,4.8
23324,February 2014,Kentucky,3415965,2027016,59.3,1877267,55.0,149749,7.4
23325,February 2014,Louisiana,3540621,2113195,59.7,1993601,56.3,119594,5.7
23326,February 2014,Maine,1087011,701579,64.5,659111,60.6,42468,6.1
23327,February 2014,Maryland,4667401,3121250,66.9,2932665,62.8,188585,6.0
23328,February 2014,Massachusetts,5438782,3533264,65.0,3318430,61.0,214834,6.1
23329,February 2014,Michigan,7835230,4744131,60.5,4364939,55.7,379192,8.0
23330,February 2014,Minnesota,4240830,2966604,70.0,2830593,66.7,136011,4.6
23331,February 2014,Mississippi,2267430,1251504,55.2,1151689,50.8,99815,8.0
23332,February 2014,Missouri,4703104,3036303,64.6,2833784,60.3,202519,6.7
23333,February 2014,Montana,802197,511373,63.7,486061,60.6,25312,4.9
23334,February 2014,Nebraska,1428487,1015516,71.1,979728,68.6,35788,3.5
23335,February 2014,Nevada,2188009,1387257,63.4,1269323,58.0,117934,8.5
23336,February 2014,New Hampshire,1076078,740807,68.8,706552,65.7,34255,4.6
23337,February 2014,New Jersey,7046461,4505018,63.9,4187388,59.4,317630,7.1
23338,February 2014,New Mexico,1598039,925142,57.9,861495,53.9,63647,6.9
23339,February 2014,New York,15767645,9599197,60.9,8944978,56.7,654219,6.8
23340,February 2014,North Carolina,7655884,4680143,61.1,4366909,57.0,313234,6.7
23341,February 2014,North Dakota,566237,410102,72.4,399062,70.5,11040,2.7
23342,February 2014,Ohio,9073979,5694655,62.8,5331006,58.8,363649,6.4
23343,February 2014,Oklahoma,2933313,1791030,61.1,1703192,58.1,87838,4.9
23344,February 2014,Oregon,3145357,1918854,61.0,1779730,56.6,139124,7.3
23345,February 2014,Pennsylvania,10196353,6393434,62.7,5986813,58.7,406621,6.4
23346,February 2014,Rhode Island,850846,556956,65.5,508670,59.8,48286,8.7
23347,February 2014,South Carolina,3736120,2196607,58.8,2058644,55.1,137963,6.3
23348,February 2014,South Dakota,641714,445320,69.4,429533,66.9,15787,3.5
23349,February 2014,Tennessee,5089541,3019245,59.3,2816281,55.3,202964,6.7
23350,February 2014,Texas,19930866,12975782,65.1,12258802,61.5,716980,5.5
23351,February 2014,Utah,2086628,1420341,68.1,1363895,65.4,56446,4.0
23352,February 2014,Vermont,513070,348447,67.9,334257,65.1,14190,4.1
23353,February 2014,Virginia,6423435,4249239,66.2,4019411,62.6,229828,5.4
23354,February 2014,Washington,5484324,3465945,63.2,3244372,59.2,221573,6.4
23355,February 2014,West Virginia,1483430,796259,53.7,741729,50.0,54530,6.8
23356,February 2014,Wisconsin,4518167,3076509,68.1,2894606,64.1,181903,5.9
23357,February 2014,Wyoming,449514,305988,68.1,292902,65.2,13086,4.3
23358,March 2014,Alabama,3774617,2168273,57.4,2012336,53.3,155937,7.2
23359,March 2014,Alaska,539713,366173,67.8,340576,63.1,25597,7.0
23360,March 2014,Arizona,5131068,3064625,59.7,2849484,55.5,215141,7.0
23361,March 2014,Arkansas,2280610,1312150,57.5,1229228,53.9,82922,6.3
23362,March 2014,California,29969049,18687420,62.4,17211927,57.4,1475493,7.9
23363,March 2014,Colorado,4112464,2790331,67.9,2633850,64.0,156481,5.6
23364,March 2014,Connecticut,2869498,1880537,65.5,1750307,61.0,130230,6.9
23365,March 2014,Delaware,735605,448540,61.0,421466,57.3,27074,6.0
23366,March 2014,District of Columbia,543408,373991,68.8,344513,63.4,29478,7.9
23367,March 2014,Florida,15897861,9558085,60.1,8930583,56.2,627502,6.6
23368,March 2014,Georgia,7633976,4743735,62.1,4395167,57.6,348568,7.3
23369,March 2014,Hawaii,1080063,663557,61.4,633219,58.6,30338,4.6
23370,March 2014,Idaho,1219569,776741,63.7,737104,60.4,39637,5.1
23371,March 2014,Illinois,10043141,6527218,65.0,6017699,59.9,509519,7.8
23372,March 2014,Indiana,5083726,3209691,63.1,3011025,59.2,198666,6.2
23373,March 2014,Iowa,2412135,1695127,70.3,1620945,67.2,74182,4.4
23374,March 2014,Kansas,2189811,1491289,68.1,1420818,64.9,70471,4.7
23375,March 2014,Kentucky,3417060,2022904,59.2,1877128,54.9,145776,7.2
23376,March 2014,Louisiana,3542268,2119691,59.8,1998225,56.4,121466,5.7
23377,March 2014,Maine,1087227,700528,64.4,658704,60.6,41824,6.0
23378,March 2014,Maryland,4669818,3122317,66.9,2935546,62.9,186771,6.0
23379,March 2014,Massachusetts,5442720,3540750,65.1,3328726,61.2,212024,6.0
23380,March 2014,Michigan,7837281,4749277,60.6,4376409,55.8,372868,7.9
23381,March 2014,Minnesota,4243189,2967700,69.9,2833935,66.8,133765,4.5
23382,March 2014,Mississippi,2267921,1250039,55.1,1151223,50.8,98816,7.9
23383,March 2014,Missouri,4704749,3039855,64.6,2839261,60.3,200594,6.6
23384,March 2014,Montana,802701,511053,63.7,486214,60.6,24839,4.9
23385,March 2014,Nebraska,1429257,1014951,71.0,979528,68.5,35423,3.5
23386,March 2014,Nevada,2191237,1389317,63.4,1273051,58.1,116266,8.4
23387,March 2014,New Hampshire,1076658,740790,68.8,707054,65.7,33736,4.6
23388,March 2014,New Jersey,7048872,4508792,64.0,4196734,59.5,312058,6.9
23389,March 2014,New Mexico,1598135,925437,57.9,862028,53.9,63409,6.9
23390,March 2014,New York,15772756,9593381,60.8,8950642,56.7,642739,6.7
23391,March 2014,North Carolina,7663481,4682620,61.1,4373764,57.1,308856,6.6
23392,March 2014,North Dakota,567151,411105,72.5,400162,70.6,10943,2.7
23393,March 2014,Ohio,9076266,5690981,62.7,5339558,58.8,351423,6.2
23394,March 2014,Oklahoma,2935088,1789231,61.0,1703595,58.0,85636,4.8
23395,March 2014,Oregon,3148238,1922507,61.1,1784708,56.7,137799,7.2
23396,March 2014,Pennsylvania,10197493,6393991,62.7,5996055,58.8,397936,6.2
23397,March 2014,Rhode Island,851132,556790,65.4,509722,59.9,47068,8.5
23398,March 2014,South Carolina,3740519,2200677,58.8,2063914,55.2,136763,6.2
23399,March 2014,South Dakota,642095,445577,69.4,429873,66.9,15704,3.5
23400,March 2014,Tennessee,5093008,3018389,59.3,2817998,55.3,200391,6.6
23401,March 2014,Texas,19962523,12993266,65.1,12290344,61.6,702922,5.4
23402,March 2014,Utah,2089395,1420948,68.0,1365628,65.4,55320,3.9
23403,March 2014,Vermont,513102,348077,67.8,334024,65.1,14053,4.0
23404,March 2014,Virginia,6428104,4251397,66.1,4022917,62.6,228480,5.4
23405,March 2014,Washington,5490534,3467704,63.2,3249195,59.2,218509,6.3
23406,March 2014,West Virginia,1483092,795193,53.6,741086,50.0,54107,6.8
23407,March 2014,Wisconsin,4519551,3076573,68.1,2898903,64.1,177670,5.8
23408,March 2014,Wyoming,449560,305996,68.1,293168,65.2,12828,4.2
23409,April 2014,Alabama,3775766,2166158,57.4,2012241,53.3,153917,7.1
23410,April 2014,Alaska,539943,366321,67.8,340698,63.1,25623,7.0
23411,April 2014,Arizona,5138036,3069982,59.8,2857354,55.6,212628,6.9
23412,April 2014,Arkansas,2281285,1312396,57.5,1231145,54.0,81251,6.2
23413,April 2014,California,29997908,18705628,62.4,17250516,57.5,1455112,7.8
23414,April 2014,Colorado,4118563,2794211,67.8,2643134,64.2,151077,5.4
23415,April 2014,Connecticut,2870114,1883851,65.6,1755573,61.2,128278,6.8
23416,April 2014,Delaware,736388,450001,61.1,423112,57.5,26889,6.0
23417,April 2014,District of Columbia,544016,374788,68.9,345343,63.5,29445,7.9
23418,April 2014,Florida,15920333,9569316,60.1,8946770,56.2,622546,6.5
23419,April 2014,Georgia,7642260,4746692,62.1,4399100,57.6,347592,7.3
23420,April 2014,Hawaii,1080795,664699,61.5,634666,58.7,30033,4.5
23421,April 2014,Idaho,1221002,777672,63.7,738412,60.5,39260,5.0
23422,April 2014,Illinois,10044676,6518844,64.9,6026286,60.0,492558,7.6
23423,April 2014,Indiana,5085875,3215090,63.2,3017514,59.3,197576,6.1
23424,April 2014,Iowa,2413137,1697562,70.3,1623791,67.3,73771,4.3
23425,April 2014,Kansas,2190626,1492647,68.1,1422834,65.0,69813,4.7
23426,April 2014,Kentucky,3418190,2017540,59.0,1876261,54.9,141279,7.0
23427,April 2014,Louisiana,3543970,2127781,60.0,2002374,56.5,125407,5.9
23428,April 2014,Maine,1087429,699367,64.3,658283,60.5,41084,5.9
23429,April 2014,Maryland,4672320,3123975,66.9,2938258,62.9,185717,5.9
23430,April 2014,Massachusetts,5446819,3547905,65.1,3337985,61.3,209920,5.9
23431,April 2014,Michigan,7839435,4752298,60.6,4386098,55.9,366200,7.7
23432,April 2014,Minnesota,4245605,2968402,69.9,2837663,66.8,130739,4.4
23433,April 2014,Mississippi,2268449,1248343,55.0,1150642,50.7,97701,7.8
23434,April 2014,Missouri,4706417,3041394,64.6,2844446,60.4,196948,6.5
23435,April 2014,Montana,803232,510982,63.6,486555,60.6,24427,4.8
23436,April 2014,Nebraska,1430023,1014063,70.9,979152,68.5,34911,3.4
23437,April 2014,Nevada,2194538,1390865,63.4,1276390,58.2,114475,8.2
23438,April 2014,New Hampshire,1077210,740628,68.8,707404,65.7,33224,4.5
23439,April 2014,New Jersey,7051595,4512852,64.0,4205370,59.6,307482,6.8
23440,April 2014,New Mexico,1598341,925720,57.9,862519,54.0,63201,6.8
23441,April 2014,New York,15778298,9587227,60.8,8954628,56.8,632599,6.6
23442,April 2014,North Carolina,7671065,4685783,61.1,4379856,57.1,305927,6.5
23443,April 2014,North Dakota,568109,412232,72.6,401352,70.6,10880,2.6
23444,April 2014,Ohio,9078726,5688973,62.7,5346330,58.9,342643,6.0
23445,April 2014,Oklahoma,2936973,1787894,60.9,1704318,58.0,83576,4.7
23446,April 2014,Oregon,3151235,1926047,61.1,1789945,56.8,136102,7.1
23447,April 2014,Pennsylvania,10198873,6393276,62.7,6002473,58.9,390803,6.1
23448,April 2014,Rhode Island,851364,556573,65.4,510815,60.0,45758,8.2
23449,April 2014,South Carolina,3745011,2205633,58.9,2068237,55.2,137396,6.2
23450,April 2014,South Dakota,642457,445772,69.4,430179,67.0,15593,3.5
23451,April 2014,Tennessee,5096570,3017596,59.2,2817664,55.3,199932,6.6
23452,April 2014,Texas,19994978,13005741,65.0,12314360,61.6,691381,5.3
23453,April 2014,Utah,2092201,1421621,67.9,1367117,65.3,54504,3.8
23454,April 2014,Vermont,513150,347733,67.8,333798,65.0,13935,4.0
23455,April 2014,Virginia,6432642,4251609,66.1,4023905,62.6,227704,5.4
23456,April 2014,Washington,5496786,3470417,63.1,3254383,59.2,216034,6.2
23457,April 2014,West Virginia,1482796,793279,53.5,739798,49.9,53481,6.7
23458,April 2014,Wisconsin,4521021,3076821,68.1,2902712,64.2,174109,5.7
23459,April 2014,Wyoming,449617,306103,68.1,293442,65.3,12661,4.1
23460,May 2014,Alabama,3777034,2163015,57.3,2011844,53.3,151171,7.0
23461,May 2014,Alaska,539995,366371,67.8,340738,63.1,25633,7.0
23462,May 2014,Arizona,5145074,3074749,59.8,2864399,55.7,210350,6.8
23463,May 2014,Arkansas,2282073,1312946,57.5,1233077,54.0,79869,6.1
23464,May 2014,California,30026220,18720579,62.3,17286313,57.6,1434266,7.7
23465,May 2014,Colorado,4124723,2796717,67.8,2651468,64.3,145249,5.2
23466,May 2014,Connecticut,2870876,1886960,65.7,1760517,61.3,126443,6.7
23467,May 2014,Delaware,737194,451546,61.3,424872,57.6,26674,5.9
23468,May 2014,District of Columbia,544581,375976,69.0,346517,63.6,29459,7.8
23469,May 2014,Florida,15943101,9574893,60.1,8960001,56.2,614892,6.4
23470,May 2014,Georgia,7650408,4749200,62.1,4402554,57.5,346646,7.3
23471,May 2014,Hawaii,1081205,665787,61.6,636077,58.8,29710,4.5
23472,May 2014,Idaho,1222505,778545,63.7,739615,60.5,38930,5.0
23473,May 2014,Illinois,10046643,6508786,64.8,6033091,60.1,475695,7.3
23474,May 2014,Indiana,5088449,3219535,63.3,3023464,59.4,196071,6.1
23475,May 2014,Iowa,2414413,1699688,70.4,1626431,67.4,73257,4.3
23476,May 2014,Kansas,2191476,1493403,68.1,1424356,65.0,69047,4.6
23477,May 2014,Kentucky,3419499,2011074,58.8,1874949,54.8,136125,6.8
23478,May 2014,Louisiana,3545739,2137376,60.3,2006812,56.6,130564,6.1
23479,May 2014,Maine,1087716,698061,64.2,657799,60.5,40262,5.8
23480,May 2014,Maryland,4674809,3125843,66.9,2941057,62.9,184786,5.9
23481,May 2014,Massachusetts,5451296,3554751,65.2,3346539,61.4,208212,5.9
23482,May 2014,Michigan,7842160,4753430,60.6,4394821,56.0,358609,7.5
23483,May 2014,Minnesota,4248410,2968931,69.9,2841849,66.9,127082,4.3
23484,May 2014,Mississippi,2269011,1246611,54.9,1150237,50.7,96374,7.7
23485,May 2014,Missouri,4708409,3042003,64.6,2849832,60.5,192171,6.3
23486,May 2014,Montana,803784,511165,63.6,487092,60.6,24073,4.7
23487,May 2014,Nebraska,1430894,1012942,70.8,978697,68.4,34245,3.4
23488,May 2014,Nevada,2197808,1392022,63.3,1279519,58.2,112503,8.1
23489,May 2014,New Hampshire,1077844,740384,68.7,707716,65.7,32668,4.4
23490,May 2014,New Jersey,7054577,4517138,64.0,4213441,59.7,303697,6.7
23491,May 2014,New Mexico,1598492,926045,57.9,863119,54.0,62926,6.8
23492,May 2014,New York,15784475,9580960,60.7,8959403,56.8,621557,6.5
23493,May 2014,North Carolina,7678294,4689374,61.1,4386045,57.1,303329,6.5
23494,May 2014,North Dakota,569014,413390,72.7,402522,70.7,10868,2.6
23495,May 2014,Ohio,9081833,5689218,62.6,5353135,58.9,336083,5.9
23496,May 2014,Oklahoma,2938971,1787512,60.8,1705850,58.0,81662,4.6
23497,May 2014,Oregon,3154353,1929630,61.2,1795499,56.9,134131,7.0
23498,May 2014,Pennsylvania,10200907,6391439,62.7,6007518,58.9,383921,6.0
23499,May 2014,Rhode Island,851693,556287,65.3,511860,60.1,44427,8.0
23500,May 2014,South Carolina,3749405,2211245,59.0,2071911,55.3,139334,6.3
23501,May 2014,South Dakota,642872,445942,69.4,430520,67.0,15422,3.5
23502,May 2014,Tennessee,5100309,3016835,59.2,2816456,55.2,200379,6.6
23503,May 2014,Texas,20027194,13014950,65.0,12334096,61.6,680854,5.2
23504,May 2014,Utah,2095176,1422754,67.9,1368756,65.3,53998,3.8
23505,May 2014,Vermont,513254,347430,67.7,333599,65.0,13831,4.0
23506,May 2014,Virginia,6436750,4250039,66.0,4023352,62.5,226687,5.3
23507,May 2014,Washington,5502928,3474541,63.1,3260531,59.3,214010,6.2
23508,May 2014,West Virginia,1482645,790818,53.3,738061,49.8,52757,6.7
23509,May 2014,Wisconsin,4522902,3077723,68.0,2906706,64.3,171017,5.6
23510,May 2014,Wyoming,449705,306288,68.1,293704,65.3,12584,4.1
23511,June 2014,Alabama,3778452,2160232,57.2,2012140,53.3,148092,6.9
23512,June 2014,Alaska,540178,366300,67.8,340724,63.1,25576,7.0
23513,June 2014,Arizona,5152350,3080490,59.8,2872150,55.7,208340,6.8
23514,June 2014,Arkansas,2282941,1313795,57.5,1235073,54.1,78722,6.0
23515,June 2014,California,30056137,18738878,62.3,17325552,57.6,1413326,7.5
23516,June 2014,Colorado,4131069,2798862,67.8,2659441,64.4,139421,5.0
23517,June 2014,Connecticut,2871719,1890485,65.8,1765584,61.5,124901,6.6
23518,June 2014,Delaware,738016,453078,61.4,426666,57.8,26412,5.8
23519,June 2014,District of Columbia,545216,377476,69.2,348014,63.8,29462,7.8
23520,June 2014,Florida,15966623,9580545,60.0,8974853,56.2,605692,6.3
23521,June 2014,Georgia,7659094,4752201,62.0,4407519,57.5,344682,7.3
23522,June 2014,Hawaii,1081888,666807,61.6,637489,58.9,29318,4.4
23523,June 2014,Idaho,1224053,779305,63.7,740764,60.5,38541,4.9
23524,June 2014,Illinois,10048968,6501505,64.7,6041564,60.1,459941,7.1
23525,June 2014,Indiana,5091055,3223659,63.3,3029827,59.5,193832,6.0
23526,June 2014,Iowa,2415682,1701664,70.4,1629022,67.4,72642,4.3
23527,June 2014,Kansas,2192460,1493632,68.1,1425488,65.0,68144,4.6
23528,June 2014,Kentucky,3420844,2004458,58.6,1873894,54.8,130564,6.5
23529,June 2014,Louisiana,3547657,2148447,60.6,2012270,56.7,136177,6.3
23530,June 2014,Maine,1088075,696669,64.0,657278,60.4,39391,5.7
23531,June 2014,Maryland,4677546,3127946,66.9,2944486,62.9,183460,5.9
23532,June 2014,Massachusetts,5455893,3562187,65.3,3355631,61.5,206556,5.8
23533,June 2014,Michigan,7845034,4754507,60.6,4404334,56.1,350173,7.4
23534,June 2014,Minnesota,4251287,2969951,69.9,2846646,67.0,123305,4.2
23535,June 2014,Mississippi,2269648,1245328,54.9,1150494,50.7,94834,7.6
23536,June 2014,Missouri,4710498,3043498,64.6,2856273,60.6,187225,6.2
23537,June 2014,Montana,804383,511488,63.6,487699,60.6,23789,4.7
23538,June 2014,Nebraska,1431831,1011756,70.7,978273,68.3,33483,3.3
23539,June 2014,Nevada,2201213,1393171,63.3,1282685,58.3,110486,7.9
23540,June 2014,New Hampshire,1078520,740152,68.6,708111,65.7,32041,4.3
23541,June 2014,New Jersey,7057759,4522464,64.1,4221412,59.8,301052,6.7
23542,June 2014,New Mexico,1598743,926582,58.0,864036,54.0,62546,6.8
23543,June 2014,New York,15791143,9577760,60.7,8968415,56.8,609345,6.4
23544,June 2014,North Carolina,7686010,4694171,61.1,4393892,57.2,300279,6.4
23545,June 2014,North Dakota,570015,414510,72.7,403591,70.8,10919,2.6
23546,June 2014,Ohio,9085068,5692734,62.7,5362267,59.0,330467,5.8
23547,June 2014,Oklahoma,2941073,1788720,60.8,1708756,58.1,79964,4.5
23548,June 2014,Oregon,3157622,1933666,61.2,1801516,57.1,132150,6.8
23549,June 2014,Pennsylvania,10203193,6390302,62.6,6013863,58.9,376439,5.9
23550,June 2014,Rhode Island,852029,555941,65.2,512810,60.2,43131,7.8
23551,June 2014,South Carolina,3754052,2217702,59.1,2075763,55.3,141939,6.4
23552,June 2014,South Dakota,643309,446137,69.4,430927,67.0,15210,3.4
23553,June 2014,Tennessee,5104248,3017035,59.1,2816402,55.2,200633,6.7
23554,June 2014,Texas,20060605,13025433,64.9,12354836,61.6,670597,5.1
23555,June 2014,Utah,2098251,1424638,67.9,1370842,65.3,53796,3.8
23556,June 2014,Vermont,513354,347161,67.6,333428,65.0,13733,4.0
23557,June 2014,Virginia,6441545,4247816,65.9,4022912,62.5,224904,5.3
23558,June 2014,Washington,5509475,3480745,63.2,3268326,59.3,212419,6.1
23559,June 2014,West Virginia,1482476,788302,53.2,736236,49.7,52066,6.6
23560,June 2014,Wisconsin,4524884,3079827,68.1,2911829,64.4,167998,5.5
23561,June 2014,Wyoming,449760,306527,68.2,293922,65.4,12605,4.1
23562,July 2014,Alabama,3779953,2158349,57.1,2013284,53.3,145065,6.7
23563,July 2014,Alaska,540492,366082,67.7,340654,63.0,25428,6.9
23564,July 2014,Arizona,5159739,3087621,59.8,2880871,55.8,206750,6.7
23565,July 2014,Arkansas,2283867,1315047,57.6,1237263,54.2,77784,5.9
23566,July 2014,California,30086570,18761768,62.4,17367972,57.7,1393796,7.4
23567,July 2014,Colorado,4137639,2801137,67.7,2666946,64.5,134191,4.8
23568,July 2014,Connecticut,2872602,1894443,65.9,1770727,61.6,123716,6.5
23569,July 2014,Delaware,738900,454496,61.5,428417,58.0,26079,5.7
23570,July 2014,District of Columbia,545835,379044,69.4,349587,64.0,29457,7.8
23571,July 2014,Florida,15990502,9587865,60.0,8991044,56.2,596821,6.2
23572,July 2014,Georgia,7667648,4755370,62.0,4414252,57.6,341118,7.2
23573,July 2014,Hawaii,1082775,667697,61.7,638830,59.0,28867,4.3
23574,July 2014,Idaho,1225619,779981,63.6,741905,60.5,38076,4.9
23575,July 2014,Illinois,10051178,6498177,64.7,6051857,60.2,446320,6.9
23576,July 2014,Indiana,5093820,3227460,63.4,3036196,59.6,191264,5.9
23577,July 2014,Iowa,2417003,1703365,70.5,1631343,67.5,72022,4.2
23578,July 2014,Kansas,2193571,1493387,68.1,1426231,65.0,67156,4.5
23579,July 2014,Kentucky,3422400,1998317,58.4,1873101,54.7,125216,6.3
23580,July 2014,Louisiana,3549718,2160200,60.9,2018504,56.9,141696,6.6
23581,July 2014,Maine,1088408,695313,63.9,656759,60.3,38554,5.5
23582,July 2014,Maryland,4680452,3130276,66.9,2948459,63.0,181817,5.8
23583,July 2014,Massachusetts,5460595,3570360,65.4,3365591,61.6,204769,5.7
23584,July 2014,Michigan,7848013,4756013,60.6,4414628,56.3,341385,7.2
23585,July 2014,Minnesota,4254257,2971803,69.9,2851689,67.0,120114,4.0
23586,July 2014,Mississippi,2270323,1244720,54.8,1151452,50.7,93268,7.5
23587,July 2014,Missouri,4712667,3046430,64.6,2863490,60.8,182940,6.0
23588,July 2014,Montana,805028,511750,63.6,488171,60.6,23579,4.6
23589,July 2014,Nebraska,1432783,1010666,70.5,977932,68.3,32734,3.2
23590,July 2014,Nevada,2204687,1394574,63.3,1285902,58.3,108672,7.8
23591,July 2014,New Hampshire,1079233,740025,68.6,708660,65.7,31365,4.2
23592,July 2014,New Jersey,7061031,4528817,64.1,4228714,59.9,300103,6.6
23593,July 2014,New Mexico,1599097,927278,58.0,865226,54.1,62052,6.7
23594,July 2014,New York,15798024,9577988,60.6,8980512,56.8,597476,6.2
23595,July 2014,North Carolina,7694366,4699524,61.1,4403037,57.2,296487,6.3
23596,July 2014,North Dakota,571031,415542,72.8,404520,70.8,11022,2.7
23597,July 2014,Ohio,9088542,5698855,62.7,5373408,59.1,325447,5.7
23598,July 2014,Oklahoma,2943163,1791447,60.9,1712881,58.2,78566,4.4
23599,July 2014,Oregon,3160939,1938066,61.3,1807640,57.2,130426,6.7
23600,July 2014,Pennsylvania,10205668,6390623,62.6,6021955,59.0,368668,5.8
23601,July 2014,Rhode Island,852394,555582,65.2,513688,60.3,41894,7.5
23602,July 2014,South Carolina,3758513,2224859,59.2,2080136,55.3,144723,6.5
23603,July 2014,South Dakota,643784,446400,69.3,431365,67.0,15035,3.4
23604,July 2014,Tennessee,5108342,3018185,59.1,2818005,55.2,200180,6.6
23605,July 2014,Texas,20094518,13036975,64.9,12376611,61.6,660364,5.1
23606,July 2014,Utah,2101317,1427161,67.9,1373330,65.4,53831,3.8
23607,July 2014,Vermont,513460,346903,67.6,333263,64.9,13640,3.9
23608,July 2014,Virginia,6446776,4245204,65.9,4022613,62.4,222591,5.2
23609,July 2014,Washington,5516334,3488748,63.2,3277350,59.4,211398,6.1
23610,July 2014,West Virginia,1482350,786016,53.0,734476,49.5,51540,6.6
23611,July 2014,Wisconsin,4526921,3082605,68.1,2917861,64.5,164744,5.3
23612,July 2014,Wyoming,449873,306752,68.2,294062,65.4,12690,4.1
23613,August 2014,Alabama,3781754,2157559,57.1,2015187,53.3,142372,6.6
23614,August 2014,Alaska,540719,365764,67.6,340579,63.0,25185,6.9
23615,August 2014,Arizona,5168489,3096360,59.9,2890582,55.9,205778,6.6
23616,August 2014,Arkansas,2285199,1316885,57.6,1239830,54.3,77055,5.9
23617,August 2014,California,30118426,18789997,62.4,17413131,57.8,1376866,7.3
23618,August 2014,Colorado,4145823,2803968,67.6,2673927,64.5,130041,4.6
23619,August 2014,Connecticut,2873395,1898592,66.1,1775812,61.8,122780,6.5
23620,August 2014,Delaware,739760,455752,61.6,430088,58.1,25664,5.6
23621,August 2014,District of Columbia,546612,380520,69.6,351084,64.2,29436,7.7
23622,August 2014,Florida,16020473,9597556,59.9,9007834,56.2,589722,6.1
23623,August 2014,Georgia,7677489,4758702,62.0,4422691,57.6,336011,7.1
23624,August 2014,Hawaii,1083407,668431,61.7,640023,59.1,28408,4.2
23625,August 2014,Idaho,1227266,780675,63.6,743151,60.6,37524,4.8
23626,August 2014,Illinois,10052675,6498623,64.6,6063179,60.3,435444,6.7
23627,August 2014,Indiana,5096338,3232228,63.4,3042914,59.7,189314,5.9
23628,August 2014,Iowa,2418333,1704803,70.5,1633298,67.5,71505,4.2
23629,August 2014,Kansas,2194514,1492897,68.0,1426660,65.0,66237,4.4
23630,August 2014,Kentucky,3424165,1993374,58.2,1872740,54.7,120634,6.1
23631,August 2014,Louisiana,3552113,2171863,61.1,2025140,57.0,146723,6.8
23632,August 2014,Maine,1088707,694151,63.8,656309,60.3,37842,5.5
23633,August 2014,Maryland,4683532,3132943,66.9,2952827,63.0,180116,5.7
23634,August 2014,Massachusetts,5464996,3579021,65.5,3376337,61.8,202684,5.7
23635,August 2014,Michigan,7850930,4758747,60.6,4425524,56.4,333223,7.0
23636,August 2014,Minnesota,4257216,2974455,69.9,2856542,67.1,117913,4.0
23637,August 2014,Mississippi,2270974,1244882,54.8,1153085,50.8,91797,7.4
23638,August 2014,Missouri,4714989,3050856,64.7,2871163,60.9,179693,5.9
23639,August 2014,Montana,805757,511868,63.5,488463,60.6,23405,4.6
23640,August 2014,Nebraska,1433774,1009797,70.4,977708,68.2,32089,3.2
23641,August 2014,Nevada,2208814,1396397,63.2,1289214,58.4,107183,7.7
23642,August 2014,New Hampshire,1079699,740124,68.5,709416,65.7,30708,4.1
23643,August 2014,New Jersey,7064524,4535901,64.2,4235211,60.0,300690,6.6
23644,August 2014,New Mexico,1599824,928010,58.0,866558,54.2,61452,6.6
23645,August 2014,New York,15805466,9582653,60.6,8995010,56.9,587643,6.1
23646,August 2014,North Carolina,7704208,4705430,61.1,4413160,57.3,292270,6.2
23647,August 2014,North Dakota,572018,416447,72.8,405310,70.9,11137,2.7
23648,August 2014,Ohio,9091970,5706613,62.8,5385724,59.2,320889,5.6
23649,August 2014,Oklahoma,2945630,1795523,61.0,1718027,58.3,77496,4.3
23650,August 2014,Oregon,3165799,1942533,61.4,1813602,57.3,128931,6.6
23651,August 2014,Pennsylvania,10208360,6393522,62.6,6031582,59.1,361940,5.7
23652,August 2014,Rhode Island,852733,555324,65.1,514599,60.3,40725,7.3
23653,August 2014,South Carolina,3763944,2232509,59.3,2085208,55.4,147301,6.6
23654,August 2014,South Dakota,644170,446741,69.4,431789,67.0,14952,3.3
23655,August 2014,Tennessee,5113179,3020966,59.1,2821702,55.2,199264,6.6
23656,August 2014,Texas,20132344,13049277,64.8,12399173,61.6,650104,5.0
23657,August 2014,Utah,2105014,1430168,67.9,1376217,65.4,53951,3.8
23658,August 2014,Vermont,513545,346676,67.5,333118,64.9,13558,3.9
23659,August 2014,Virginia,6451604,4242797,65.8,4022685,62.4,220112,5.2
23660,August 2014,Washington,5524864,3497992,63.3,3287014,59.5,210978,6.0
23661,August 2014,West Virginia,1482087,784131,52.9,732920,49.5,51211,6.5
23662,August 2014,Wisconsin,4528902,3085725,68.1,2924212,64.6,161513,5.2
23663,August 2014,Wyoming,450091,306859,68.2,294119,65.3,12740,4.2
23664,September 2014,Alabama,3783562,2157365,57.0,2017529,53.3,139836,6.5
23665,September 2014,Alaska,540998,365407,67.5,340561,63.0,24846,6.8
23666,September 2014,Arizona,5177198,3106166,60.0,2900821,56.0,205345,6.6
23667,September 2014,Arkansas,2286534,1319231,57.7,1242772,54.4,76459,5.8
23668,September 2014,California,30150585,18820557,62.4,17459316,57.9,1361241,7.2
23669,September 2014,Colorado,4154139,2807182,67.6,2680193,64.5,126989,4.5
23670,September 2014,Connecticut,2874234,1902652,66.2,1780703,62.0,121949,6.4
23671,September 2014,Delaware,740697,456841,61.7,431663,58.3,25178,5.5
23672,September 2014,District of Columbia,547382,381860,69.8,352477,64.4,29383,7.7
23673,September 2014,Florida,16050633,9607662,59.9,9023477,56.2,584185,6.1
23674,September 2014,Georgia,7687552,4762086,61.9,4432269,57.7,329817,6.9
23675,September 2014,Hawaii,1084222,669073,61.7,641079,59.1,27994,4.2
23676,September 2014,Idaho,1228941,781434,63.6,744565,60.6,36869,4.7
23677,September 2014,Illinois,10054147,6500409,64.7,6073997,60.4,426412,6.6
23678,September 2014,Indiana,5098817,3238312,63.5,3050237,59.8,188075,5.8
23679,September 2014,Iowa,2419622,1705865,70.5,1634902,67.6,70963,4.2
23680,September 2014,Kansas,2195540,1492331,68.0,1426891,65.0,65440,4.4
23681,September 2014,Kentucky,3425940,1989701,58.1,1872866,54.7,116835,5.9
23682,September 2014,Louisiana,3554581,2182193,61.4,2031470,57.2,150723,6.9
23683,September 2014,Maine,1089013,693166,63.7,655943,60.2,37223,5.4
23684,September 2014,Maryland,4686756,3135704,66.9,2957292,63.1,178412,5.7
23685,September 2014,Massachusetts,5469381,3587366,65.6,3387301,61.9,200065,5.6
23686,September 2014,Michigan,7853782,4761565,60.6,4436103,56.5,325462,6.8
23687,September 2014,Minnesota,4260138,2977402,69.9,2860853,67.2,116549,3.9
23688,September 2014,Mississippi,2271640,1245573,54.8,1155290,50.9,90283,7.2
23689,September 2014,Missouri,4717354,3056205,64.8,2879006,61.0,177199,5.8
23690,September 2014,Montana,806512,511912,63.5,488679,60.6,23233,4.5
23691,September 2014,Nebraska,1434801,1009113,70.3,977578,68.1,31535,3.1
23692,September 2014,Nevada,2212959,1398608,63.2,1292599,58.4,106009,7.6
23693,September 2014,New Hampshire,1080135,740449,68.6,710332,65.8,30117,4.1
23694,September 2014,New Jersey,7068062,4542614,64.3,4240811,60.0,301803,6.6
23695,September 2014,New Mexico,1600533,928671,58.0,867852,54.2,60819,6.5
23696,September 2014,New York,15812742,9590924,60.7,9011015,57.0,579909,6.0
23697,September 2014,North Carolina,7714183,4712026,61.1,4424252,57.4,287774,6.1
23698,September 2014,North Dakota,573024,417143,72.8,405930,70.8,11213,2.7
23699,September 2014,Ohio,9095328,5713476,62.8,5397721,59.3,315755,5.5
23700,September 2014,Oklahoma,2948090,1800520,61.1,1723835,58.5,76685,4.3
23701,September 2014,Oregon,3170603,1946537,61.4,1819269,57.4,127268,6.5
23702,September 2014,Pennsylvania,10210941,6398773,62.7,6041865,59.2,356908,5.6
23703,September 2014,Rhode Island,853087,555198,65.1,515558,60.4,39640,7.1
23704,September 2014,South Carolina,3769606,2240079,59.4,2090951,55.5,149128,6.7
23705,September 2014,South Dakota,644603,447093,69.4,432146,67.0,14947,3.3
23706,September 2014,Tennessee,5117994,3025616,59.1,2827400,55.2,198216,6.6
23707,September 2014,Texas,20170534,13060199,64.7,12421312,61.6,638887,4.9
23708,September 2014,Utah,2108747,1433471,68.0,1379531,65.4,53940,3.8
23709,September 2014,Vermont,513633,346500,67.5,333012,64.8,13488,3.9
23710,September 2014,Virginia,6457053,4240825,65.7,4023305,62.3,217520,5.1
23711,September 2014,Washington,5533573,3507315,63.4,3296464,59.6,210851,6.0
23712,September 2014,West Virginia,1481853,782576,52.8,731601,49.4,50975,6.5
23713,September 2014,Wisconsin,4530857,3088732,68.2,2930126,64.7,158606,5.1
23714,September 2014,Wyoming,450306,306794,68.1,294110,65.3,12684,4.1
23715,October 2014,Alabama,3785348,2156760,57.0,2019742,53.4,137018,6.4
23716,October 2014,Alaska,541308,365091,67.4,340639,62.9,24452,6.7
23717,October 2014,Arizona,5185881,3115316,60.1,2910581,56.1,204735,6.6
23718,October 2014,Arkansas,2287813,1321596,57.8,1245769,54.5,75827,5.7
23719,October 2014,California,30182687,18845275,62.4,17502647,58.0,1342628,7.1
23720,October 2014,Colorado,4162401,2810172,67.5,2685419,64.5,124753,4.4
23721,October 2014,Connecticut,2875031,1906160,66.3,1785258,62.1,120902,6.3
23722,October 2014,Delaware,741558,457809,61.7,433159,58.4,24650,5.4
23723,October 2014,District of Columbia,548134,382995,69.9,353730,64.5,29265,7.6
23724,October 2014,Florida,16080687,9613511,59.8,9035168,56.2,578343,6.0
23725,October 2014,Georgia,7697589,4764293,61.9,4441804,57.7,322489,6.8
23726,October 2014,Hawaii,1085073,669695,61.7,642042,59.2,27653,4.1
23727,October 2014,Idaho,1230605,782311,63.6,746184,60.6,36127,4.6
23728,October 2014,Illinois,10055594,6499324,64.6,6082376,60.5,416948,6.4
23729,October 2014,Indiana,5101297,3243753,63.6,3057461,59.9,186292,5.7
23730,October 2014,Iowa,2420909,1706362,70.5,1636143,67.6,70219,4.1
23731,October 2014,Kansas,2196542,1491682,67.9,1426983,65.0,64699,4.3
23732,October 2014,Kentucky,3427709,1986733,58.0,1873222,54.6,113511,5.7
23733,October 2014,Louisiana,3557047,2189473,61.6,2036537,57.3,152936,7.0
23734,October 2014,Maine,1089301,692227,63.5,655604,60.2,36623,5.3
23735,October 2014,Maryland,4689932,3137998,66.9,2961414,63.1,176584,5.6
23736,October 2014,Massachusetts,5473702,3594140,65.7,3397519,62.1,196621,5.5
23737,October 2014,Michigan,7856531,4761519,60.6,4444991,56.6,316528,6.6
23738,October 2014,Minnesota,4263026,2979859,69.9,2864393,67.2,115466,3.9
23739,October 2014,Mississippi,2272313,1246588,54.9,1157924,51.0,88664,7.1
23740,October 2014,Missouri,4719646,3061041,64.9,2886432,61.2,174609,5.7
23741,October 2014,Montana,807244,511973,63.4,488976,60.6,22997,4.5
23742,October 2014,Nebraska,1435799,1008432,70.2,977483,68.1,30949,3.1
23743,October 2014,Nevada,2217077,1400810,63.2,1295904,58.5,104906,7.5
23744,October 2014,New Hampshire,1080598,740917,68.6,711315,65.8,29602,4.0
23745,October 2014,New Jersey,7071462,4547241,64.3,4245351,60.0,301890,6.6
23746,October 2014,New Mexico,1601255,929206,58.0,868956,54.3,60250,6.5
23747,October 2014,New York,15819916,9598512,60.7,9026419,57.1,572093,6.0
23748,October 2014,North Carolina,7724194,4718050,61.1,4435464,57.4,282586,6.0
23749,October 2014,North Dakota,573996,417567,72.7,406342,70.8,11225,2.7
23750,October 2014,Ohio,9098598,5716338,62.8,5407347,59.4,308991,5.4
23751,October 2014,Oklahoma,2950585,1805751,61.2,1729795,58.6,75956,4.2
23752,October 2014,Oregon,3175376,1949413,61.4,1824451,57.5,124962,6.4
23753,October 2014,Pennsylvania,10213387,6403632,62.7,6051001,59.2,352631,5.5
23754,October 2014,Rhode Island,853425,555151,65.0,516493,60.5,38658,7.0
23755,October 2014,South Carolina,3775268,2246604,59.5,2097010,55.5,149594,6.7
23756,October 2014,South Dakota,645001,447434,69.4,432451,67.0,14983,3.3
23757,October 2014,Tennessee,5122803,3031008,59.2,2834510,55.3,196498,6.5
23758,October 2014,Texas,20208549,13064841,64.7,12440120,61.6,624721,4.8
23759,October 2014,Utah,2112424,1436875,68.0,1383216,65.5,53659,3.7
23760,October 2014,Vermont,513717,346366,67.4,332952,64.8,13414,3.9
23761,October 2014,Virginia,6462493,4238480,65.6,4023940,62.3,214540,5.1
23762,October 2014,Washington,5542299,3514786,63.4,3304682,59.6,210104,6.0
23763,October 2014,West Virginia,1481599,781195,52.7,730404,49.3,50791,6.5
23764,October 2014,Wisconsin,4532760,3090676,68.2,2934899,64.7,155777,5.0
23765,October 2014,Wyoming,450506,306569,68.0,294060,65.3,12509,4.1
23766,November 2014,Alabama,3786810,2155271,56.9,2021275,53.4,133996,6.2
23767,November 2014,Alaska,541496,364853,67.4,340782,62.9,24071,6.6
23768,November 2014,Arizona,5194055,3122497,60.1,2918853,56.2,203644,6.5
23769,November 2014,Arkansas,2288968,1323513,57.8,1248331,54.5,75182,5.7
23770,November 2014,California,30212902,18858565,62.4,17538990,58.1,1319575,7.0
23771,November 2014,Colorado,4170214,2812153,67.4,2689289,64.5,122864,4.4
23772,November 2014,Connecticut,2875615,1908703,66.4,1789140,62.2,119563,6.3
23773,November 2014,Delaware,742360,458728,61.8,434597,58.5,24131,5.3
23774,November 2014,District of Columbia,548845,383889,69.9,354814,64.6,29075,7.6
23775,November 2014,Florida,16108903,9612197,59.7,9041142,56.1,571055,5.9
23776,November 2014,Georgia,7707269,4764717,61.8,4449987,57.7,314730,6.6
23777,November 2014,Hawaii,1085637,670325,61.7,642946,59.2,27379,4.1
23778,November 2014,Idaho,1232149,783329,63.6,747956,60.7,35373,4.5
23779,November 2014,Illinois,10056444,6493329,64.6,6086755,60.5,406574,6.3
23780,November 2014,Indiana,5103420,3246869,63.6,3063611,60.0,183258,5.6
23781,November 2014,Iowa,2421992,1706134,70.4,1636938,67.6,69196,4.1
23782,November 2014,Kansas,2197219,1491052,67.9,1426870,64.9,64182,4.3
23783,November 2014,Kentucky,3429148,1983997,57.9,1873354,54.6,110643,5.6
23784,November 2014,Louisiana,3559169,2192766,61.6,2039569,57.3,153197,7.0
23785,November 2014,Maine,1089508,691184,63.4,655242,60.1,35942,5.2
23786,November 2014,Maryland,4692651,3139460,66.9,2964842,63.2,174618,5.6
23787,November 2014,Massachusetts,5477703,3598369,65.7,3405927,62.2,192442,5.3
23788,November 2014,Michigan,7858797,4757098,60.5,4451214,56.6,305884,6.4
23789,November 2014,Minnesota,4265615,2981372,69.9,2867193,67.2,114179,3.8
23790,November 2014,Mississippi,2272770,1247698,54.9,1160732,51.1,86966,7.0
23791,November 2014,Missouri,4721651,3064844,64.9,2892689,61.3,172155,5.6
23792,November 2014,Montana,807885,512203,63.4,489540,60.6,22663,4.4
23793,November 2014,Nebraska,1436663,1007667,70.1,977365,68.0,30302,3.0
23794,November 2014,Nevada,2221024,1402731,63.2,1298979,58.5,103752,7.4
23795,November 2014,New Hampshire,1081007,741390,68.6,712254,65.9,29136,3.9
23796,November 2014,New Jersey,7074400,4548874,64.3,4248545,60.1,300329,6.6
23797,November 2014,New Mexico,1601825,929560,58.0,869692,54.3,59868,6.4
23798,November 2014,New York,15825973,9603293,60.7,9039635,57.1,563658,5.9
23799,November 2014,North Carolina,7733247,4722356,61.1,4445121,57.5,277235,5.9
23800,November 2014,North Dakota,574923,417680,72.6,406509,70.7,11171,2.7
23801,November 2014,Ohio,9101194,5713902,62.8,5412582,59.5,301320,5.3
23802,November 2014,Oklahoma,2952829,1810693,61.3,1735295,58.8,75398,4.2
23803,November 2014,Oregon,3179915,1950851,61.3,1828830,57.5,122021,6.3
23804,November 2014,Pennsylvania,10214997,6405696,62.7,6056929,59.3,348767,5.4
23805,November 2014,Rhode Island,853722,555116,65.0,517334,60.6,37782,6.8
23806,November 2014,South Carolina,3780720,2251392,59.5,2102651,55.6,148741,6.6
23807,November 2014,South Dakota,645325,447743,69.4,432758,67.1,14985,3.3
23808,November 2014,Tennessee,5127215,3036318,59.2,2842354,55.4,193964,6.4
23809,November 2014,Texas,20245097,13060992,64.5,12452402,61.5,608590,4.7
23810,November 2014,Utah,2116007,1440201,68.1,1387034,65.5,53167,3.7
23811,November 2014,Vermont,513767,346268,67.4,332947,64.8,13321,3.8
23812,November 2014,Virginia,6466794,4235101,65.5,4023901,62.2,211200,5.0
23813,November 2014,Washington,5550304,3519331,63.4,3311006,59.7,208325,5.9
23814,November 2014,West Virginia,1481209,780012,52.7,729222,49.2,50790,6.5
23815,November 2014,Wisconsin,4534355,3090837,68.2,2938028,64.8,152809,4.9
23816,November 2014,Wyoming,450672,306253,68.0,293986,65.2,12267,4.0
23817,December 2014,Alabama,3787955,2153710,56.9,2022128,53.4,131582,6.1
23818,December 2014,Alaska,541469,364684,67.4,340913,63.0,23771,6.5
23819,December 2014,Arizona,5201745,3128099,60.1,2925797,56.2,202302,6.5
23820,December 2014,Arkansas,2289905,1324946,57.9,1250274,54.6,74672,5.6
23821,December 2014,California,30240040,18864959,62.4,17568792,58.1,1296167,6.9
23822,December 2014,Colorado,4177579,2813376,67.3,2692166,64.4,121210,4.3
23823,December 2014,Connecticut,2875942,1910209,66.4,1792141,62.3,118068,6.2
23824,December 2014,Delaware,743076,459681,61.9,435994,58.7,23687,5.2
23825,December 2014,District of Columbia,549536,384535,70.0,355697,64.7,28838,7.5
23826,December 2014,Florida,16135636,9606748,59.5,9043324,56.0,563424,5.9
23827,December 2014,Georgia,7716136,4765097,61.8,4456817,57.8,308280,6.5
23828,December 2014,Hawaii,1085938,670992,61.8,643858,59.3,27134,4.0
23829,December 2014,Idaho,1233611,784581,63.6,749839,60.8,34742,4.4
23830,December 2014,Illinois,10056511,6485617,64.5,6088273,60.5,397344,6.1
23831,December 2014,Indiana,5105177,3247940,63.6,3068680,60.1,179260,5.5
23832,December 2014,Iowa,2422884,1705360,70.4,1637271,67.6,68089,4.0
23833,December 2014,Kansas,2197641,1490665,67.8,1426575,64.9,64090,4.3
23834,December 2014,Kentucky,3430256,1981580,57.8,1873171,54.6,108409,5.5
23835,December 2014,Louisiana,3560915,2192712,61.6,2040627,57.3,152085,6.9
23836,December 2014,Maine,1089637,690013,63.3,654890,60.1,35123,5.1
23837,December 2014,Maryland,4694908,3140635,66.9,2967796,63.2,172839,5.5
23838,December 2014,Massachusetts,5481207,3600356,65.7,3412065,62.3,188291,5.2
23839,December 2014,Michigan,7860439,4750544,60.4,4455413,56.7,295131,6.2
23840,December 2014,Minnesota,4267856,2982642,69.9,2869729,67.2,112913,3.8
23841,December 2014,Mississippi,2273045,1249203,55.0,1163705,51.2,85498,6.8
23842,December 2014,Missouri,4723206,3068612,65.0,2897845,61.4,170767,5.6
23843,December 2014,Montana,808443,512705,63.4,490440,60.7,22265,4.3
23844,December 2014,Nebraska,1437371,1006963,70.1,977188,68.0,29775,3.0
23845,December 2014,Nevada,2224747,1404457,63.1,1301840,58.5,102617,7.3
23846,December 2014,New Hampshire,1081331,741778,68.6,713091,65.9,28687,3.9
23847,December 2014,New Jersey,7076714,4548708,64.3,4250883,60.1,297825,6.5
23848,December 2014,New Mexico,1602143,929745,58.0,869948,54.3,59797,6.4
23849,December 2014,New York,15830652,9608495,60.7,9052083,57.2,556412,5.8
23850,December 2014,North Carolina,7741143,4726586,61.1,4452955,57.5,273631,5.8
23851,December 2014,North Dakota,575741,417490,72.5,406401,70.6,11089,2.7
23852,December 2014,Ohio,9103026,5708602,62.7,5413523,59.5,295079,5.2
23853,December 2014,Oklahoma,2954773,1815420,61.4,1740041,58.9,75379,4.2
23854,December 2014,Oregon,3184179,1951551,61.3,1832551,57.6,119000,6.1
23855,December 2014,Pennsylvania,10215826,6406038,62.7,6059760,59.3,346278,5.4
23856,December 2014,Rhode Island,853892,555103,65.0,518074,60.7,37029,6.7
23857,December 2014,South Carolina,3785868,2254936,59.6,2107569,55.7,147367,6.5
23858,December 2014,South Dakota,645614,448030,69.4,433114,67.1,14916,3.3
23859,December 2014,Tennessee,5131082,3041991,59.3,2850703,55.6,191288,6.3
23860,December 2014,Texas,20279611,13052867,64.4,12458463,61.4,594404,4.6
23861,December 2014,Utah,2119398,1443453,68.1,1390763,65.6,52690,3.7
23862,December 2014,Vermont,513765,346195,67.4,332994,64.8,13201,3.8
23863,December 2014,Virginia,6470471,4231749,65.4,4023558,62.2,208191,4.9
23864,December 2014,Washington,5557668,3521903,63.4,3315896,59.7,206007,5.8
23865,December 2014,West Virginia,1480739,779218,52.6,728088,49.2,51130,6.6
23866,December 2014,Wisconsin,4535614,3089823,68.1,2939772,64.8,150051,4.9
23867,December 2014,Wyoming,450773,305921,67.9,293881,65.2,12040,3.9
23868,January 2015,Alabama,3789162,2152864,56.8,2022508,53.4,130356,6.1
23869,January 2015,Alaska,541721,364564,67.3,340969,62.9,23595,6.5
23870,January 2015,Arizona,5209473,3132506,60.1,2931891,56.3,200615,6.4
23871,January 2015,Arkansas,2290769,1326006,57.9,1251706,54.6,74300,5.6
23872,January 2015,California,30268573,18869738,62.3,17594160,58.1,1275578,6.8
23873,January 2015,Colorado,4185055,2814564,67.3,2694651,64.4,119913,4.3
23874,January 2015,Connecticut,2876268,1910500,66.4,1794135,62.4,116365,6.1
23875,January 2015,Delaware,743836,460708,61.9,437353,58.8,23355,5.1
23876,January 2015,District of Columbia,550187,384933,70.0,356362,64.8,28571,7.4
23877,January 2015,Florida,16162602,9601148,59.4,9044574,56.0,556574,5.8
23878,January 2015,Georgia,7725536,4766879,61.7,4462844,57.8,304035,6.4
23879,January 2015,Hawaii,1086679,671725,61.8,644855,59.3,26870,4.0
23880,January 2015,Idaho,1235063,786097,63.6,751776,60.9,34321,4.4
23881,January 2015,Illinois,10056621,6480066,64.4,6089149,60.5,390917,6.0
23882,January 2015,Indiana,5106678,3248169,63.6,3073306,60.2,174863,5.4
23883,January 2015,Iowa,2423670,1704352,70.3,1637228,67.6,67124,3.9
23884,January 2015,Kansas,2198224,1490547,67.8,1426176,64.9,64371,4.3
23885,January 2015,Kentucky,3431308,1979563,57.7,1872776,54.6,106787,5.4
23886,January 2015,Louisiana,3562772,2190299,61.5,2040119,57.3,150180,6.9
23887,January 2015,Maine,1089695,688770,63.2,654546,60.1,34224,5.0
23888,January 2015,Maryland,4697335,3142076,66.9,2970741,63.2,171335,5.5
23889,January 2015,Massachusetts,5484602,3600655,65.7,3415819,62.3,184836,5.1
23890,January 2015,Michigan,7861736,4744689,60.4,4458455,56.7,286234,6.0
23891,January 2015,Minnesota,4269886,2984479,69.9,2872393,67.3,112086,3.8
23892,January 2015,Mississippi,2273392,1251285,55.0,1166864,51.3,84421,6.7
23893,January 2015,Missouri,4724740,3072671,65.0,2902307,61.4,170364,5.5
23894,January 2015,Montana,808957,513440,63.5,491565,60.8,21875,4.3
23895,January 2015,Nebraska,1438039,1006398,70.0,976938,67.9,29460,2.9
23896,January 2015,Nevada,2228472,1406035,63.1,1304585,58.5,101450,7.2
23897,January 2015,New Hampshire,1081524,742044,68.6,713810,66.0,28234,3.8
23898,January 2015,New Jersey,7078985,4547984,64.2,4253146,60.1,294838,6.5
23899,January 2015,New Mexico,1602604,929802,58.0,869768,54.3,60034,6.5
23900,January 2015,New York,15835219,9616089,60.7,9065084,57.2,551005,5.7
23901,January 2015,North Carolina,7749944,4732430,61.1,4459452,57.5,272978,5.8
23902,January 2015,North Dakota,576533,417050,72.3,406012,70.4,11038,2.6
23903,January 2015,Ohio,9104495,5703166,62.6,5411624,59.4,291542,5.1
23904,January 2015,Oklahoma,2956853,1820025,61.6,1743912,59.0,76113,4.2
23905,January 2015,Oregon,3188328,1952569,61.2,1836074,57.6,116495,6.0
23906,January 2015,Pennsylvania,10216221,6406562,62.7,6060921,59.3,345641,5.4
23907,January 2015,Rhode Island,854112,555178,65.0,518751,60.7,36427,6.6
23908,January 2015,South Carolina,3791324,2257877,59.6,2111797,55.7,146080,6.5
23909,January 2015,South Dakota,645868,448326,69.4,433534,67.1,14792,3.3
23910,January 2015,Tennessee,5134983,3048047,59.4,2859089,55.7,188958,6.2
23911,January 2015,Texas,20315137,13045312,64.2,12460631,61.3,584681,4.5
23912,January 2015,Utah,2122739,1446630,68.1,1394253,65.7,52377,3.6
23913,January 2015,Vermont,513757,346124,67.4,333065,64.8,13059,3.8
23914,January 2015,Virginia,6474742,4229159,65.3,4023319,62.1,205840,4.9
23915,January 2015,Washington,5565293,3524048,63.3,3320282,59.7,203766,5.8
23916,January 2015,West Virginia,1480104,778972,52.6,727112,49.1,51860,6.7
23917,January 2015,Wisconsin,4536654,3088625,68.1,2940724,64.8,147901,4.8
23918,January 2015,Wyoming,450862,305637,67.8,293711,65.1,11926,3.9
23919,February 2015,Alabama,3789800,2153032,56.8,2022729,53.4,130303,6.1
23920,February 2015,Alaska,541923,364475,67.3,340940,62.9,23535,6.5
23921,February 2015,Arizona,5216404,3136046,60.1,2937344,56.3,198702,6.3
23922,February 2015,Arkansas,2291292,1326908,57.9,1252979,54.7,73929,5.6
23923,February 2015,California,30293032,18875876,62.3,17616950,58.2,1258926,6.7
23924,February 2015,Colorado,4192191,2815991,67.2,2697178,64.3,118813,4.2
23925,February 2015,Connecticut,2876190,1909452,66.4,1794936,62.4,114516,6.0
23926,February 2015,Delaware,744450,461822,62.0,438686,58.9,23136,5.0
23927,February 2015,District of Columbia,550813,385199,69.9,356931,64.8,28268,7.3
23928,February 2015,Florida,16186801,9597967,59.3,9046666,55.9,551301,5.7
23929,February 2015,Georgia,7734031,4770086,61.7,4468447,57.8,301639,6.3
23930,February 2015,Hawaii,1087324,672452,61.8,645961,59.4,26491,3.9
23931,February 2015,Idaho,1236344,787839,63.7,753691,61.0,34148,4.3
23932,February 2015,Illinois,10055233,6479149,64.4,6091086,60.6,388063,6.0
23933,February 2015,Indiana,5107598,3248712,63.6,3078122,60.3,170590,5.3
23934,February 2015,Iowa,2424081,1703365,70.3,1636962,67.5,66403,3.9
23935,February 2015,Kansas,2198560,1490576,67.8,1425754,64.8,64822,4.3
23936,February 2015,Kentucky,3432063,1978051,57.6,1872197,54.6,105854,5.4
23937,February 2015,Louisiana,3564171,2186465,61.3,2038531,57.2,147934,6.8
23938,February 2015,Maine,1089626,687487,63.1,654184,60.0,33303,4.8
23939,February 2015,Maryland,4699180,3143998,66.9,2974063,63.3,169935,5.4
23940,February 2015,Massachusetts,5487260,3599696,65.6,3417349,62.3,182347,5.1
23941,February 2015,Michigan,7861944,4741110,60.3,4461002,56.7,280108,5.9
23942,February 2015,Minnesota,4271436,2987104,69.9,2875222,67.3,111882,3.7
23943,February 2015,Mississippi,2273472,1253894,55.2,1170186,51.5,83708,6.7
23944,February 2015,Missouri,4725574,3076662,65.1,2906273,61.5,170389,5.5
23945,February 2015,Montana,809416,514258,63.5,492690,60.9,21568,4.2
23946,February 2015,Nebraska,1438569,1006024,69.9,976655,67.9,29369,2.9
23947,February 2015,Nevada,2231955,1407528,63.1,1307267,58.6,100261,7.1
23948,February 2015,New Hampshire,1081669,742148,68.6,714389,66.0,27759,3.7
23949,February 2015,New Jersey,7080286,4547301,64.2,4255716,60.1,291585,6.4
23950,February 2015,New Mexico,1602835,929775,58.0,869305,54.2,60470,6.5
23951,February 2015,New York,15837694,9625636,60.8,9078633,57.3,547003,5.7
23952,February 2015,North Carolina,7757904,4740390,61.1,4465033,57.6,275357,5.8
23953,February 2015,North Dakota,577324,416431,72.1,405369,70.2,11062,2.7
23954,February 2015,Ohio,9104793,5699269,62.6,5408818,59.4,290451,5.1
23955,February 2015,Oklahoma,2958523,1824392,61.7,1746858,59.0,77534,4.2
23956,February 2015,Oregon,3192016,1954637,61.2,1839768,57.6,114869,5.9
23957,February 2015,Pennsylvania,10215183,6408527,62.7,6061886,59.3,346641,5.4
23958,February 2015,Rhode Island,854252,555352,65.0,519408,60.8,35944,6.5
23959,February 2015,South Carolina,3796172,2260659,59.6,2115598,55.7,145061,6.4
23960,February 2015,South Dakota,646097,448650,69.4,434003,67.2,14647,3.3
23961,February 2015,Tennessee,5138272,3053936,59.4,2866956,55.8,186980,6.1
23962,February 2015,Texas,20348035,13041224,64.1,12461065,61.2,580159,4.4
23963,February 2015,Utah,2125905,1449800,68.2,1397477,65.7,52323,3.6
23964,February 2015,Vermont,513694,346018,67.4,333114,64.8,12904,3.7
23965,February 2015,Virginia,6478482,4227366,65.3,4023369,62.1,203997,4.8
23966,February 2015,Washington,5572449,3526710,63.3,3324560,59.7,202150,5.7
23967,February 2015,West Virginia,1479365,779326,52.7,726410,49.1,52916,6.8
23968,February 2015,Wisconsin,4537095,3087873,68.1,2941388,64.8,146485,4.7
23969,February 2015,Wyoming,450942,305426,67.7,293446,65.1,11980,3.9
23970,March 2015,Alabama,3790622,2154425,56.8,2023392,53.4,131033,6.1
23971,March 2015,Alaska,541982,364382,67.2,340839,62.9,23543,6.5
23972,March 2015,Arizona,5223437,3139582,60.1,2943010,56.3,196572,6.3
23973,March 2015,Arkansas,2292014,1327878,57.9,1254590,54.7,73288,5.5
23974,March 2015,California,30316517,18884659,62.3,17641582,58.2,1243077,6.6
23975,March 2015,Colorado,4199297,2817740,67.1,2700289,64.3,117451,4.2
23976,March 2015,Connecticut,2876213,1907169,66.3,1794585,62.4,112584,5.9
23977,March 2015,Delaware,745115,463016,62.1,440022,59.1,22994,5.0
23978,March 2015,District of Columbia,551461,385532,69.9,357618,64.8,27914,7.2
23979,March 2015,Florida,16211183,9599576,59.2,9052910,55.8,546666,5.7
23980,March 2015,Georgia,7742407,4774160,61.7,4474681,57.8,299479,6.3
23981,March 2015,Hawaii,1087566,673142,61.9,647188,59.5,25954,3.9
23982,March 2015,Idaho,1237689,789664,63.8,755539,61.0,34125,4.3
23983,March 2015,Illinois,10054289,6483672,64.5,6096084,60.6,387588,6.0
23984,March 2015,Indiana,5108963,3250447,63.6,3084016,60.4,166431,5.1
23985,March 2015,Iowa,2424751,1702586,70.2,1636758,67.5,65828,3.9
23986,March 2015,Kansas,2198855,1490648,67.8,1425555,64.8,65093,4.4
23987,March 2015,Kentucky,3432955,1977029,57.6,1871681,54.5,105348,5.3
23988,March 2015,Louisiana,3565624,2181803,61.2,2036573,57.1,145230,6.7
23989,March 2015,Maine,1089658,686222,63.0,653823,60.0,32399,4.7
23990,March 2015,Maryland,4701046,3146357,66.9,2978170,63.4,168187,5.3
23991,March 2015,Massachusetts,5490343,3597954,65.5,3417585,62.2,180369,5.0
23992,March 2015,Michigan,7862795,4740542,60.3,4464827,56.8,275715,5.8
23993,March 2015,Minnesota,4273366,2990401,70.0,2878381,67.4,112020,3.7
23994,March 2015,Mississippi,2273510,1256836,55.3,1173763,51.6,83073,6.6
23995,March 2015,Missouri,4726784,3079966,65.2,2910302,61.6,169664,5.5
23996,March 2015,Montana,809903,514994,63.6,493613,60.9,21381,4.2
23997,March 2015,Nebraska,1439217,1005926,69.9,976454,67.8,29472,2.9
23998,March 2015,Nevada,2235436,1408992,63.0,1309909,58.6,99083,7.0
23999,March 2015,New Hampshire,1081876,742179,68.6,714960,66.1,27219,3.7
24000,March 2015,New Jersey,7081861,4546585,64.2,4259282,60.1,287303,6.3
24001,March 2015,New Mexico,1602947,929633,58.0,868742,54.2,60891,6.6
24002,March 2015,New York,15840633,9636161,60.8,9094038,57.4,542123,5.6
24003,March 2015,North Carolina,7765376,4749922,61.2,4470992,57.6,278930,5.9
24004,March 2015,North Dakota,578116,415734,71.9,404558,70.0,11176,2.7
24005,March 2015,Ohio,9105863,5697465,62.6,5407698,59.4,289767,5.1
24006,March 2015,Oklahoma,2960250,1828268,61.8,1749070,59.1,79198,4.3
24007,March 2015,Oregon,3195992,1958063,61.3,1844089,57.7,113974,5.8
24008,March 2015,Pennsylvania,10214987,6412351,62.8,6064850,59.4,347501,5.4
24009,March 2015,Rhode Island,854358,555556,65.0,520062,60.9,35494,6.4
24010,March 2015,South Carolina,3800944,2263370,59.5,2119600,55.8,143770,6.4
24011,March 2015,South Dakota,646323,448978,69.5,434468,67.2,14510,3.2
24012,March 2015,Tennessee,5141775,3058985,59.5,2874305,55.9,184680,6.0
24013,March 2015,Texas,20380438,13041797,64.0,12463536,61.2,578261,4.4
24014,March 2015,Utah,2129180,1453059,68.2,1400564,65.8,52495,3.6
24015,March 2015,Vermont,513660,345830,67.3,333081,64.8,12749,3.7
24016,March 2015,Virginia,6481724,4226340,65.2,4024620,62.1,201720,4.8
24017,March 2015,Washington,5579443,3530163,63.3,3329138,59.7,201025,5.7
24018,March 2015,West Virginia,1478739,780190,52.8,726154,49.1,54036,6.9
24019,March 2015,Wisconsin,4537980,3087872,68.0,2942528,64.8,145344,4.7
24020,March 2015,Wyoming,451035,305298,67.7,293095,65.0,12203,4.0
24021,April 2015,Alabama,3791632,2156636,56.9,2024505,53.4,132131,6.1
24022,April 2015,Alaska,542056,364256,67.2,340699,62.9,23557,6.5
24023,April 2015,Arizona,5230796,3143599,60.1,2949235,56.4,194364,6.2
24024,April 2015,Arkansas,2292824,1329057,58.0,1256877,54.8,72180,5.4
24025,April 2015,California,30342382,18893637,62.3,17668653,58.2,1224984,6.5
24026,April 2015,Colorado,4206654,2819642,67.0,2704075,64.3,115567,4.1
24027,April 2015,Connecticut,2876359,1903863,66.2,1793199,62.3,110664,5.8
24028,April 2015,Delaware,745806,464258,62.2,441369,59.2,22889,4.9
24029,April 2015,District of Columbia,552103,386015,69.9,358497,64.9,27518,7.1
24030,April 2015,Florida,16236574,9605698,59.2,9064192,55.8,541506,5.6
24031,April 2015,Georgia,7751273,4778272,61.6,4481808,57.8,296464,6.2
24032,April 2015,Hawaii,1088002,673815,61.9,648485,59.6,25330,3.8
24033,April 2015,Idaho,1239077,791449,63.9,757305,61.1,34144,4.3
24034,April 2015,Illinois,10053957,6491955,64.6,6104163,60.7,387792,6.0
24035,April 2015,Indiana,5110448,3253644,63.7,3091145,60.5,162499,5.0
24036,April 2015,Iowa,2425513,1701865,70.2,1636591,67.5,65274,3.8
24037,April 2015,Kansas,2199224,1490624,67.8,1425746,64.8,64878,4.4
24038,April 2015,Kentucky,3434000,1976187,57.5,1871270,54.5,104917,5.3
24039,April 2015,Louisiana,3567270,2176477,61.0,2034417,57.0,142060,6.5
24040,April 2015,Maine,1089715,685039,62.9,653482,60.0,31557,4.6
24041,April 2015,Maryland,4703124,3148794,67.0,2982816,63.4,165978,5.3
24042,April 2015,Massachusetts,5493626,3595589,65.5,3417183,62.2,178406,5.0
24043,April 2015,Michigan,7864017,4742127,60.3,4470699,56.9,271428,5.7
24044,April 2015,Minnesota,4275446,2993808,70.0,2881802,67.4,112006,3.7
24045,April 2015,Mississippi,2273699,1259778,55.4,1177425,51.8,82353,6.5
24046,April 2015,Missouri,4728187,3081666,65.2,2914573,61.6,167093,5.4
24047,April 2015,Montana,810455,515524,63.6,494207,61.0,21317,4.1
24048,April 2015,Nebraska,1439858,1006142,69.9,976398,67.8,29744,3.0
24049,April 2015,Nevada,2239083,1410438,63.0,1312405,58.6,98033,7.0
24050,April 2015,New Hampshire,1082119,742183,68.6,715586,66.1,26597,3.6
24051,April 2015,New Jersey,7083804,4545285,64.2,4263782,60.2,281503,6.2
24052,April 2015,New Mexico,1603222,929340,58.0,868239,54.2,61101,6.6
24053,April 2015,New York,15844457,9645383,60.9,9110699,57.5,534684,5.5
24054,April 2015,North Carolina,7773266,4759578,61.2,4477830,57.6,281748,5.9
24055,April 2015,North Dakota,578972,415055,71.7,403701,69.7,11354,2.7
24056,April 2015,Ohio,9107282,5696792,62.6,5408946,59.4,287846,5.1
24057,April 2015,Oklahoma,2962129,1831270,61.8,1750663,59.1,80607,4.4
24058,April 2015,Oregon,3200119,1962741,61.3,1849244,57.8,113497,5.8
24059,April 2015,Pennsylvania,10215154,6417432,62.8,6070270,59.4,347162,5.4
24060,April 2015,Rhode Island,854522,555653,65.0,520686,60.9,34967,6.3
24061,April 2015,South Carolina,3806063,2265694,59.5,2123982,55.8,141712,6.3
24062,April 2015,South Dakota,646577,449253,69.5,434856,67.3,14397,3.2
24063,April 2015,Tennessee,5145513,3062401,59.5,2880692,56.0,181709,5.9
24064,April 2015,Texas,20414381,13046053,63.9,12469384,61.1,576669,4.4
24065,April 2015,Utah,2132578,1456338,68.3,1403548,65.8,52790,3.6
24066,April 2015,Vermont,513665,345530,67.3,332924,64.8,12606,3.6
24067,April 2015,Virginia,6485382,4225385,65.2,4027036,62.1,198349,4.7
24068,April 2015,Washington,5586782,3534273,63.3,3334147,59.7,200126,5.7
24069,April 2015,West Virginia,1478148,781249,52.9,726347,49.1,54902,7.0
24070,April 2015,Wisconsin,4538989,3088516,68.0,2944479,64.9,144037,4.7
24071,April 2015,Wyoming,451127,305225,67.7,292694,64.9,12531,4.1
24072,May 2015,Alabama,3792867,2158534,56.9,2025485,53.4,133049,6.2
24073,May 2015,Alaska,542218,364100,67.2,340548,62.8,23552,6.5
24074,May 2015,Arizona,5238475,3147710,60.1,2955431,56.4,192279,6.1
24075,May 2015,Arkansas,2293802,1330421,58.0,1259836,54.9,70585,5.3
24076,May 2015,California,30369572,18898102,62.2,17694738,58.3,1203364,6.4
24077,May 2015,Colorado,4214242,2821296,66.9,2708106,64.3,113190,4.0
24078,May 2015,Connecticut,2876766,1899800,66.0,1790984,62.3,108816,5.7
24079,May 2015,Delaware,746531,465513,62.4,442714,59.3,22799,4.9
24080,May 2015,District of Columbia,552762,386621,69.9,359520,65.0,27101,7.0
24081,May 2015,Florida,16263036,9613096,59.1,9077851,55.8,535245,5.6
24082,May 2015,Georgia,7760788,4781352,61.6,4489081,57.8,292271,6.1
24083,May 2015,Hawaii,1088455,674477,62.0,649763,59.7,24714,3.7
24084,May 2015,Idaho,1240597,793134,63.9,758989,61.2,34145,4.3
24085,May 2015,Illinois,10054337,6500197,64.7,6113055,60.8,387142,6.0
24086,May 2015,Indiana,5112385,3257569,63.7,3098693,60.6,158876,4.9
24087,May 2015,Iowa,2426515,1701032,70.1,1636338,67.4,64694,3.8
24088,May 2015,Kansas,2199883,1490357,67.7,1426290,64.8,64067,4.3
24089,May 2015,Kentucky,3435335,1975090,57.5,1870715,54.5,104375,5.3
24090,May 2015,Louisiana,3569144,2170541,60.8,2031824,56.9,138717,6.4
24091,May 2015,Maine,1089855,683963,62.8,653163,59.9,30800,4.5
24092,May 2015,Maryland,4705398,3150776,67.0,2987267,63.5,163509,5.2
24093,May 2015,Massachusetts,5497322,3592385,65.3,3416150,62.1,176235,4.9
24094,May 2015,Michigan,7865733,4744012,60.3,4477974,56.9,266038,5.6
24095,May 2015,Minnesota,4277891,2996756,70.1,2885083,67.4,111673,3.7
24096,May 2015,Mississippi,2274030,1262296,55.5,1180820,51.9,81476,6.5
24097,May 2015,Missouri,4730047,3081150,65.1,2918698,61.7,162452,5.3
24098,May 2015,Montana,811058,515857,63.6,494500,61.0,21357,4.1
24099,May 2015,Nebraska,1440702,1006573,69.9,976482,67.8,30091,3.0
24100,May 2015,Nevada,2242765,1411779,62.9,1314641,58.6,97138,6.9
24101,May 2015,New Hampshire,1082466,742072,68.6,716138,66.2,25934,3.5
24102,May 2015,New Jersey,7086147,4542634,64.1,4268359,60.2,274275,6.0
24103,May 2015,New Mexico,1603569,928843,57.9,867829,54.1,61014,6.6
24104,May 2015,New York,15849110,9650027,60.9,9125791,57.6,524236,5.4
24105,May 2015,North Carolina,7781965,4767359,61.3,4484780,57.6,282579,5.9
24106,May 2015,North Dakota,579855,414436,71.5,402899,69.5,11537,2.8
24107,May 2015,Ohio,9109353,5695302,62.5,5411352,59.4,283950,5.0
24108,May 2015,Oklahoma,2964358,1833030,61.8,1751592,59.1,81438,4.4
24109,May 2015,Oregon,3204427,1968112,61.4,1855080,57.9,113032,5.7
24110,May 2015,Pennsylvania,10216164,6421799,62.9,6076529,59.5,345270,5.4
24111,May 2015,Rhode Island,854759,555528,65.0,521231,61.0,34297,6.2
24112,May 2015,South Carolina,3811606,2267387,59.5,2128457,55.8,138930,6.1
24113,May 2015,South Dakota,646892,449427,69.5,435126,67.3,14301,3.2
24114,May 2015,Tennessee,5149599,3063520,59.5,2885399,56.0,178121,5.8
24115,May 2015,Texas,20449363,13051485,63.8,12476596,61.0,574889,4.4
24116,May 2015,Utah,2136109,1459521,68.3,1406444,65.8,53077,3.6
24117,May 2015,Vermont,513682,345130,67.2,332647,64.8,12483,3.6
24118,May 2015,Virginia,6489542,4223305,65.1,4029385,62.1,193920,4.6
24119,May 2015,Washington,5594549,3538326,63.2,3339019,59.7,199307,5.6
24120,May 2015,West Virginia,1477718,782009,52.9,726786,49.2,55223,7.1
24121,May 2015,Wisconsin,4540371,3089389,68.0,2946983,64.9,142406,4.6
24122,May 2015,Wyoming,451277,305157,67.6,292283,64.8,12874,4.2
24123,June 2015,Alabama,3794336,2159045,56.9,2025786,53.4,133259,6.2
24124,June 2015,Alaska,542558,363935,67.1,340385,62.7,23550,6.5
24125,June 2015,Arizona,5246311,3151289,60.1,2960783,56.4,190506,6.0
24126,June 2015,Arkansas,2294863,1331757,58.0,1263138,55.0,68619,5.2
24127,June 2015,California,30398253,18894808,62.2,17716426,58.3,1178382,6.2
24128,June 2015,Colorado,4222184,2822330,66.8,2711857,64.2,110473,3.9
24129,June 2015,Connecticut,2877302,1895321,65.9,1788208,62.1,107113,5.7
24130,June 2015,Delaware,747322,466746,62.5,444029,59.4,22717,4.9
24131,June 2015,District of Columbia,553471,387336,70.0,360633,65.2,26703,6.9
24132,June 2015,Florida,16290421,9618579,59.0,9090798,55.8,527781,5.5
24133,June 2015,Georgia,7770774,4782837,61.5,4495751,57.9,287086,6.0
24134,June 2015,Hawaii,1089370,675105,62.0,650952,59.8,24153,3.6
24135,June 2015,Idaho,1242140,794576,64.0,760542,61.2,34034,4.3
24136,June 2015,Illinois,10054970,6505427,64.7,6120210,60.9,385217,5.9
24137,June 2015,Indiana,5114391,3261201,63.8,3105684,60.7,155517,4.8
24138,June 2015,Iowa,2427560,1700147,70.0,1636052,67.4,64095,3.8
24139,June 2015,Kansas,2200761,1489841,67.7,1427031,64.8,62810,4.2
24140,June 2015,Kentucky,3436830,1973549,57.4,1869870,54.4,103679,5.3
24141,June 2015,Louisiana,3571212,2164016,60.6,2028512,56.8,135504,6.3
24142,June 2015,Maine,1090073,682961,62.7,652855,59.9,30106,4.4
24143,June 2015,Maryland,4708180,3151847,66.9,2990862,63.5,160985,5.1
24144,June 2015,Massachusetts,5501161,3588237,65.2,3414433,62.1,173804,4.8
24145,June 2015,Michigan,7867598,4744884,60.3,4485560,57.0,259324,5.5
24146,June 2015,Minnesota,4280430,2998741,70.1,2887737,67.5,111004,3.7
24147,June 2015,Mississippi,2274531,1264033,55.6,1183562,52.0,80471,6.4
24148,June 2015,Missouri,4732062,3078734,65.1,2922165,61.8,156569,5.1
24149,June 2015,Montana,811695,516126,63.6,494691,60.9,21435,4.2
24150,June 2015,Nebraska,1441578,1007111,69.9,976681,67.8,30430,3.0
24151,June 2015,Nevada,2246625,1412964,62.9,1316646,58.6,96318,6.8
24152,June 2015,New Hampshire,1082859,741858,68.5,716579,66.2,25279,3.4
24153,June 2015,New Jersey,7088669,4538357,64.0,4272321,60.3,266036,5.9
24154,June 2015,New Mexico,1604055,928170,57.9,867467,54.1,60703,6.5
24155,June 2015,New York,15854245,9647923,60.9,9136826,57.6,511097,5.3
24156,June 2015,North Carolina,7791281,4771646,61.2,4490741,57.6,280905,5.9
24157,June 2015,North Dakota,580809,413879,71.3,402214,69.3,11665,2.8
24158,June 2015,Ohio,9111629,5691595,62.5,5413260,59.4,278335,4.9
24159,June 2015,Oklahoma,2966622,1833437,61.8,1751810,59.1,81627,4.5
24160,June 2015,Oregon,3208862,1973545,61.5,1861348,58.0,112197,5.7
24161,June 2015,Pennsylvania,10217395,6423435,62.9,6081445,59.5,341990,5.3
24162,June 2015,Rhode Island,855041,555159,64.9,521642,61.0,33517,6.0
24163,June 2015,South Carolina,3817392,2268388,59.4,2132646,55.9,135742,6.0
24164,June 2015,South Dakota,647247,449487,69.4,435301,67.3,14186,3.2
24165,June 2015,Tennessee,5153954,3062358,59.4,2888247,56.0,174111,5.7
24166,June 2015,Texas,20485589,13055985,63.7,12482627,60.9,573358,4.4
24167,June 2015,Utah,2139730,1462506,68.4,1409268,65.9,53238,3.6
24168,June 2015,Vermont,513715,344663,67.1,332285,64.7,12378,3.6
24169,June 2015,Virginia,6494869,4219251,65.0,4030449,62.1,188802,4.5
24170,June 2015,Washington,5602837,3541532,63.2,3343054,59.7,198478,5.6
24171,June 2015,West Virginia,1477338,782100,52.9,727251,49.2,54849,7.0
24172,June 2015,Wisconsin,4541930,3090132,68.0,2949553,64.9,140579,4.5
24173,June 2015,Wyoming,451456,305037,67.6,291893,64.7,13144,4.3
24174,July 2015,Alabama,3795751,2158418,56.9,2025695,53.4,132723,6.1
24175,July 2015,Alaska,542697,363781,67.0,340202,62.7,23579,6.5
24176,July 2015,Arizona,5254378,3154406,60.0,2965286,56.4,189120,6.0
24177,July 2015,Arkansas,2296018,1332991,58.1,1266510,55.2,66481,5.0
24178,July 2015,California,30426572,18887968,62.1,17735253,58.3,1152715,6.1
24179,July 2015,Colorado,4230105,2823113,66.7,2715331,64.2,107782,3.8
24180,July 2015,Connecticut,2877825,1891197,65.7,1785389,62.0,105808,5.6
24181,July 2015,Delaware,748105,467950,62.6,445303,59.5,22647,4.8
24182,July 2015,District of Columbia,554195,388169,70.0,361812,65.3,26357,6.8
24183,July 2015,Florida,16317952,9623389,59.0,9103240,55.8,520149,5.4
24184,July 2015,Georgia,7779896,4784055,61.5,4502316,57.9,281739,5.9
24185,July 2015,Hawaii,1089899,675749,62.0,652094,59.8,23655,3.5
24186,July 2015,Idaho,1243728,795794,64.0,761995,61.3,33799,4.2
24187,July 2015,Illinois,10055564,6508349,64.7,6125236,60.9,383113,5.9
24188,July 2015,Indiana,5116676,3264871,63.8,3112210,60.8,152661,4.7
24189,July 2015,Iowa,2428753,1699492,70.0,1635952,67.4,63540,3.7
24190,July 2015,Kansas,2201522,1489276,67.6,1427863,64.9,61413,4.1
24191,July 2015,Kentucky,3438398,1972328,57.4,1869233,54.4,103095,5.2
24192,July 2015,Louisiana,3573334,2157405,60.4,2024693,56.7,132712,6.2
24193,July 2015,Maine,1090290,682015,62.6,652580,59.9,29435,4.3
24194,July 2015,Maryland,4710838,3152293,66.9,2993690,63.5,158603,5.0
24195,July 2015,Massachusetts,5505271,3583976,65.1,3412692,62.0,171284,4.8
24196,July 2015,Michigan,7869958,4745542,60.3,4493354,57.1,252188,5.3
24197,July 2015,Minnesota,4283197,2999848,70.0,2889785,67.5,110063,3.7
24198,July 2015,Mississippi,2274922,1265293,55.6,1185655,52.1,79638,6.3
24199,July 2015,Missouri,4734051,3075828,65.0,2925242,61.8,150586,4.9
24200,July 2015,Montana,812354,516527,63.6,495038,60.9,21489,4.2
24201,July 2015,Nebraska,1442507,1007690,69.9,977001,67.7,30689,3.0
24202,July 2015,Nevada,2250507,1414165,62.8,1318691,58.6,95474,6.8
24203,July 2015,New Hampshire,1083272,741623,68.5,716967,66.2,24656,3.3
24204,July 2015,New Jersey,7091489,4533668,63.9,4276000,60.3,257668,5.7
24205,July 2015,New Mexico,1604482,927461,57.8,867116,54.0,60345,6.5
24206,July 2015,New York,15860022,9642615,60.8,9145207,57.7,497408,5.2
24207,July 2015,North Carolina,7800245,4773491,61.2,4496181,57.6,277310,5.8
24208,July 2015,North Dakota,581744,413404,71.1,401697,69.1,11707,2.8
24209,July 2015,Ohio,9114388,5687046,62.4,5414473,59.4,272573,4.8
24210,July 2015,Oklahoma,2968775,1832981,61.7,1751566,59.0,81415,4.4
24211,July 2015,Oregon,3213423,1978977,61.6,1868008,58.1,110969,5.6
24212,July 2015,Pennsylvania,10219184,6422978,62.9,6084751,59.5,338227,5.3
24213,July 2015,Rhode Island,855315,554612,64.8,521902,61.0,32710,5.9
24214,July 2015,South Carolina,3822254,2269190,59.4,2136611,55.9,132579,5.8
24215,July 2015,South Dakota,647596,449488,69.4,435475,67.2,14013,3.1
24216,July 2015,Tennessee,5158386,3060464,59.3,2890457,56.0,170007,5.6
24217,July 2015,Texas,20521356,13061556,63.6,12488065,60.9,573491,4.4
24218,July 2015,Utah,2143421,1465430,68.4,1412167,65.9,53263,3.6
24219,July 2015,Vermont,513792,344191,67.0,331914,64.6,12277,3.6
24220,July 2015,Virginia,6499325,4214178,64.8,4030452,62.0,183726,4.4
24221,July 2015,Washington,5610947,3544371,63.2,3346383,59.6,197988,5.6
24222,July 2015,West Virginia,1476960,781572,52.9,727692,49.3,53880,6.9
24223,July 2015,Wisconsin,4543662,3091219,68.0,2952303,65.0,138916,4.5
24224,July 2015,Wyoming,451634,304844,67.5,291540,64.6,13304,4.4
24225,August 2015,Alabama,3797413,2157506,56.8,2025684,53.3,131822,6.1
24226,August 2015,Alaska,543105,363638,67.0,339980,62.6,23658,6.5
24227,August 2015,Arizona,5263778,3157379,60.0,2969433,56.4,187946,6.0
24228,August 2015,Arkansas,2297396,1334099,58.1,1269727,55.3,64372,4.8
24229,August 2015,California,30454240,18883260,62.0,17753613,58.3,1129647,6.0
24230,August 2015,Colorado,4237972,2824328,66.6,2718949,64.2,105379,3.7
24231,August 2015,Connecticut,2878479,1888108,65.6,1783002,61.9,105106,5.6
24232,August 2015,Delaware,748918,469108,62.6,446526,59.6,22582,4.8
24233,August 2015,District of Columbia,555001,389037,70.1,362967,65.4,26070,6.7
24234,August 2015,Florida,16348638,9629515,58.9,9116146,55.8,513369,5.3
24235,August 2015,Georgia,7789700,4786699,61.4,4509593,57.9,277106,5.8
24236,August 2015,Hawaii,1090444,676428,62.0,653238,59.9,23190,3.4
24237,August 2015,Idaho,1246160,796877,63.9,763368,61.3,33509,4.2
24238,August 2015,Illinois,10056465,6511013,64.7,6128774,60.9,382239,5.9
24239,August 2015,Indiana,5119623,3269022,63.9,3118521,60.9,150501,4.6
24240,August 2015,Iowa,2429981,1699215,69.9,1636168,67.3,63047,3.7
24241,August 2015,Kansas,2202578,1488871,67.6,1428682,64.9,60189,4.0
24242,August 2015,Kentucky,3440255,1972226,57.3,1869285,54.3,102941,5.2
24243,August 2015,Louisiana,3575145,2151397,60.2,2020723,56.5,130674,6.1
24244,August 2015,Maine,1090700,681160,62.5,652397,59.8,28763,4.2
24245,August 2015,Maryland,4713249,3152548,66.9,2996172,63.6,156376,5.0
24246,August 2015,Massachusetts,5508904,3580576,65.0,3411726,61.9,168850,4.7
24247,August 2015,Michigan,7873356,4747133,60.3,4501452,57.2,245681,5.2
24248,August 2015,Minnesota,4286682,3000704,70.0,2891547,67.5,109157,3.6
24249,August 2015,Mississippi,2275749,1266557,55.7,1187360,52.2,79197,6.3
24250,August 2015,Missouri,4736197,3073713,64.9,2928251,61.8,145462,4.7
24251,August 2015,Montana,813182,517172,63.6,495639,61.0,21533,4.2
24252,August 2015,Nebraska,1443656,1008235,69.8,977406,67.7,30829,3.1
24253,August 2015,Nevada,2254778,1415480,62.8,1320936,58.6,94544,6.7
24254,August 2015,New Hampshire,1083981,741433,68.4,717372,66.2,24061,3.2
24255,August 2015,New Jersey,7094737,4529601,63.8,4279822,60.3,249779,5.5
24256,August 2015,New Mexico,1605345,926850,57.7,866712,54.0,60138,6.5
24257,August 2015,New York,15865188,9638772,60.8,9152893,57.7,485879,5.0
24258,August 2015,North Carolina,7810363,4774649,61.1,4501794,57.6,272855,5.7
24259,August 2015,North Dakota,581758,413054,71.0,401355,69.0,11699,2.8
24260,August 2015,Ohio,9117859,5683697,62.3,5415269,59.4,268428,4.7
24261,August 2015,Oklahoma,2970394,1832145,61.7,1750994,58.9,81151,4.4
24262,August 2015,Oregon,3219119,1984543,61.6,1875044,58.2,109499,5.5
24263,August 2015,Pennsylvania,10221355,6421669,62.8,6086835,59.6,334834,5.2
24264,August 2015,Rhode Island,855645,553984,64.7,522018,61.0,31966,5.8
24265,August 2015,South Carolina,3827502,2270343,59.3,2140430,55.9,129913,5.7
24266,August 2015,South Dakota,648138,449500,69.4,435714,67.2,13786,3.1
24267,August 2015,Tennessee,5163677,3059596,59.3,2893587,56.0,166009,5.4
24268,August 2015,Texas,20555491,13070260,63.6,12494300,60.8,575960,4.4
24269,August 2015,Utah,2148023,1468405,68.4,1415187,65.9,53218,3.6
24270,August 2015,Vermont,513865,343753,66.9,331590,64.5,12163,3.5
24271,August 2015,Virginia,6503950,4209225,64.7,4029807,62.0,179418,4.3
24272,August 2015,Washington,5620852,3547789,63.1,3349676,59.6,198113,5.6
24273,August 2015,West Virginia,1476519,780721,52.9,728092,49.3,52629,6.7
24274,August 2015,Wisconsin,4545874,3093075,68.0,2955525,65.0,137550,4.4
24275,August 2015,Wyoming,451617,304621,67.5,291199,64.5,13422,4.4
24276,September 2015,Alabama,3799079,2157233,56.8,2026310,53.3,130923,6.1
24277,September 2015,Alaska,543492,363487,66.9,339705,62.5,23782,6.5
24278,September 2015,Arizona,5273082,3160793,59.9,2974175,56.4,186618,5.9
24279,September 2015,Arkansas,2298742,1335078,58.1,1272676,55.4,62402,4.7
24280,September 2015,California,30481978,18885350,62.0,17775211,58.3,1110139,5.9
24281,September 2015,Colorado,4245843,2826738,66.6,2723507,64.1,103231,3.7
24282,September 2015,Connecticut,2879134,1886258,65.5,1781381,61.9,104877,5.6
24283,September 2015,Delaware,749744,470196,62.7,447699,59.7,22497,4.8
24284,September 2015,District of Columbia,555824,389817,70.1,363986,65.5,25831,6.6
24285,September 2015,Florida,16379357,9639189,58.8,9132024,55.8,507165,5.3
24286,September 2015,Georgia,7799558,4792273,61.4,4518960,57.9,273313,5.7
24287,September 2015,Hawaii,1090917,677105,62.1,654391,60.0,22714,3.4
24288,September 2015,Idaho,1248552,797949,63.9,764764,61.3,33185,4.2
24289,September 2015,Illinois,10057469,6515622,64.8,6132703,61.0,382919,5.9
24290,September 2015,Indiana,5122546,3274355,63.9,3125350,61.0,149005,4.6
24291,September 2015,Iowa,2431266,1699444,69.9,1636748,67.3,62696,3.7
24292,September 2015,Kansas,2203635,1488737,67.6,1429444,64.9,59293,4.0
24293,September 2015,Kentucky,3442099,1973770,57.3,1870510,54.3,103260,5.2
24294,September 2015,Louisiana,3576944,2146610,60.0,2017192,56.4,129418,6.0
24295,September 2015,Maine,1091089,680551,62.4,652453,59.8,28098,4.1
24296,September 2015,Maryland,4715658,3153030,66.9,2998899,63.6,154131,4.9
24297,September 2015,Massachusetts,5512536,3578676,64.9,3412307,61.9,166369,4.6
24298,September 2015,Michigan,7876742,4750797,60.3,4510687,57.3,240110,5.1
24299,September 2015,Minnesota,4290197,3002186,70.0,2893651,67.4,108535,3.6
24300,September 2015,Mississippi,2276603,1268207,55.7,1189099,52.2,79108,6.2
24301,September 2015,Missouri,4738326,3073050,64.9,2931627,61.9,141423,4.6
24302,September 2015,Montana,814021,517976,63.6,496398,61.0,21578,4.2
24303,September 2015,Nebraska,1444783,1008689,69.8,977830,67.7,30859,3.1
24304,September 2015,Nevada,2259028,1416886,62.7,1323418,58.6,93468,6.6
24305,September 2015,New Hampshire,1084699,741421,68.4,717947,66.2,23474,3.2
24306,September 2015,New Jersey,7097965,4526812,63.8,4284395,60.4,242417,5.4
24307,September 2015,New Mexico,1606246,926459,57.7,866330,53.9,60129,6.5
24308,September 2015,New York,15870313,9639790,60.7,9162509,57.7,477281,5.0
24309,September 2015,North Carolina,7820341,4776854,61.1,4508688,57.7,268166,5.6
24310,September 2015,North Dakota,581760,412876,71.0,401159,69.0,11717,2.8
24311,September 2015,Ohio,9121264,5683488,62.3,5416746,59.4,266742,4.7
24312,September 2015,Oklahoma,2972052,1831411,61.6,1750319,58.9,81092,4.4
24313,September 2015,Oregon,3224803,1990474,61.7,1882613,58.4,107861,5.4
24314,September 2015,Pennsylvania,10223448,6421300,62.8,6089074,59.6,332226,5.2
24315,September 2015,Rhode Island,855954,553425,64.7,522076,61.0,31349,5.7
24316,September 2015,South Carolina,3832961,2272162,59.3,2144311,55.9,127851,5.6
24317,September 2015,South Dakota,648664,449589,69.3,436054,67.2,13535,3.0
24318,September 2015,Tennessee,5168965,3061025,59.2,2899106,56.1,161919,5.3
24319,September 2015,Texas,20589821,13083640,63.5,12504368,60.7,579272,4.4
24320,September 2015,Utah,2152662,1471468,68.4,1418323,65.9,53145,3.6
24321,September 2015,Vermont,513962,343399,66.8,331369,64.5,12030,3.5
24322,September 2015,Virginia,6508504,4205517,64.6,4029409,61.9,176108,4.2
24323,September 2015,Washington,5630695,3552718,63.1,3354185,59.6,198533,5.6
24324,September 2015,West Virginia,1476155,780011,52.8,728525,49.4,51486,6.6
24325,September 2015,Wisconsin,4548125,3095932,68.1,2959654,65.1,136278,4.4
24326,September 2015,Wyoming,451644,304400,67.4,290826,64.4,13574,4.5
24327,October 2015,Alabama,3800840,2158433,56.8,2028049,53.4,130384,6.0
24328,October 2015,Alaska,543796,363325,66.8,339395,62.4,23930,6.6
24329,October 2015,Arizona,5282499,3165860,59.9,2980794,56.4,185066,5.8
24330,October 2015,Arkansas,2300168,1336144,58.1,1275490,55.5,60654,4.5
24331,October 2015,California,30509688,18900681,61.9,17805009,58.4,1095672,5.8
24332,October 2015,Colorado,4253599,2831273,66.6,2729866,64.2,101407,3.6
24333,October 2015,Connecticut,2879803,1885861,65.5,1780926,61.8,104935,5.6
24334,October 2015,Delaware,750585,471208,62.8,448834,59.8,22374,4.7
24335,October 2015,District of Columbia,556631,390487,70.2,364861,65.5,25626,6.6
24336,October 2015,Florida,16410155,9656292,58.8,9154582,55.8,501710,5.2
24337,October 2015,Georgia,7809686,4802666,61.5,4531928,58.0,270738,5.6
24338,October 2015,Hawaii,1091103,677789,62.1,655575,60.1,22214,3.3
24339,October 2015,Idaho,1251001,799217,63.9,766345,61.3,32872,4.1
24340,October 2015,Illinois,10058693,6525571,64.9,6139841,61.0,385730,5.9
24341,October 2015,Indiana,5125625,3282622,64.0,3133962,61.1,148660,4.5
24342,October 2015,Iowa,2432556,1700229,69.9,1637732,67.3,62497,3.7
24343,October 2015,Kansas,2204609,1488969,67.5,1430124,64.9,58845,4.0
24344,October 2015,Kentucky,3443941,1977278,57.4,1873341,54.4,103937,5.3
24345,October 2015,Louisiana,3578785,2143724,59.9,2014753,56.3,128971,6.0
24346,October 2015,Maine,1091530,680404,62.3,652909,59.8,27495,4.0
24347,October 2015,Maryland,4718082,3154434,66.9,3002557,63.6,151877,4.8
24348,October 2015,Massachusetts,5516309,3578931,64.9,3415105,61.9,163826,4.6
24349,October 2015,Michigan,7880326,4758819,60.4,4522383,57.4,236436,5.0
24350,October 2015,Minnesota,4293832,3005312,70.0,2896714,67.5,108598,3.6
24351,October 2015,Mississippi,2277449,1270486,55.8,1191269,52.3,79217,6.2
24352,October 2015,Missouri,4740598,3074709,64.9,2936068,61.9,138641,4.5
24353,October 2015,Montana,814851,518844,63.7,497199,61.0,21645,4.2
24354,October 2015,Nebraska,1445924,1009076,69.8,978237,67.7,30839,3.1
24355,October 2015,Nevada,2263257,1418387,62.7,1326109,58.6,92278,6.5
24356,October 2015,New Hampshire,1085445,741679,68.3,718796,66.2,22883,3.1
24357,October 2015,New Jersey,7101393,4526413,63.7,4290296,60.4,236117,5.2
24358,October 2015,New Mexico,1607083,926428,57.6,866134,53.9,60294,6.5
24359,October 2015,New York,15875733,9649346,60.8,9176940,57.8,472406,4.9
24360,October 2015,North Carolina,7829990,4782646,61.1,4518594,57.7,264052,5.5
24361,October 2015,North Dakota,581729,412889,71.0,401051,68.9,11838,2.9
24362,October 2015,Ohio,9124856,5688797,62.3,5420833,59.4,267964,4.7
24363,October 2015,Oklahoma,2973774,1831462,61.6,1749948,58.8,81514,4.5
24364,October 2015,Oregon,3230550,1997346,61.8,1891126,58.5,106220,5.3
24365,October 2015,Pennsylvania,10225796,6424953,62.8,6093761,59.6,331192,5.2
24366,October 2015,Rhode Island,856296,553120,64.6,522237,61.0,30883,5.6
24367,October 2015,South Carolina,3838639,2275165,59.3,2148649,56.0,126516,5.6
24368,October 2015,South Dakota,649218,449781,69.3,436489,67.2,13292,3.0
24369,October 2015,Tennessee,5174265,3065916,59.3,2907972,56.2,157944,5.2
24370,October 2015,Texas,20624058,13105284,63.5,12522649,60.7,582635,4.4
24371,October 2015,Utah,2157302,1474796,68.4,1421695,65.9,53101,3.6
24372,October 2015,Vermont,514050,343199,66.8,331320,64.5,11879,3.5
24373,October 2015,Virginia,6512633,4204910,64.6,4031024,61.9,173886,4.1
24374,October 2015,Washington,5640325,3560369,63.1,3361332,59.6,199037,5.6
24375,October 2015,West Virginia,1475770,779844,52.8,729142,49.4,50702,6.5
24376,October 2015,Wisconsin,4550422,3100298,68.1,2965296,65.2,135002,4.4
24377,October 2015,Wyoming,451662,304200,67.4,290382,64.3,13818,4.5
24378,November 2015,Alabama,3802411,2161113,56.8,2030806,53.4,130307,6.0
24379,November 2015,Alaska,544394,363189,66.7,339106,62.3,24083,6.6
24380,November 2015,Arizona,5291559,3172959,60.0,2989479,56.5,183480,5.8
24381,November 2015,Arkansas,2301355,1337454,58.1,1278332,55.5,59122,4.4
24382,November 2015,California,30537296,18930454,62.0,17843177,58.4,1087277,5.7
24383,November 2015,Colorado,4261501,2838185,66.6,2738100,64.3,100085,3.5
24384,November 2015,Connecticut,2880317,1886812,65.5,1781767,61.9,105045,5.6
24385,November 2015,Delaware,751347,472125,62.8,449921,59.9,22204,4.7
24386,November 2015,District of Columbia,557417,391122,70.2,365689,65.6,25433,6.5
24387,November 2015,Florida,16440042,9681233,58.9,9183799,55.9,497434,5.1
24388,November 2015,Georgia,7820174,4818164,61.6,4548457,58.2,269707,5.6
24389,November 2015,Hawaii,1092244,678467,62.1,656747,60.1,21720,3.2
24390,November 2015,Idaho,1253314,800797,63.9,768198,61.3,32599,4.1
24391,November 2015,Illinois,10059306,6541806,65.0,6150781,61.1,391025,6.0
24392,November 2015,Indiana,5128079,3294330,64.2,3144405,61.3,149925,4.6
24393,November 2015,Iowa,2433548,1701366,69.9,1638960,67.3,62406,3.7
24394,November 2015,Kansas,2205666,1489462,67.5,1430670,64.9,58792,3.9
24395,November 2015,Kentucky,3445677,1982149,57.5,1877513,54.5,104636,5.3
24396,November 2015,Louisiana,3580424,2142794,59.8,2013499,56.2,129295,6.0
24397,November 2015,Maine,1091831,680844,62.4,653837,59.9,27007,4.0
24398,November 2015,Maryland,4720547,3157033,66.9,3007280,63.7,149753,4.7
24399,November 2015,Massachusetts,5519439,3581595,64.9,3420236,62.0,161359,4.5
24400,November 2015,Michigan,7882885,4771979,60.5,4536566,57.5,235413,4.9
24401,November 2015,Minnesota,4296864,3010353,70.1,2900741,67.5,109612,3.6
24402,November 2015,Mississippi,2278297,1273187,55.9,1193870,52.4,79317,6.2
24403,November 2015,Missouri,4742544,3078496,64.9,2941351,62.0,137145,4.5
24404,November 2015,Montana,815623,519663,63.7,497919,61.0,21744,4.2
24405,November 2015,Nebraska,1447044,1009412,69.8,978590,67.6,30822,3.1
24406,November 2015,Nevada,2267421,1419852,62.6,1328854,58.6,90998,6.4
24407,November 2015,New Hampshire,1086078,742227,68.3,719919,66.3,22308,3.0
24408,November 2015,New Jersey,7104042,4528761,63.7,4296943,60.5,231818,5.1
24409,November 2015,New Mexico,1607908,926774,57.6,866189,53.9,60585,6.5
24410,November 2015,New York,15879455,9666507,60.9,9195096,57.9,471411,4.9
24411,November 2015,North Carolina,7840325,4793113,61.1,4531941,57.8,261172,5.4
24412,November 2015,North Dakota,581744,413080,71.0,400974,68.9,12106,2.9
24413,November 2015,Ohio,9127344,5700315,62.5,5428202,59.5,272113,4.8
24414,November 2015,Oklahoma,2975405,1832474,61.6,1749941,58.8,82533,4.5
24415,November 2015,Oregon,3235835,2005356,62.0,1900588,58.7,104768,5.2
24416,November 2015,Pennsylvania,10226766,6433854,62.9,6101195,59.7,332659,5.2
24417,November 2015,Rhode Island,856649,553122,64.6,522558,61.0,30564,5.5
24418,November 2015,South Carolina,3844783,2279461,59.3,2153555,56.0,125906,5.5
24419,November 2015,South Dakota,649697,450056,69.3,436968,67.3,13088,2.9
24420,November 2015,Tennessee,5179305,3073995,59.4,2919494,56.4,154501,5.0
24421,November 2015,Texas,20658476,13135543,63.6,12549480,60.7,586063,4.5
24422,November 2015,Utah,2161751,1478590,68.4,1425409,65.9,53181,3.6
24423,November 2015,Vermont,514109,343170,66.8,331446,64.5,11724,3.4
24424,November 2015,Virginia,6518754,4207928,64.6,4035173,61.9,172755,4.1
24425,November 2015,Washington,5650379,3571004,63.2,3371407,59.7,199597,5.6
24426,November 2015,West Virginia,1475216,780239,52.9,729928,49.5,50311,6.4
24427,November 2015,Wisconsin,4552207,3106162,68.2,2972354,65.3,133808,4.3
24428,November 2015,Wyoming,451636,304054,67.3,289848,64.2,14206,4.7
24429,December 2015,Alabama,3803714,2164212,56.9,2033895,53.5,130317,6.0
24430,December 2015,Alaska,544457,363123,66.7,338890,62.2,24233,6.7
24431,December 2015,Arizona,5300245,3181208,60.0,2999350,56.6,181858,5.7
24432,December 2015,Arkansas,2302472,1338709,58.1,1280985,55.6,57724,4.3
24433,December 2015,California,30561717,18966230,62.1,17884555,58.5,1081675,5.7
24434,December 2015,Colorado,4268581,2846469,66.7,2747292,64.4,99177,3.5
24435,December 2015,Connecticut,2880711,1888469,65.6,1783630,61.9,104839,5.6
24436,December 2015,Delaware,752062,472896,62.9,450910,60.0,21986,4.6
24437,December 2015,District of Columbia,558140,391797,70.2,366585,65.7,25212,6.4
24438,December 2015,Florida,16468485,9708918,59.0,9215723,56.0,493195,5.1
24439,December 2015,Georgia,7829523,4836190,61.8,4566884,58.3,269306,5.6
24440,December 2015,Hawaii,1092030,679099,62.2,657821,60.2,21278,3.1
24441,December 2015,Idaho,1255606,802585,63.9,770265,61.3,32320,4.0
24442,December 2015,Illinois,10059706,6560144,65.2,6163243,61.3,396901,6.1
24443,December 2015,Indiana,5130697,3307528,64.5,3155379,61.5,152149,4.6
24444,December 2015,Iowa,2434615,1702422,69.9,1640116,67.4,62306,3.7
24445,December 2015,Kansas,2206177,1489807,67.5,1430983,64.9,58824,3.9
24446,December 2015,Kentucky,3447050,1987162,57.6,1882202,54.6,104960,5.3
24447,December 2015,Louisiana,3581813,2142787,59.8,2012919,56.2,129868,6.1
24448,December 2015,Maine,1092145,681821,62.4,655182,60.0,26639,3.9
24449,December 2015,Maryland,4722262,3160146,66.9,3012444,63.8,147702,4.7
24450,December 2015,Massachusetts,5522696,3585704,64.9,3426975,62.1,158729,4.4
24451,December 2015,Michigan,7885750,4787566,60.7,4551589,57.7,235977,4.9
24452,December 2015,Minnesota,4300051,3016108,70.1,2905136,67.6,110972,3.7
24453,December 2015,Mississippi,2278867,1275573,56.0,1196454,52.5,79119,6.2
24454,December 2015,Missouri,4744362,3082376,65.0,2946252,62.1,136124,4.4
24455,December 2015,Montana,816361,520327,63.7,498468,61.1,21859,4.2
24456,December 2015,Nebraska,1447973,1009640,69.7,978842,67.6,30798,3.1
24457,December 2015,Nevada,2271404,1421019,62.6,1331399,58.6,89620,6.3
24458,December 2015,New Hampshire,1086716,743012,68.4,721206,66.4,21806,2.9
24459,December 2015,New Jersey,7106698,4532336,63.8,4302757,60.5,229579,5.1
24460,December 2015,New Mexico,1608476,927360,57.7,866453,53.9,60907,6.6
24461,December 2015,New York,15883270,9683783,61.0,9212136,58.0,471647,4.9
24462,December 2015,North Carolina,7848538,4805667,61.2,4546944,57.9,258723,5.4
24463,December 2015,North Dakota,581594,413386,71.1,400901,68.9,12485,3.0
24464,December 2015,Ohio,9130052,5714833,62.6,5437417,59.6,277416,4.9
24465,December 2015,Oklahoma,2976747,1833796,61.6,1749913,58.8,83883,4.6
24466,December 2015,Oregon,3241264,2013727,62.1,1910279,58.9,103448,5.1
24467,December 2015,Pennsylvania,10228087,6444964,63.0,6109111,59.7,335853,5.2
24468,December 2015,Rhode Island,856876,553314,64.6,522959,61.0,30355,5.5
24469,December 2015,South Carolina,3850179,2284066,59.3,2158677,56.1,125389,5.5
24470,December 2015,South Dakota,650148,450348,69.3,437408,67.3,12940,2.9
24471,December 2015,Tennessee,5183953,3083259,59.5,2931797,56.6,151462,4.9
24472,December 2015,Texas,20690325,13168859,63.6,12580565,60.8,588294,4.5
24473,December 2015,Utah,2166157,1482830,68.5,1429475,66.0,53355,3.6
24474,December 2015,Vermont,514168,343279,66.8,331699,64.5,11580,3.4
24475,December 2015,Virginia,6521491,4212681,64.6,4040651,62.0,172030,4.1
24476,December 2015,Washington,5659038,3583080,63.3,3383287,59.8,199793,5.6
24477,December 2015,West Virginia,1474688,780948,53.0,730731,49.6,50217,6.4
24478,December 2015,Wisconsin,4554101,3112505,68.3,2979978,65.4,132527,4.3
24479,December 2015,Wyoming,451590,303992,67.3,289227,64.0,14765,4.9
24480,January 2016,Alabama,3804855,2166738,56.9,2036583,53.5,130155,6.0
24481,January 2016,Alaska,545303,363116,66.6,338737,62.1,24379,6.7
24482,January 2016,Arizona,5308785,3189617,60.1,3009326,56.7,180291,5.7
24483,January 2016,Arkansas,2303437,1339612,58.2,1283171,55.7,56441,4.2
24484,January 2016,California,30587966,18998578,62.1,17922727,58.6,1075851,5.7
24485,January 2016,Colorado,4276195,2854824,66.8,2756327,64.5,98497,3.5
24486,January 2016,Connecticut,2880905,1890386,65.6,1786143,62.0,104243,5.5
24487,January 2016,Delaware,752800,473470,62.9,451719,60.0,21751,4.6
24488,January 2016,District of Columbia,558922,392517,70.2,367566,65.8,24951,6.4
24489,January 2016,Florida,16496858,9734045,59.0,9245776,56.0,488269,5.0
24490,January 2016,Georgia,7839872,4853592,61.9,4585169,58.5,268423,5.5
24491,January 2016,Hawaii,1093509,679663,62.2,658737,60.2,20926,3.1
24492,January 2016,Idaho,1257774,804372,64.0,772360,61.4,32012,4.0
24493,January 2016,Illinois,10059395,6575193,65.4,6174129,61.4,401064,6.1
24494,January 2016,Indiana,5132392,3319337,64.7,3165020,61.7,154317,4.6
24495,January 2016,Iowa,2435238,1702859,69.9,1640749,67.4,62110,3.6
24496,January 2016,Kansas,2207181,1489683,67.5,1430919,64.8,58764,3.9
24497,January 2016,Kentucky,3448452,1991326,57.7,1886587,54.7,104739,5.3
24498,January 2016,Louisiana,3583153,2142546,59.8,2012275,56.2,130271,6.1
24499,January 2016,Maine,1092253,683181,62.5,656810,60.1,26371,3.9
24500,January 2016,Maryland,4724286,3162842,66.9,3017205,63.9,145637,4.6
24501,January 2016,Massachusetts,5525159,3589877,65.0,3434271,62.2,155606,4.3
24502,January 2016,Michigan,7887252,4802047,60.9,4565260,57.9,236787,4.9
24503,January 2016,Minnesota,4302534,3021121,70.2,2909097,67.6,112024,3.7
24504,January 2016,Mississippi,2279555,1277009,56.0,1198472,52.6,78537,6.2
24505,January 2016,Missouri,4745843,3084925,65.0,2949626,62.2,135299,4.4
24506,January 2016,Montana,817037,520800,63.7,498835,61.1,21965,4.2
24507,January 2016,Nebraska,1448860,1009749,69.7,978963,67.6,30786,3.0
24508,January 2016,Nevada,2275356,1421843,62.5,1333571,58.6,88272,6.2
24509,January 2016,New Hampshire,1087190,743851,68.4,722423,66.4,21428,2.9
24510,January 2016,New Jersey,7108635,4535191,63.8,4306309,60.6,228882,5.0
24511,January 2016,New Mexico,1609266,927982,57.7,866799,53.9,61183,6.6
24512,January 2016,New York,15885474,9693829,61.0,9223101,58.1,470728,4.9
24513,January 2016,North Carolina,7859388,4817070,61.3,4561187,58.0,255883,5.3
24514,January 2016,North Dakota,581605,413707,71.1,400820,68.9,12887,3.1
24515,January 2016,Ohio,9131252,5727886,62.7,5446034,59.6,281852,4.9
24516,January 2016,Oklahoma,2978157,1834586,61.6,1749338,58.7,85248,4.6
24517,January 2016,Oregon,3246095,2021679,62.3,1919339,59.1,102340,5.1
24518,January 2016,Pennsylvania,10227646,6454136,63.1,6114683,59.8,339453,5.3
24519,January 2016,Rhode Island,857116,553510,64.6,523326,61.1,30184,5.5
24520,January 2016,South Carolina,3856393,2287911,59.3,2163430,56.1,124481,5.4
24521,January 2016,South Dakota,650585,450580,69.3,437730,67.3,12850,2.9
24522,January 2016,Tennessee,5188456,3091912,59.6,2943168,56.7,148744,4.8
24523,January 2016,Texas,20723511,13199516,63.7,12610385,60.9,589131,4.5
24524,January 2016,Utah,2170402,1487244,68.5,1433717,66.1,53527,3.6
24525,January 2016,Vermont,514129,343459,66.8,331995,64.6,11464,3.3
24526,January 2016,Virginia,6527186,4217199,64.6,4046031,62.0,171168,4.1
24527,January 2016,Washington,5668739,3594774,63.4,3395445,59.9,199329,5.5
24528,January 2016,West Virginia,1473858,781676,53.0,731425,49.6,50251,6.4
24529,January 2016,Wisconsin,4555233,3118110,68.5,2987120,65.6,130990,4.2
24530,January 2016,Wyoming,451512,303985,67.3,288554,63.9,15431,5.1
24531,February 2016,Alabama,3805757,2168221,57.0,2038490,53.6,129731,6.0
24532,February 2016,Alaska,545425,363130,66.6,338609,62.1,24521,6.8
24533,February 2016,Arizona,5316907,3197499,60.1,3018568,56.8,178931,5.6
24534,February 2016,Arkansas,2304293,1340145,58.2,1284815,55.8,55330,4.1
24535,February 2016,California,30609882,19023416,62.1,17953960,58.7,1069456,5.6
24536,February 2016,Colorado,4283078,2862563,66.8,2764474,64.5,98089,3.4
24537,February 2016,Connecticut,2881006,1892490,65.7,1789142,62.1,103348,5.5
24538,February 2016,Delaware,753422,473846,62.9,452295,60.0,21551,4.5
24539,February 2016,District of Columbia,559620,393199,70.3,368524,65.9,24675,6.3
24540,February 2016,Florida,16522898,9754183,59.0,9271169,56.1,483014,5.0
24541,February 2016,Georgia,7848671,4868903,62.0,4601984,58.6,266919,5.5
24542,February 2016,Hawaii,1093456,680224,62.2,659505,60.3,20719,3.0
24543,February 2016,Idaho,1259879,806036,64.0,774339,61.5,31697,3.9
24544,February 2016,Illinois,10058664,6583442,65.5,6181201,61.5,402241,6.1
24545,February 2016,Indiana,5134412,3328010,64.8,3172203,61.8,155807,4.7
24546,February 2016,Iowa,2435978,1702464,69.9,1640548,67.3,61916,3.6
24547,February 2016,Kansas,2207595,1489031,67.5,1430376,64.8,58655,3.9
24548,February 2016,Kentucky,3449539,1994325,57.8,1890380,54.8,103945,5.2
24549,February 2016,Louisiana,3584226,2141486,59.7,2011031,56.1,130455,6.1
24550,February 2016,Maine,1092389,684810,62.7,658596,60.3,26214,3.8
24551,February 2016,Maryland,4725651,3164812,67.0,3021082,63.9,143730,4.5
24552,February 2016,Massachusetts,5527772,3593476,65.0,3441464,62.3,152012,4.2
24553,February 2016,Michigan,7889123,4813551,61.0,4576214,58.0,237337,4.9
24554,February 2016,Minnesota,4305309,3024783,70.3,2912078,67.6,112705,3.7
24555,February 2016,Mississippi,2279909,1277417,56.0,1199675,52.6,77742,6.1
24556,February 2016,Missouri,4747004,3085884,65.0,2950847,62.2,135037,4.4
24557,February 2016,Montana,817643,521085,63.7,499046,61.0,22039,4.2
24558,February 2016,Nebraska,1449649,1009754,69.7,978954,67.5,30800,3.1
24559,February 2016,Nevada,2278990,1422516,62.4,1335515,58.6,87001,6.1
24560,February 2016,New Hampshire,1087722,744615,68.5,723401,66.5,21214,2.8
24561,February 2016,New Jersey,7110505,4536386,63.8,4307177,60.6,229209,5.1
24562,February 2016,New Mexico,1609659,928496,57.7,867081,53.9,61415,6.6
24563,February 2016,New York,15887473,9693731,61.0,9225412,58.1,468319,4.8
24564,February 2016,North Carolina,7866919,4825860,61.3,4573255,58.1,252605,5.2
24565,February 2016,North Dakota,581399,413977,71.2,400755,68.9,13222,3.2
24566,February 2016,Ohio,9132824,5736558,62.8,5452142,59.7,284416,5.0
24567,February 2016,Oklahoma,2979258,1834349,61.6,1747880,58.7,86469,4.7
24568,February 2016,Oregon,3251063,2028874,62.4,1927175,59.3,101699,5.0
24569,February 2016,Pennsylvania,10227540,6459118,63.2,6116326,59.8,342792,5.3
24570,February 2016,Rhode Island,857290,553636,64.6,523609,61.1,30027,5.4
24571,February 2016,South Carolina,3861291,2290566,59.3,2167436,56.1,123130,5.4
24572,February 2016,South Dakota,650988,450750,69.2,437917,67.3,12833,2.8
24573,February 2016,Tennessee,5192644,3099359,59.7,2952699,56.9,146660,4.7
24574,February 2016,Texas,20754017,13225462,63.7,12635100,60.9,590362,4.5
24575,February 2016,Utah,2174766,1491665,68.6,1438041,66.1,53624,3.6
24576,February 2016,Vermont,514134,343678,66.8,332290,64.6,11388,3.3
24577,February 2016,Virginia,6529826,4220658,64.6,4050346,62.0,170312,4.0
24578,February 2016,Washington,5677076,3605078,63.5,3406672,60.0,198406,5.5
24579,February 2016,West Virginia,1473146,782132,53.1,731965,49.7,50167,6.4
24580,February 2016,Wisconsin,4556613,3122453,68.5,2992964,65.7,129489,4.1
24581,February 2016,Wyoming,451468,303954,67.3,287859,63.8,16095,5.3
24582,March 2016,Alabama,3806907,2168546,57.0,2039715,53.6,128831,5.9
24583,March 2016,Alaska,545630,363143,66.6,338475,62.0,24668,6.8
24584,March 2016,Arizona,5325179,3204221,60.2,3026569,56.8,177652,5.5
24585,March 2016,Arkansas,2305257,1340420,58.1,1286005,55.8,54415,4.1
24586,March 2016,California,30632154,19039622,62.2,17977540,58.7,1062082,5.6
24587,March 2016,Colorado,4290093,2869340,66.9,2771487,64.6,97853,3.4
24588,March 2016,Connecticut,2881132,1894859,65.8,1792613,62.2,102246,5.4
24589,March 2016,Delaware,754096,474044,62.9,452637,60.0,21407,4.5
24590,March 2016,District of Columbia,560317,393717,70.3,369302,65.9,24415,6.2
24591,March 2016,Florida,16549203,9768958,59.0,9291259,56.1,477699,4.9
24592,March 2016,Georgia,7858024,4881584,62.1,4616828,58.8,264756,5.4
24593,March 2016,Hawaii,1093290,680867,62.3,660228,60.4,20639,3.0
24594,March 2016,Idaho,1262143,807562,64.0,776157,61.5,31405,3.9
24595,March 2016,Illinois,10058351,6583314,65.5,6183626,61.5,399688,6.1
24596,March 2016,Indiana,5136786,3332963,64.9,3176839,61.8,156124,4.7
24597,March 2016,Iowa,2436827,1701402,69.8,1639559,67.3,61843,3.6
24598,March 2016,Kansas,2208126,1487951,67.4,1429318,64.7,58633,3.9
24599,March 2016,Kentucky,3450827,1996590,57.9,1893845,54.9,102745,5.1
24600,March 2016,Louisiana,3585476,2139109,59.7,2008745,56.0,130364,6.1
24601,March 2016,Maine,1092584,686607,62.8,660430,60.4,26177,3.8
24602,March 2016,Maryland,4727153,3166166,67.0,3024104,64.0,142062,4.5
24603,March 2016,Massachusetts,5530637,3596491,65.0,3448421,62.4,148070,4.1
24604,March 2016,Michigan,7891466,4821499,61.1,4584064,58.1,237435,4.9
24605,March 2016,Minnesota,4308253,3027140,70.3,2913936,67.6,113204,3.7
24606,March 2016,Mississippi,2280405,1277117,56.0,1200184,52.6,76933,6.0
24607,March 2016,Missouri,4748554,3085501,65.0,2949710,62.1,135791,4.4
24608,March 2016,Montana,818323,521224,63.7,499160,61.0,22064,4.2
24609,March 2016,Nebraska,1450484,1009636,69.6,978812,67.5,30824,3.1
24610,March 2016,Nevada,2282803,1423328,62.4,1337541,58.6,85787,6.0
24611,March 2016,New Hampshire,1088259,745256,68.5,724079,66.5,21177,2.8
24612,March 2016,New Jersey,7112628,4535566,63.8,4305784,60.5,229782,5.1
24613,March 2016,New Mexico,1610103,928859,57.7,867204,53.9,61655,6.6
24614,March 2016,New York,15890223,9684423,60.9,9219391,58.0,465032,4.8
24615,March 2016,North Carolina,7875281,4831662,61.4,4582793,58.2,248869,5.2
24616,March 2016,North Dakota,581262,414185,71.3,400771,68.9,13414,3.2
24617,March 2016,Ohio,9134949,5739612,62.8,5454768,59.7,284844,5.0
24618,March 2016,Oklahoma,2980518,1833117,61.5,1745591,58.6,87526,4.8
24619,March 2016,Oregon,3256241,2035128,62.5,1933604,59.4,101524,5.0
24620,March 2016,Pennsylvania,10228002,6459360,63.2,6114031,59.8,345329,5.3
24621,March 2016,Rhode Island,857440,553693,64.6,523811,61.1,29882,5.4
24622,March 2016,South Carolina,3866515,2291990,59.3,2170620,56.1,121370,5.3
24623,March 2016,South Dakota,651386,450917,69.2,438018,67.2,12899,2.9
24624,March 2016,Tennessee,5197145,3105920,59.8,2960511,57.0,145409,4.7
24625,March 2016,Texas,20784894,13246777,63.7,12653469,60.9,593308,4.5
24626,March 2016,Utah,2179209,1495989,68.6,1442465,66.2,53524,3.6
24627,March 2016,Vermont,514161,343933,66.9,332585,64.7,11348,3.3
24628,March 2016,Virginia,6532207,4223019,64.6,4053248,62.1,169771,4.0
24629,March 2016,Washington,5685581,3613596,63.6,3416330,60.1,197266,5.5
24630,March 2016,West Virginia,1472506,782190,53.1,732407,49.7,49783,6.4
24631,March 2016,Wisconsin,4558205,3125488,68.6,2997265,65.8,128223,4.1
24632,March 2016,Wyoming,451363,303790,67.3,287161,63.6,16629,5.5
24633,April 2016,Alabama,3808208,2168384,56.9,2040798,53.6,127586,5.9
24634,April 2016,Alaska,545918,363128,66.5,338301,62.0,24827,6.8
24635,April 2016,Arizona,5333724,3209737,60.2,3033383,56.9,176354,5.5
24636,April 2016,Arkansas,2306392,1340694,58.1,1286936,55.8,53758,4.0
24637,April 2016,California,30656970,19051354,62.1,17996254,58.7,1055100,5.5
24638,April 2016,Colorado,4297407,2875495,66.9,2777726,64.6,97769,3.4
24639,April 2016,Connecticut,2881423,1897560,65.9,1796438,62.3,101122,5.3
24640,April 2016,Delaware,754784,474111,62.8,452786,60.0,21325,4.5
24641,April 2016,District of Columbia,561092,394048,70.2,369841,65.9,24207,6.1
24642,April 2016,Florida,16576646,9781523,59.0,9308147,56.2,473376,4.8
24643,April 2016,Georgia,7867986,4892523,62.2,4630106,58.8,262417,5.4
24644,April 2016,Hawaii,1093476,681655,62.3,661060,60.5,20595,3.0
24645,April 2016,Idaho,1264382,809051,64.0,777887,61.5,31164,3.9
24646,April 2016,Illinois,10058701,6576574,65.4,6181944,61.5,394630,6.0
24647,April 2016,Indiana,5139216,3334891,64.9,3179595,61.9,155296,4.7
24648,April 2016,Iowa,2437785,1700094,69.7,1638154,67.2,61940,3.6
24649,April 2016,Kansas,2208768,1486698,67.3,1427841,64.6,58857,4.0
24650,April 2016,Kentucky,3452305,1999149,57.9,1897425,55.0,101724,5.1
24651,April 2016,Louisiana,3586896,2135735,59.5,2005530,55.9,130205,6.1
24652,April 2016,Maine,1092843,688452,63.0,662200,60.6,26252,3.8
24653,April 2016,Maryland,4728932,3167571,67.0,3026741,64.0,140830,4.4
24654,April 2016,Massachusetts,5533713,3599500,65.0,3455387,62.4,144113,4.0
24655,April 2016,Michigan,7893985,4827114,61.1,4589642,58.1,237472,4.9
24656,April 2016,Minnesota,4311308,3028832,70.3,2914965,67.6,113867,3.8
24657,April 2016,Mississippi,2281028,1276703,56.0,1200454,52.6,76249,6.0
24658,April 2016,Missouri,4750380,3084709,64.9,2946719,62.0,137990,4.5
24659,April 2016,Montana,818994,521327,63.7,499296,61.0,22031,4.2
24660,April 2016,Nebraska,1451439,1009453,69.5,978583,67.4,30870,3.1
24661,April 2016,Nevada,2286776,1424533,62.3,1339944,58.6,84589,5.9
24662,April 2016,New Hampshire,1088855,745870,68.5,724589,66.5,21281,2.9
24663,April 2016,New Jersey,7115049,4533694,63.7,4303477,60.5,230217,5.1
24664,April 2016,New Mexico,1610660,929129,57.7,867169,53.8,61960,6.7
24665,April 2016,New York,15893497,9671293,60.9,9208475,57.9,462818,4.8
24666,April 2016,North Carolina,7884183,4835707,61.3,4590456,58.2,245251,5.1
24667,April 2016,North Dakota,581163,414358,71.3,400932,69.0,13426,3.2
24668,April 2016,Ohio,9137258,5738636,62.8,5454416,59.7,284220,5.0
24669,April 2016,Oklahoma,2981948,1831412,61.4,1742923,58.4,88489,4.8
24670,April 2016,Oregon,3261475,2040554,62.6,1938884,59.4,101670,5.0
24671,April 2016,Pennsylvania,10228674,6456623,63.1,6109343,59.7,347280,5.4
24672,April 2016,Rhode Island,857650,553738,64.6,523976,61.1,29762,5.4
24673,April 2016,South Carolina,3872140,2292767,59.2,2173366,56.1,119401,5.2
24674,April 2016,South Dakota,651807,451158,69.2,438113,67.2,13045,2.9
24675,April 2016,Tennessee,5201828,3112711,59.8,2967479,57.0,145232,4.7
24676,April 2016,Texas,20817563,13266124,63.7,12666886,60.8,599238,4.5
24677,April 2016,Utah,2183757,1500288,68.7,1447102,66.3,53186,3.5
24678,April 2016,Vermont,514182,344210,66.9,332884,64.7,11326,3.3
24679,April 2016,Virginia,6535674,4225403,64.7,4055384,62.0,170019,4.0
24680,April 2016,Washington,5694576,3620786,63.6,3424536,60.1,196250,5.4
24681,April 2016,West Virginia,1471902,781963,53.1,732816,49.8,49147,6.3
24682,April 2016,Wisconsin,4559896,3127726,68.6,3000309,65.8,127417,4.1
24683,April 2016,Wyoming,451309,303401,67.2,286475,63.5,16926,5.6
24684,May 2016,Alabama,3809559,2168867,56.9,2042261,53.6,126606,5.8
24685,May 2016,Alaska,546244,363067,66.5,338073,61.9,24994,6.9
24686,May 2016,Arizona,5342336,3214844,60.2,3039825,56.9,175019,5.4
24687,May 2016,Arkansas,2307514,1341223,58.1,1287858,55.8,53365,4.0
24688,May 2016,California,30681566,19065156,62.1,18014848,58.7,1050308,5.5
24689,May 2016,Colorado,4304863,2881818,66.9,2784082,64.7,97736,3.4
24690,May 2016,Connecticut,2881796,1900634,66.0,1800560,62.5,100074,5.3
24691,May 2016,Delaware,755479,474086,62.8,452791,59.9,21295,4.5
24692,May 2016,District of Columbia,561812,394246,70.2,370175,65.9,24071,6.1
24693,May 2016,Florida,16604522,9797113,59.0,9326116,56.2,470997,4.8
24694,May 2016,Georgia,7877928,4903819,62.2,4642941,58.9,260878,5.3
24695,May 2016,Hawaii,1093750,682657,62.4,662120,60.5,20537,3.0
24696,May 2016,Idaho,1266699,810579,64.0,779604,61.5,30975,3.8
24697,May 2016,Illinois,10059139,6566854,65.3,6177815,61.4,389039,5.9
24698,May 2016,Indiana,5141837,3335032,64.9,3181437,61.9,153595,4.6
24699,May 2016,Iowa,2438870,1698950,69.7,1636797,67.1,62153,3.7
24700,May 2016,Kansas,2209594,1485611,67.2,1426215,64.5,59396,4.0
24701,May 2016,Kentucky,3453922,2002952,58.0,1901579,55.1,101373,5.1
24702,May 2016,Louisiana,3588315,2132036,59.4,2001884,55.8,130152,6.1
24703,May 2016,Maine,1093135,690297,63.1,663862,60.7,26435,3.8
24704,May 2016,Maryland,4730759,3169805,67.0,3029632,64.0,140173,4.4
24705,May 2016,Massachusetts,5536949,3603159,65.1,3462678,62.5,140481,3.9
24706,May 2016,Michigan,7896643,4832414,61.2,4594352,58.2,238062,4.9
24707,May 2016,Minnesota,4314591,3030721,70.2,2915706,67.6,115015,3.8
24708,May 2016,Mississippi,2281666,1276791,56.0,1201018,52.6,75773,5.9
24709,May 2016,Missouri,4752322,3084398,64.9,2942967,61.9,141431,4.6
24710,May 2016,Montana,819759,521453,63.6,499497,60.9,21956,4.2
24711,May 2016,Nebraska,1452463,1009323,69.5,978344,67.4,30979,3.1
24712,May 2016,Nevada,2290690,1426295,62.3,1342871,58.6,83424,5.8
24713,May 2016,New Hampshire,1089482,746519,68.5,725083,66.6,21436,2.9
24714,May 2016,New Jersey,7117550,4532105,63.7,4301765,60.4,230340,5.1
24715,May 2016,New Mexico,1611214,929360,57.7,867045,53.8,62315,6.7
24716,May 2016,New York,15896889,9661160,60.8,9197499,57.9,463661,4.8
24717,May 2016,North Carolina,7893327,4840217,61.3,4597447,58.2,242770,5.0
24718,May 2016,North Dakota,581107,414519,71.3,401243,69.0,13276,3.2
24719,May 2016,Ohio,9139822,5736590,62.8,5452552,59.7,284038,5.0
24720,May 2016,Oklahoma,2983544,1829780,61.3,1740446,58.3,89334,4.9
24721,May 2016,Oregon,3266832,2045414,62.6,1943538,59.5,101876,5.0
24722,May 2016,Pennsylvania,10229698,6453909,63.1,6104677,59.7,349232,5.4
24723,May 2016,Rhode Island,857938,553827,64.6,524154,61.1,29673,5.4
24724,May 2016,South Carolina,3877853,2293375,59.1,2176034,56.1,117341,5.1
24725,May 2016,South Dakota,652291,451494,69.2,438240,67.2,13254,2.9
24726,May 2016,Tennessee,5206635,3120872,59.9,2974781,57.1,146091,4.7
24727,May 2016,Texas,20850100,13286617,63.7,12678715,60.8,607902,4.6
24728,May 2016,Utah,2188344,1504752,68.8,1452065,66.4,52687,3.5
24729,May 2016,Vermont,514225,344481,67.0,333180,64.8,11301,3.3
24730,May 2016,Virginia,6539571,4229290,64.7,4058025,62.1,171265,4.0
24731,May 2016,Washington,5703854,3627599,63.6,3432125,60.2,195474,5.4
24732,May 2016,West Virginia,1471359,781756,53.1,733286,49.8,48470,6.2
24733,May 2016,Wisconsin,4561826,3129801,68.6,3002676,65.8,127125,4.1
24734,May 2016,Wyoming,451289,302749,67.1,285802,63.3,16947,5.6
24735,June 2016,Alabama,3810938,2170437,57.0,2044198,53.6,126239,5.8
24736,June 2016,Alaska,546548,362974,66.4,337833,61.8,25141,6.9
24737,June 2016,Arizona,5350978,3220217,60.2,3046683,56.9,173534,5.4
24738,June 2016,Arkansas,2308693,1342026,58.1,1288916,55.8,53110,4.0
24739,June 2016,California,30706034,19082915,62.1,18035934,58.7,1046981,5.5
24740,June 2016,Colorado,4312373,2888818,67.0,2791396,64.7,97422,3.4
24741,June 2016,Connecticut,2882202,1903861,66.1,1804899,62.6,98962,5.2
24742,June 2016,Delaware,756222,473982,62.7,452687,59.9,21295,4.5
24743,June 2016,District of Columbia,562549,394370,70.1,370388,65.8,23982,6.1
24744,June 2016,Florida,16632531,9818190,59.0,9347954,56.2,470236,4.8
24745,June 2016,Georgia,7887750,4916680,62.3,4656111,59.0,260569,5.3
24746,June 2016,Hawaii,1093951,683850,62.5,663411,60.6,20439,3.0
24747,June 2016,Idaho,1269027,812222,64.0,781384,61.6,30838,3.8
24748,June 2016,Illinois,10059612,6556383,65.2,6172806,61.4,383577,5.9
24749,June 2016,Indiana,5144493,3333935,64.8,3182854,61.9,151081,4.5
24750,June 2016,Iowa,2439971,1697954,69.6,1635657,67.0,62297,3.7
24751,June 2016,Kansas,2210385,1484847,67.2,1424701,64.5,60146,4.1
24752,June 2016,Kentucky,3455513,2008078,58.1,1906395,55.2,101683,5.1
24753,June 2016,Louisiana,3589784,2128210,59.3,1998198,55.7,130012,6.1
24754,June 2016,Maine,1093444,692104,63.3,665443,60.9,26661,3.9
24755,June 2016,Maryland,4732597,3173074,67.0,3033124,64.1,139950,4.4
24756,June 2016,Massachusetts,5540261,3607475,65.1,3470112,62.6,137363,3.8
24757,June 2016,Michigan,7899406,4838198,61.2,4599012,58.2,239186,4.9
24758,June 2016,Minnesota,4317881,3033239,70.2,2916634,67.5,116605,3.8
24759,June 2016,Mississippi,2282315,1277652,56.0,1202260,52.7,75392,5.9
24760,June 2016,Missouri,4754289,3084323,64.9,2939363,61.8,144960,4.7
24761,June 2016,Montana,820528,521576,63.6,499751,60.9,21825,4.2
24762,June 2016,Nebraska,1453519,1009219,69.4,978103,67.3,31116,3.1
24763,June 2016,Nevada,2294644,1428524,62.3,1346208,58.7,82316,5.8
24764,June 2016,New Hampshire,1090154,747095,68.5,725552,66.6,21543,2.9
24765,June 2016,New Jersey,7120079,4530971,63.6,4301331,60.4,229640,5.1
24766,June 2016,New Mexico,1611797,929466,57.7,866833,53.8,62633,6.7
24767,June 2016,New York,15900365,9656897,60.7,9189687,57.8,467210,4.8
24768,June 2016,North Carolina,7902162,4846568,61.3,4604718,58.3,241850,5.0
24769,June 2016,North Dakota,581033,414656,71.4,401641,69.1,13015,3.1
24770,June 2016,Ohio,9142506,5735290,62.7,5450477,59.6,284813,5.0
24771,June 2016,Oklahoma,2985013,1828486,61.3,1738597,58.2,89889,4.9
24772,June 2016,Oregon,3272242,2049889,62.6,1948163,59.5,101726,5.0
24773,June 2016,Pennsylvania,10230869,6452786,63.1,6101694,59.6,351092,5.4
24774,June 2016,Rhode Island,858182,553925,64.5,524380,61.1,29545,5.3
24775,June 2016,South Carolina,3883427,2293809,59.1,2178673,56.1,115136,5.0
24776,June 2016,South Dakota,652762,451886,69.2,438401,67.2,13485,3.0
24777,June 2016,Tennessee,5211454,3130549,60.1,2983098,57.2,147451,4.7
24778,June 2016,Texas,20882719,13308254,63.7,12691603,60.8,616651,4.6
24779,June 2016,Utah,2192960,1509389,68.8,1457301,66.5,52088,3.5
24780,June 2016,Vermont,514301,344716,67.0,333460,64.8,11256,3.3
24781,June 2016,Virginia,6543447,4235054,64.7,4061892,62.1,173162,4.1
24782,June 2016,Washington,5713079,3634480,63.6,3439828,60.2,194652,5.4
24783,June 2016,West Virginia,1470879,781766,53.1,733865,49.9,47901,6.1
24784,June 2016,Wisconsin,4563772,3131899,68.6,3004851,65.8,127048,4.1
24785,June 2016,Wyoming,451251,301839,66.9,285148,63.2,16691,5.5
24786,July 2016,Alabama,3812500,2172918,57.0,2046485,53.7,126433,5.8
24787,July 2016,Alaska,546854,362901,66.4,337641,61.7,25260,7.0
24788,July 2016,Arizona,5359962,3226395,60.2,3054557,57.0,171838,5.3
24789,July 2016,Arkansas,2310029,1342926,58.1,1290076,55.8,52850,3.9
24790,July 2016,California,30732088,19103647,62.2,18060098,58.8,1043549,5.5
24791,July 2016,Colorado,4320123,2896488,67.0,2800024,64.8,96464,3.3
24792,July 2016,Connecticut,2882759,1906918,66.1,1809327,62.8,97591,5.1
24793,July 2016,Delaware,756987,473826,62.6,452516,59.8,21310,4.5
24794,July 2016,District of Columbia,563349,394490,70.0,370581,65.8,23909,6.1
24795,July 2016,Florida,16661545,9844722,59.1,9374622,56.3,470100,4.8
24796,July 2016,Georgia,7897572,4931371,62.4,4670094,59.1,261277,5.3
24797,July 2016,Hawaii,1094269,685061,62.6,664793,60.8,20268,3.0
24798,July 2016,Idaho,1271462,813918,64.0,783235,61.6,30683,3.8
24799,July 2016,Illinois,10060441,6546561,65.1,6168360,61.3,378201,5.8
24800,July 2016,Indiana,5147529,3331846,64.7,3183960,61.9,147886,4.4
24801,July 2016,Iowa,2441239,1696882,69.5,1634721,67.0,62161,3.7
24802,July 2016,Kansas,2211356,1484435,67.1,1423531,64.4,60904,4.1
24803,July 2016,Kentucky,3457370,2013977,58.3,1911673,55.3,102304,5.1
24804,July 2016,Louisiana,3591497,2124325,59.1,1994734,55.5,129591,6.1
24805,July 2016,Maine,1093840,693820,63.4,666979,61.0,26841,3.9
24806,July 2016,Maryland,4734776,3177308,67.1,3037412,64.2,139896,4.4
24807,July 2016,Massachusetts,5543933,3612256,65.2,3477347,62.7,134909,3.7
24808,July 2016,Michigan,7902795,4844616,61.3,4604076,58.3,240540,5.0
24809,July 2016,Minnesota,4321477,3036531,70.3,2918113,67.5,118418,3.9
24810,July 2016,Mississippi,2283060,1279022,56.0,1204207,52.7,74815,5.8
24811,July 2016,Missouri,4756430,3083872,64.8,2936517,61.7,147355,4.8
24812,July 2016,Montana,821321,521691,63.5,500040,60.9,21651,4.2
24813,July 2016,Nebraska,1454640,1009036,69.4,977806,67.2,31230,3.1
24814,July 2016,Nevada,2298788,1430927,62.2,1349678,58.7,81249,5.7
24815,July 2016,New Hampshire,1090876,747522,68.5,725965,66.5,21557,2.9
24816,July 2016,New Jersey,7123058,4530152,63.6,4302316,60.4,227836,5.0
24817,July 2016,New Mexico,1612490,929428,57.6,866610,53.7,62818,6.8
24818,July 2016,New York,15904949,9657971,60.7,9186540,57.8,471431,4.9
24819,July 2016,North Carolina,7911722,4855005,61.4,4612752,58.3,242253,5.0
24820,July 2016,North Dakota,581012,414739,71.4,402011,69.2,12728,3.1
24821,July 2016,Ohio,9145897,5735528,62.7,5449229,59.6,286299,5.0
24822,July 2016,Oklahoma,2986621,1827741,61.2,1737693,58.2,90048,4.9
24823,July 2016,Oregon,3277885,2054016,62.7,1953253,59.6,100763,4.9
24824,July 2016,Pennsylvania,10232813,6453104,63.1,6100843,59.6,352261,5.5
24825,July 2016,Rhode Island,858493,553953,64.5,524662,61.1,29291,5.3
24826,July 2016,South Carolina,3888748,2294123,59.0,2181313,56.1,112810,4.9
24827,July 2016,South Dakota,653298,452265,69.2,438569,67.1,13696,3.0
24828,July 2016,Tennessee,5216701,3141039,60.2,2992406,57.4,148633,4.7
24829,July 2016,Texas,20916186,13330303,63.7,12707069,60.8,623234,4.7
24830,July 2016,Utah,2197701,1514057,68.9,1462582,66.6,51475,3.4
24831,July 2016,Vermont,514389,344904,67.1,333715,64.9,11189,3.2
24832,July 2016,Virginia,6547555,4242427,64.8,4067366,62.1,175061,4.1
24833,July 2016,Washington,5722709,3641115,63.6,3448084,60.3,193031,5.3
24834,July 2016,West Virginia,1470446,781962,53.2,734506,50.0,47456,6.1
24835,July 2016,Wisconsin,4566110,3133839,68.6,3007198,65.9,126641,4.0
24836,July 2016,Wyoming,451228,300776,66.7,284525,63.1,16251,5.4
24837,August 2016,Alabama,3814344,2175777,57.0,2048690,53.7,127087,5.8
24838,August 2016,Alaska,546988,362878,66.3,337517,61.7,25361,7.0
24839,August 2016,Arizona,5369424,3233493,60.2,3063249,57.0,170244,5.3
24840,August 2016,Arkansas,2311503,1343759,58.1,1291228,55.9,52531,3.9
24841,August 2016,California,30757503,19124648,62.2,18084549,58.8,1040099,5.4
24842,August 2016,Colorado,4326757,2904307,67.1,2809433,64.9,94874,3.3
24843,August 2016,Connecticut,2883662,1909661,66.2,1813567,62.9,96094,5.0
24844,August 2016,Delaware,757829,473685,62.5,452345,59.7,21340,4.5
24845,August 2016,District of Columbia,563927,394700,70.0,370860,65.8,23840,6.0
24846,August 2016,Florida,16688728,9874732,59.2,9404227,56.4,470505,4.8
24847,August 2016,Georgia,7907439,4947161,62.6,4684242,59.2,262919,5.3
24848,August 2016,Hawaii,1094747,686121,62.7,666075,60.8,20046,2.9
24849,August 2016,Idaho,1274202,815540,64.0,785097,61.6,30443,3.7
24850,August 2016,Illinois,10061045,6538260,65.0,6164483,61.3,373777,5.7
24851,August 2016,Indiana,5150740,3329135,64.6,3184489,61.8,144646,4.3
24852,August 2016,Iowa,2442554,1695452,69.4,1633730,66.9,61722,3.6
24853,August 2016,Kansas,2212285,1484219,67.1,1422740,64.3,61479,4.1
24854,August 2016,Kentucky,3459224,2019860,58.4,1916794,55.4,103066,5.1
24855,August 2016,Louisiana,3592207,2120372,59.0,1991448,55.4,128924,6.1
24856,August 2016,Maine,1094515,695358,63.5,668501,61.1,26857,3.9
24857,August 2016,Maryland,4737823,3182340,67.2,3042323,64.2,140017,4.4
24858,August 2016,Massachusetts,5547759,3617304,65.2,3483842,62.8,133462,3.7
24859,August 2016,Michigan,7906871,4851400,61.4,4608898,58.3,242502,5.0
24860,August 2016,Minnesota,4325532,3040371,70.3,2920164,67.5,120207,4.0
24861,August 2016,Mississippi,2283831,1280427,56.1,1206408,52.8,74019,5.8
24862,August 2016,Missouri,4758724,3082274,64.8,2934287,61.7,147987,4.8
24863,August 2016,Montana,822278,521820,63.5,500354,60.8,21466,4.1
24864,August 2016,Nebraska,1455677,1008728,69.3,977396,67.1,31332,3.1
24865,August 2016,Nevada,2303452,1433243,62.2,1353010,58.7,80233,5.6
24866,August 2016,New Hampshire,1091706,747756,68.5,726271,66.5,21485,2.9
24867,August 2016,New Jersey,7126751,4529680,63.6,4304193,60.4,225487,5.0
24868,August 2016,New Mexico,1613339,929251,57.6,866426,53.7,62825,6.8
24869,August 2016,New York,15909398,9661489,60.7,9186699,57.7,474790,4.9
24870,August 2016,North Carolina,7923312,4864641,61.4,4620825,58.3,243816,5.0
24871,August 2016,North Dakota,580992,414751,71.4,402267,69.2,12484,3.0
24872,August 2016,Ohio,9150361,5737661,62.7,5448854,59.5,288807,5.0
24873,August 2016,Oklahoma,2987742,1827457,61.2,1737594,58.2,89863,4.9
24874,August 2016,Oregon,3282557,2057691,62.7,1958716,59.7,98975,4.8
24875,August 2016,Pennsylvania,10236056,6453783,63.0,6100991,59.6,352792,5.5
24876,August 2016,Rhode Island,858862,553870,64.5,525000,61.1,28870,5.2
24877,August 2016,South Carolina,3893990,2294503,58.9,2183854,56.1,110649,4.8
24878,August 2016,South Dakota,653879,452573,69.2,438700,67.1,13873,3.1
24879,August 2016,Tennessee,5222450,3150985,60.3,3001440,57.5,149545,4.7
24880,August 2016,Texas,20947841,13352052,63.7,12723954,60.7,628098,4.7
24881,August 2016,Utah,2202168,1518583,69.0,1467583,66.6,51000,3.4
24882,August 2016,Vermont,514501,345052,67.1,333947,64.9,11105,3.2
24883,August 2016,Virginia,6553654,4250580,64.9,4073933,62.2,176647,4.2
24884,August 2016,Washington,5732726,3647259,63.6,3456687,60.3,190572,5.2
24885,August 2016,West Virginia,1469823,782116,53.2,735047,50.0,47069,6.0
24886,August 2016,Wisconsin,4568660,3135245,68.6,3009586,65.9,125659,4.0
24887,August 2016,Wyoming,450983,299709,66.5,283944,63.0,15765,5.3
24888,September 2016,Alabama,3816210,2178442,57.1,2050468,53.7,127974,5.9
24889,September 2016,Alaska,547146,362921,66.3,337472,61.7,25449,7.0
24890,September 2016,Arizona,5378905,3241377,60.3,3072129,57.1,169248,5.2
24891,September 2016,Arkansas,2313017,1344498,58.1,1292334,55.9,52164,3.9
24892,September 2016,California,30782996,19143818,62.2,18106157,58.8,1037661,5.4
24893,September 2016,Colorado,4333440,2911768,67.2,2818834,65.0,92934,3.2
24894,September 2016,Connecticut,2884584,1912208,66.3,1817393,63.0,94815,5.0
24895,September 2016,Delaware,758744,473660,62.4,452259,59.6,21401,4.5
24896,September 2016,District of Columbia,564533,395092,70.0,371321,65.8,23771,6.0
24897,September 2016,Florida,16716006,9905728,59.3,9433880,56.4,471848,4.8
24898,September 2016,Georgia,7917384,4962915,62.7,4697546,59.3,265369,5.3
24899,September 2016,Hawaii,1095178,686987,62.7,667163,60.9,19824,2.9
24900,September 2016,Idaho,1277002,817033,64.0,786892,61.6,30141,3.7
24901,September 2016,Illinois,10061660,6531412,64.9,6160702,61.2,370710,5.7
24902,September 2016,Indiana,5154055,3326399,64.5,3184386,61.8,142013,4.3
24903,September 2016,Iowa,2443898,1693515,69.3,1632438,66.8,61077,3.6
24904,September 2016,Kansas,2213194,1483980,67.1,1422269,64.3,61711,4.2
24905,September 2016,Kentucky,3461171,2025109,58.5,1921187,55.5,103922,5.1
24906,September 2016,Louisiana,3592927,2116739,58.9,1988609,55.3,128130,6.1
24907,September 2016,Maine,1095178,696616,63.6,670004,61.2,26612,3.8
24908,September 2016,Maryland,4740931,3187949,67.2,3047573,64.3,140376,4.4
24909,September 2016,Massachusetts,5551661,3622622,65.3,3489203,62.8,133419,3.7
24910,September 2016,Michigan,7911052,4858532,61.4,4612640,58.3,245892,5.1
24911,September 2016,Minnesota,4329642,3044319,70.3,2922606,67.5,121713,4.0
24912,September 2016,Mississippi,2284578,1281520,56.1,1208373,52.9,73147,5.7
24913,September 2016,Missouri,4761152,3079067,64.7,2932295,61.6,146772,4.8
24914,September 2016,Montana,823269,521992,63.4,500706,60.8,21286,4.1
24915,September 2016,Nebraska,1456793,1008360,69.2,976915,67.1,31445,3.1
24916,September 2016,Nevada,2308084,1435422,62.2,1356118,58.8,79304,5.5
24917,September 2016,New Hampshire,1092574,747751,68.4,726379,66.5,21372,2.9
24918,September 2016,New Jersey,7130558,4529695,63.5,4306315,60.4,223380,4.9
24919,September 2016,New Mexico,1614227,928910,57.5,866241,53.7,62669,6.7
24920,September 2016,New York,15913947,9664658,60.7,9187937,57.7,476721,4.9
24921,September 2016,North Carolina,7934845,4874491,61.4,4628219,58.3,246272,5.1
24922,September 2016,North Dakota,580968,414711,71.4,402410,69.3,12301,3.0
24923,September 2016,Ohio,9154971,5741938,62.7,5449189,59.5,292749,5.1
24924,September 2016,Oklahoma,2988878,1827273,61.1,1737858,58.1,89415,4.9
24925,September 2016,Oregon,3287293,2060883,62.7,1964242,59.8,96641,4.7
24926,September 2016,Pennsylvania,10239451,6453935,63.0,6100922,59.6,353013,5.5
24927,September 2016,Rhode Island,859260,553705,64.4,525417,61.1,28288,5.1
24928,September 2016,South Carolina,3899254,2295363,58.9,2186339,56.1,109024,4.7
24929,September 2016,South Dakota,654468,452792,69.2,438771,67.0,14021,3.1
24930,September 2016,Tennessee,5228232,3159278,60.4,3008904,57.6,150374,4.8
24931,September 2016,Texas,20979571,13373379,63.7,12740011,60.7,633368,4.7
24932,September 2016,Utah,2206652,1522863,69.0,1472114,66.7,50749,3.3
24933,September 2016,Vermont,514640,345144,67.1,334125,64.9,11019,3.2
24934,September 2016,Virginia,6559833,4258581,64.9,4080774,62.2,177807,4.2
24935,September 2016,Washington,5742739,3653042,63.6,3465126,60.3,187916,5.1
24936,September 2016,West Virginia,1469251,781943,53.2,735393,50.1,46550,6.0
24937,September 2016,Wisconsin,4571289,3136035,68.6,3011833,65.9,124202,4.0
24938,September 2016,Wyoming,450723,298771,66.3,283426,62.9,15345,5.1
24939,October 2016,Alabama,3818184,2180219,57.1,2051841,53.7,128378,5.9
24940,October 2016,Alaska,547082,363025,66.4,337512,61.7,25513,7.0
24941,October 2016,Arizona,5388367,3249602,60.3,3080656,57.2,168946,5.2
24942,October 2016,Arkansas,2314572,1345050,58.1,1293389,55.9,51661,3.8
24943,October 2016,California,30807875,19158646,62.2,18124364,58.8,1034282,5.4
24944,October 2016,Colorado,4339931,2918450,67.2,2827895,65.2,90555,3.1
24945,October 2016,Connecticut,2885509,1914623,66.4,1820713,63.1,93910,4.9
24946,October 2016,Delaware,759631,473827,62.4,452325,59.5,21502,4.5
24947,October 2016,District of Columbia,565134,395706,70.0,371996,65.8,23710,6.0
24948,October 2016,Florida,16743264,9934862,59.3,9462036,56.5,472826,4.8
24949,October 2016,Georgia,7927452,4977222,62.8,4709724,59.4,267498,5.4
24950,October 2016,Hawaii,1095208,687643,62.8,668039,61.0,19604,2.9
24951,October 2016,Idaho,1279788,818322,63.9,788549,61.6,29773,3.6
24952,October 2016,Illinois,10062561,6524246,64.8,6157230,61.2,367016,5.6
24953,October 2016,Indiana,5157506,3323493,64.4,3184006,61.7,139487,4.2
24954,October 2016,Iowa,2445347,1691005,69.2,1630767,66.7,60238,3.6
24955,October 2016,Kansas,2214030,1483479,67.0,1422114,64.2,61365,4.1
24956,October 2016,Kentucky,3463070,2029376,58.6,1924737,55.6,104639,5.2
24957,October 2016,Louisiana,3593626,2113727,58.8,1986684,55.3,127043,6.0
24958,October 2016,Maine,1095955,697507,63.6,671477,61.3,26030,3.7
24959,October 2016,Maryland,4743927,3193500,67.3,3052907,64.4,140593,4.4
24960,October 2016,Massachusetts,5555743,3628128,65.3,3493493,62.9,134635,3.7
24961,October 2016,Michigan,7915498,4864749,61.5,4615229,58.3,249520,5.1
24962,October 2016,Minnesota,4333941,3047551,70.3,2925350,67.5,122201,4.0
24963,October 2016,Mississippi,2285366,1282023,56.1,1209831,52.9,72192,5.6
24964,October 2016,Missouri,4763720,3073912,64.5,2930428,61.5,143484,4.7
24965,October 2016,Montana,824234,522176,63.4,501050,60.8,21126,4.0
24966,October 2016,Nebraska,1457896,1007929,69.1,976450,67.0,31479,3.1
24967,October 2016,Nevada,2312702,1437551,62.2,1359114,58.8,78437,5.5
24968,October 2016,New Hampshire,1093498,747505,68.4,726262,66.4,21243,2.8
24969,October 2016,New Jersey,7134507,4529314,63.5,4308285,60.4,221029,4.9
24970,October 2016,New Mexico,1615039,928434,57.5,866083,53.6,62351,6.7
24971,October 2016,New York,15918800,9664875,60.7,9189318,57.7,475557,4.9
24972,October 2016,North Carolina,7945545,4883241,61.5,4634877,58.3,248364,5.1
24973,October 2016,North Dakota,580906,414646,71.4,402493,69.3,12153,2.9
24974,October 2016,Ohio,9159840,5747142,62.7,5450287,59.5,296855,5.2
24975,October 2016,Oklahoma,2990043,1826806,61.1,1738162,58.1,88644,4.9
24976,October 2016,Oregon,3292121,2063593,62.7,1969657,59.8,93936,4.6
24977,October 2016,Pennsylvania,10243140,6452410,63.0,6100217,59.6,352193,5.5
24978,October 2016,Rhode Island,859688,553476,64.4,525899,61.2,27577,5.0
24979,October 2016,South Carolina,3904636,2296747,58.8,2188971,56.1,107776,4.7
24980,October 2016,South Dakota,655047,452923,69.1,438778,67.0,14145,3.1
24981,October 2016,Tennessee,5234038,3165206,60.5,3014425,57.6,150781,4.8
24982,October 2016,Texas,21011192,13393398,63.7,12754402,60.7,638996,4.8
24983,October 2016,Utah,2211188,1526795,69.0,1476136,66.8,50659,3.3
24984,October 2016,Vermont,514787,345151,67.0,334206,64.9,10945,3.2
24985,October 2016,Virginia,6565302,4265432,65.0,4087371,62.3,178061,4.2
24986,October 2016,Washington,5752444,3658283,63.6,3473019,60.4,185264,5.1
24987,October 2016,West Virginia,1468702,781304,53.2,735583,50.1,45721,5.9
24988,October 2016,Wisconsin,4574053,3136044,68.6,3014059,65.9,121985,3.9
24989,October 2016,Wyoming,450483,298019,66.2,282987,62.8,15032,5.0
24990,November 2016,Alabama,3819872,2180900,57.1,2053351,53.8,127549,5.8
24991,November 2016,Alaska,547156,363136,66.4,337585,61.7,25551,7.0
24992,November 2016,Arizona,5397430,3258043,60.4,3088984,57.2,169059,5.2
24993,November 2016,Arkansas,2315968,1345558,58.1,1294556,55.9,51002,3.8
24994,November 2016,California,30832119,19170812,62.2,18143450,58.8,1027362,5.4
24995,November 2016,Colorado,4346270,2924511,67.3,2836933,65.3,87578,3.0
24996,November 2016,Connecticut,2886233,1917215,66.4,1823735,63.2,93480,4.9
24997,November 2016,Delaware,760451,474221,62.4,452582,59.5,21639,4.6
24998,November 2016,District of Columbia,565703,396506,70.1,372820,65.9,23686,6.0
24999,November 2016,Florida,16769049,9962343,59.4,9490736,56.6,471607,4.7
25000,November 2016,Georgia,7937523,4989945,62.9,4721891,59.5,268054,5.4
25001,November 2016,Hawaii,1095535,688141,62.8,668778,61.0,19363,2.8
25002,November 2016,Idaho,1282467,819463,63.9,790122,61.6,29341,3.6
25003,November 2016,Illinois,10062883,6516121,64.8,6155622,61.2,360499,5.5
25004,November 2016,Indiana,5160506,3320659,64.3,3184522,61.7,136137,4.1
25005,November 2016,Iowa,2446504,1688209,69.0,1628932,66.6,59277,3.5
25006,November 2016,Kansas,2214755,1482646,66.9,1422287,64.2,60359,4.1
25007,November 2016,Kentucky,3464727,2033098,58.7,1928008,55.6,105090,5.2
25008,November 2016,Louisiana,3594074,2111648,58.8,1986113,55.3,125535,5.9
25009,November 2016,Maine,1096538,698055,63.7,672898,61.4,25157,3.6
25010,November 2016,Maryland,4746634,3198761,67.4,3058366,64.4,140395,4.4
25011,November 2016,Massachusetts,5559317,3633941,65.4,3497398,62.9,136543,3.8
25012,November 2016,Michigan,7919187,4869189,61.5,4618160,58.3,251029,5.2
25013,November 2016,Minnesota,4337774,3049841,70.3,2928681,67.5,121160,4.0
25014,November 2016,Mississippi,2286008,1282184,56.1,1210940,53.0,71244,5.6
25015,November 2016,Missouri,4765992,3067552,64.4,2929314,61.5,138238,4.5
25016,November 2016,Montana,825156,522355,63.3,501354,60.8,21001,4.0
25017,November 2016,Nebraska,1458880,1007475,69.1,976123,66.9,31352,3.1
25018,November 2016,Nevada,2317155,1439790,62.1,1362189,58.8,77601,5.4
25019,November 2016,New Hampshire,1094277,747109,68.3,726005,66.3,21104,2.8
25020,November 2016,New Jersey,7137883,4528191,63.4,4310393,60.4,217798,4.8
25021,November 2016,New Mexico,1615766,928042,57.4,866167,53.6,61875,6.7
25022,November 2016,New York,15922411,9663461,60.7,9193175,57.7,470286,4.9
25023,November 2016,North Carolina,7956377,4890879,61.5,4642204,58.3,248675,5.1
25024,November 2016,North Dakota,580847,414609,71.4,402611,69.3,11998,2.9
25025,November 2016,Ohio,9163830,5752379,62.8,5453201,59.5,299178,5.2
25026,November 2016,Oklahoma,2991099,1826142,61.1,1738622,58.1,87520,4.8
25027,November 2016,Oregon,3296580,2066371,62.7,1975225,59.9,91146,4.4
25028,November 2016,Pennsylvania,10245761,6449805,63.0,6100524,59.5,349281,5.4
25029,November 2016,Rhode Island,860039,553237,64.3,526427,61.2,26810,4.8
25030,November 2016,South Carolina,3910161,2298642,58.8,2192102,56.1,106540,4.6
25031,November 2016,South Dakota,655609,453029,69.1,438771,66.9,14258,3.1
25032,November 2016,Tennessee,5239470,3169167,60.5,3019023,57.6,150144,4.7
25033,November 2016,Texas,21042077,13413543,63.7,12770111,60.7,643432,4.8
25034,November 2016,Utah,2215583,1530534,69.1,1479896,66.8,50638,3.3
25035,November 2016,Vermont,514893,345103,67.0,334211,64.9,10892,3.2
25036,November 2016,Virginia,6570799,4271482,65.0,4094330,62.3,177152,4.1
25037,November 2016,Washington,5761959,3663402,63.6,3480757,60.4,182645,5.0
25038,November 2016,West Virginia,1468010,780366,53.2,735818,50.1,44548,5.7
25039,November 2016,Wisconsin,4576409,3135726,68.5,3017002,65.9,118724,3.8
25040,November 2016,Wyoming,450193,297392,66.1,282630,62.8,14762,5.0
25041,December 2016,Alabama,3821401,2180371,57.1,2055357,53.8,125014,5.7
25042,December 2016,Alaska,547183,363186,66.4,337620,61.7,25566,7.0
25043,December 2016,Arizona,5406232,3266355,60.4,3097120,57.3,169235,5.2
25044,December 2016,Arkansas,2317194,1346290,58.1,1296017,55.9,50273,3.7
25045,December 2016,California,30854698,19183170,62.2,18166768,58.9,1016402,5.3
25046,December 2016,Colorado,4352412,2930522,67.3,2846292,65.4,84230,2.9
25047,December 2016,Connecticut,2886817,1920153,66.5,1826607,63.3,93546,4.9
25048,December 2016,Delaware,761212,474810,62.4,453017,59.5,21793,4.6
25049,December 2016,District of Columbia,566208,397427,70.2,373682,66.0,23745,6.0
25050,December 2016,Florida,16794016,9989172,59.5,9521592,56.7,467580,4.7
25051,December 2016,Georgia,7947221,5001459,62.9,4734792,59.6,266667,5.3
25052,December 2016,Hawaii,1095819,688523,62.8,669440,61.1,19083,2.8
25053,December 2016,Idaho,1285123,820615,63.9,791731,61.6,28884,3.5
25054,December 2016,Illinois,10062735,6507556,64.7,6156538,61.2,351018,5.4
25055,December 2016,Indiana,5163324,3318440,64.3,3186638,61.7,131802,4.0
25056,December 2016,Iowa,2447600,1685543,68.9,1627250,66.5,58293,3.5
25057,December 2016,Kansas,2215366,1481576,66.9,1422650,64.2,58926,4.0
25058,December 2016,Kentucky,3466278,2036692,58.8,1931436,55.7,105256,5.2
25059,December 2016,Louisiana,3594372,2110645,58.7,1986887,55.3,123758,5.9
25060,December 2016,Maine,1097133,698375,63.7,674163,61.4,24212,3.5
25061,December 2016,Maryland,4749118,3203653,67.5,3063912,64.5,139741,4.4
25062,December 2016,Massachusetts,5562675,3640083,65.4,3501473,62.9,138610,3.8
25063,December 2016,Michigan,7922557,4871565,61.5,4622742,58.3,248823,5.1
25064,December 2016,Minnesota,4341459,3051601,70.3,2932663,67.6,118938,3.9
25065,December 2016,Mississippi,2286536,1282283,56.1,1211897,53.0,70386,5.5
25066,December 2016,Missouri,4768094,3061540,64.2,2929326,61.4,132214,4.3
25067,December 2016,Montana,826021,522559,63.3,501645,60.7,20914,4.0
25068,December 2016,Nebraska,1459792,1007108,69.0,976026,66.9,31082,3.1
25069,December 2016,Nevada,2321560,1442279,62.1,1365452,58.8,76827,5.3
25070,December 2016,New Hampshire,1095044,746661,68.2,725711,66.3,20950,2.8
25071,December 2016,New Jersey,7140892,4526537,63.4,4312683,60.4,213854,4.7
25072,December 2016,New Mexico,1616417,927861,57.4,866587,53.6,61274,6.6
25073,December 2016,New York,15925279,9663730,60.7,9200891,57.8,462839,4.8
25074,December 2016,North Carolina,7966852,4897899,61.5,4651247,58.4,246652,5.0
25075,December 2016,North Dakota,580743,414644,71.4,402844,69.4,11800,2.8
25076,December 2016,Ohio,9167408,5757254,62.8,5458260,59.5,298994,5.2
25077,December 2016,Oklahoma,2992021,1825560,61.0,1739405,58.1,86155,4.7
25078,December 2016,Oregon,3300876,2069893,62.7,1981262,60.0,88631,4.3
25079,December 2016,Pennsylvania,10247928,6447352,62.9,6103106,59.6,344246,5.3
25080,December 2016,Rhode Island,860362,553037,64.3,526983,61.3,26054,4.7
25081,December 2016,South Carolina,3915543,2300911,58.8,2195709,56.1,105202,4.6
25082,December 2016,South Dakota,656126,453187,69.1,438820,66.9,14367,3.2
25083,December 2016,Tennessee,5244692,3171911,60.5,3023899,57.7,148012,4.7
25084,December 2016,Texas,21071861,13435106,63.8,12789514,60.7,645592,4.8
25085,December 2016,Utah,2219880,1534329,69.1,1483686,66.8,50643,3.3
25086,December 2016,Vermont,514964,345024,67.0,334167,64.9,10857,3.1
25087,December 2016,Virginia,6576070,4277406,65.0,4102103,62.4,175303,4.1
25088,December 2016,Washington,5771220,3669026,63.6,3488813,60.5,180213,4.9
25089,December 2016,West Virginia,1467250,779266,53.1,736192,50.2,43074,5.5
25090,December 2016,Wisconsin,4578578,3135830,68.5,3021170,66.0,114660,3.7
25091,December 2016,Wyoming,449878,296774,66.0,282351,62.8,14423,4.9
25092,January 2017,Alabama,3823014,2178674,57.0,2057886,53.8,120788,5.5
25093,January 2017,Alaska,547119,363173,66.4,337605,61.7,25568,7.0
25094,January 2017,Arizona,5415087,3273927,60.5,3104746,57.3,169181,5.2
25095,January 2017,Arkansas,2318494,1347430,58.1,1297815,56.0,49615,3.7
25096,January 2017,California,30877780,19197424,62.2,18194877,58.9,1002547,5.2
25097,January 2017,Colorado,4358433,2936962,67.4,2855949,65.5,81013,2.8
25098,January 2017,Connecticut,2887512,1923018,66.6,1829143,63.3,93875,4.9
25099,January 2017,Delaware,762018,475504,62.4,453567,59.5,21937,4.6
25100,January 2017,District of Columbia,566770,398432,70.3,374517,66.1,23915,6.0
25101,January 2017,Florida,16819184,10015169,59.5,9553986,56.8,461183,4.6
25102,January 2017,Georgia,7956974,5012051,63.0,4748387,59.7,263664,5.3
25103,January 2017,Hawaii,1095849,688770,62.9,670027,61.1,18743,2.7
25104,January 2017,Idaho,1287768,821968,63.8,793544,61.6,28424,3.5
25105,January 2017,Illinois,10062859,6499374,64.6,6159116,61.2,340258,5.2
25106,January 2017,Indiana,5166251,3317246,64.2,3190264,61.8,126982,3.8
25107,January 2017,Iowa,2448722,1683420,68.7,1626056,66.4,57364,3.4
25108,January 2017,Kansas,2215932,1480401,66.8,1423025,64.2,57376,3.9
25109,January 2017,Kentucky,3467836,2040337,58.8,1935073,55.8,105264,5.2
25110,January 2017,Louisiana,3594696,2110480,58.7,1988614,55.3,121866,5.8
25111,January 2017,Maine,1097683,698617,63.6,675170,61.5,23447,3.4
25112,January 2017,Maryland,4751593,3208134,67.5,3069326,64.6,138808,4.3
25113,January 2017,Massachusetts,5566189,3646271,65.5,3505786,63.0,140485,3.9
25114,January 2017,Michigan,7926158,4871909,61.5,4629277,58.4,242632,5.0
25115,January 2017,Minnesota,4345264,3053201,70.3,2937135,67.6,116066,3.8
25116,January 2017,Mississippi,2287048,1282448,56.1,1212790,53.0,69658,5.4
25117,January 2017,Missouri,4770267,3056831,64.1,2930182,61.4,126649,4.1
25118,January 2017,Montana,826921,522837,63.2,501976,60.7,20861,4.0
25119,January 2017,Nebraska,1460680,1006904,68.9,976181,66.8,30723,3.1
25120,January 2017,Nevada,2325878,1445143,62.1,1368979,58.9,76164,5.3
25121,January 2017,New Hampshire,1095814,746324,68.1,725544,66.2,20780,2.8
25122,January 2017,New Jersey,7144128,4524882,63.3,4315001,60.4,209881,4.6
25123,January 2017,New Mexico,1617044,927876,57.4,867298,53.6,60578,6.5
25124,January 2017,New York,15928484,9667870,60.7,9211660,57.8,456210,4.7
25125,January 2017,North Carolina,7976867,4904409,61.5,4661890,58.4,242519,4.9
25126,January 2017,North Dakota,580598,414764,71.4,403232,69.5,11532,2.8
25127,January 2017,Ohio,9171164,5761919,62.8,5464821,59.6,297098,5.2
25128,January 2017,Oklahoma,2992924,1825368,61.0,1740657,58.2,84711,4.6
25129,January 2017,Oregon,3305281,2074335,62.8,1987682,60.1,86653,4.2
25130,January 2017,Pennsylvania,10250361,6445319,62.9,6107264,59.6,338055,5.2
25131,January 2017,Rhode Island,860659,552931,64.2,527548,61.3,25383,4.6
25132,January 2017,South Carolina,3920901,2303205,58.7,2199535,56.1,103670,4.5
25133,January 2017,South Dakota,656613,453449,69.1,438978,66.9,14471,3.2
25134,January 2017,Tennessee,5249876,3173953,60.5,3029624,57.7,144329,4.5
25135,January 2017,Texas,21102072,13456962,63.8,12812482,60.7,644480,4.8
25136,January 2017,Utah,2224163,1538459,69.2,1487762,66.9,50697,3.3
25137,January 2017,Vermont,515067,344930,67.0,334104,64.9,10826,3.1
25138,January 2017,Virginia,6580778,4283392,65.1,4110477,62.5,172915,4.0
25139,January 2017,Washington,5780280,3675547,63.6,3497247,60.5,178300,4.9
25140,January 2017,West Virginia,1466485,778089,53.1,736619,50.2,41470,5.3
25141,January 2017,Wisconsin,4580789,3136931,68.5,3026463,66.1,110468,3.5
25142,January 2017,Wyoming,449571,296087,65.9,282136,62.8,13951,4.7
25143,February 2017,Alabama,3823893,2176238,56.9,2060841,53.9,115397,5.3
25144,February 2017,Alaska,546915,363116,66.4,337536,61.7,25580,7.0
25145,February 2017,Arizona,5422931,3280620,60.5,3112215,57.4,168405,5.1
25146,February 2017,Arkansas,2319330,1348930,58.2,1299810,56.0,49120,3.6
25147,February 2017,California,30895102,19213870,62.2,18227872,59.0,985998,5.1
25148,February 2017,Colorado,4363786,2944356,67.5,2865932,65.7,78424,2.7
25149,February 2017,Connecticut,2887616,1925146,66.7,1831128,63.4,94018,4.9
25150,February 2017,Delaware,762658,476175,62.4,454127,59.5,22048,4.6
25151,February 2017,District of Columbia,567224,399429,70.4,375246,66.2,24183,6.1
25152,February 2017,Florida,16840900,10039859,59.6,9587135,56.9,452724,4.5
25153,February 2017,Georgia,7964991,5021719,63.0,4762647,59.8,259072,5.2
25154,February 2017,Hawaii,1095571,688822,62.9,670493,61.2,18329,2.7
25155,February 2017,Idaho,1290209,823579,63.8,795617,61.7,27962,3.4
25156,February 2017,Illinois,10061071,6491944,64.5,6162233,61.2,329711,5.1
25157,February 2017,Indiana,5168394,3316903,64.2,3194857,61.8,122046,3.7
25158,February 2017,Iowa,2449469,1682054,68.7,1625619,66.4,56435,3.4
25159,February 2017,Kansas,2216102,1479268,66.8,1423411,64.2,55857,3.8
25160,February 2017,Kentucky,3468764,2044158,58.9,1938884,55.9,105274,5.1
25161,February 2017,Louisiana,3594339,2110486,58.7,1990792,55.4,119694,5.7
25162,February 2017,Maine,1098076,698922,63.6,675877,61.6,23045,3.3
25163,February 2017,Maryland,4753236,3212117,67.6,3074488,64.7,137629,4.3
25164,February 2017,Massachusetts,5568803,3651878,65.6,3510163,63.0,141715,3.9
25165,February 2017,Michigan,7928435,4870505,61.4,4637259,58.5,233246,4.8
25166,February 2017,Minnesota,4348451,3054729,70.2,2941922,67.7,112807,3.7
25167,February 2017,Mississippi,2287151,1282615,56.1,1213621,53.1,68994,5.4
25168,February 2017,Missouri,4771507,3053600,64.0,2931794,61.4,121806,4.0
25169,February 2017,Montana,827664,523228,63.2,502396,60.7,20832,4.0
25170,February 2017,Nebraska,1461348,1006849,68.9,976540,66.8,30309,3.0
25171,February 2017,Nevada,2329892,1448354,62.2,1372727,58.9,75627,5.2
25172,February 2017,New Hampshire,1096404,746182,68.1,725584,66.2,20598,2.8
25173,February 2017,New Jersey,7146184,4523440,63.3,4317138,60.4,206302,4.6
25174,February 2017,New Mexico,1617402,928003,57.4,868228,53.7,59775,6.4
25175,February 2017,New York,15929035,9676575,60.7,9224820,57.9,451755,4.7
25176,February 2017,North Carolina,7985169,4910423,61.5,4673823,58.5,236600,4.8
25177,February 2017,North Dakota,580378,414935,71.5,403739,69.6,11196,2.7
25178,February 2017,Ohio,9173448,5766616,62.9,5472202,59.7,294414,5.1
25179,February 2017,Oklahoma,2993299,1825759,61.0,1742574,58.2,83185,4.6
25180,February 2017,Oregon,3309158,2079640,62.8,1994359,60.3,85281,4.1
25181,February 2017,Pennsylvania,10251110,6443096,62.9,6112047,59.6,331049,5.1
25182,February 2017,Rhode Island,860857,552941,64.2,528073,61.3,24868,4.5
25183,February 2017,South Carolina,3925215,2305118,58.7,2203344,56.1,101774,4.4
25184,February 2017,South Dakota,657036,453772,69.1,439207,66.8,14565,3.2
25185,February 2017,Tennessee,5254237,3175765,60.4,3036677,57.8,139088,4.4
25186,February 2017,Texas,21128479,13476511,63.8,12838778,60.8,637733,4.7
25187,February 2017,Utah,2228243,1542962,69.2,1492177,67.0,50785,3.3
25188,February 2017,Vermont,515087,344817,66.9,334037,64.9,10780,3.1
25189,February 2017,Virginia,6584477,4289357,65.1,4119253,62.6,170104,4.0
25190,February 2017,Washington,5788437,3683212,63.6,3506309,60.6,176903,4.8
25191,February 2017,West Virginia,1465532,777036,53.0,737024,50.3,40012,5.1
25192,February 2017,Wisconsin,4582324,3139314,68.5,3032555,66.2,106759,3.4
25193,February 2017,Wyoming,449216,295322,65.7,281962,62.8,13360,4.5
25194,March 2017,Alabama,3825030,2173415,56.8,2063770,54.0,109645,5.0
25195,March 2017,Alaska,546784,363033,66.4,337404,61.7,25629,7.1
25196,March 2017,Arizona,5431000,3286430,60.5,3119620,57.4,166810,5.1
25197,March 2017,Arkansas,2320422,1350593,58.2,1301684,56.1,48909,3.6
25198,March 2017,California,30913200,19231489,62.2,18262184,59.1,969305,5.0
25199,March 2017,Colorado,4369507,2953005,67.6,2875953,65.8,77052,2.6
25200,March 2017,Connecticut,2887941,1925846,66.7,1832161,63.4,93685,4.9
25201,March 2017,Delaware,763321,476716,62.5,454591,59.6,22125,4.6
25202,March 2017,District of Columbia,567699,400292,70.5,375795,66.2,24497,6.1
25203,March 2017,Florida,16863268,10061216,59.7,9617681,57.0,443535,4.4
25204,March 2017,Georgia,7973739,5030359,63.1,4776791,59.9,253568,5.0
25205,March 2017,Hawaii,1095383,688539,62.9,670688,61.2,17851,2.6
25206,March 2017,Idaho,1292726,825352,63.8,797841,61.7,27511,3.3
25207,March 2017,Illinois,10059965,6485561,64.5,6163712,61.3,321849,5.0
25208,March 2017,Indiana,5170883,3317073,64.1,3199009,61.9,118064,3.6
25209,March 2017,Iowa,2450423,1681267,68.6,1625752,66.3,55515,3.3
25210,March 2017,Kansas,2216447,1478421,66.7,1423789,64.2,54632,3.7
25211,March 2017,Kentucky,3470040,2047954,59.0,1942462,56.0,105492,5.2
25212,March 2017,Louisiana,3594238,2110205,58.7,1992855,55.4,117350,5.6
25213,March 2017,Maine,1098533,699359,63.7,676282,61.6,23077,3.3
25214,March 2017,Maryland,4755132,3215406,67.6,3079066,64.8,136340,4.2
25215,March 2017,Massachusetts,5571734,3656082,65.6,3513943,63.1,142139,3.9
25216,March 2017,Michigan,7931179,4868060,61.4,4644775,58.6,223285,4.6
25217,March 2017,Minnesota,4351868,3056265,70.2,2946452,67.7,109813,3.6
25218,March 2017,Mississippi,2287409,1282578,56.1,1214156,53.1,68422,5.3
25219,March 2017,Missouri,4773211,3051773,63.9,2933616,61.5,118157,3.9
25220,March 2017,Montana,828432,523729,63.2,502907,60.7,20822,4.0
25221,March 2017,Nebraska,1462191,1006881,68.9,976977,66.8,29904,3.0
25222,March 2017,Nevada,2333945,1451700,62.2,1376508,59.0,75192,5.2
25223,March 2017,New Hampshire,1097096,746204,68.0,725796,66.2,20408,2.7
25224,March 2017,New Jersey,7148437,4522064,63.3,4318174,60.4,203890,4.5
25225,March 2017,New Mexico,1617756,928073,57.4,869180,53.7,58893,6.3
25226,March 2017,New York,15930230,9687989,60.8,9237380,58.0,450609,4.7
25227,March 2017,North Carolina,7994236,4915997,61.5,4685724,58.6,230273,4.7
25228,March 2017,North Dakota,580201,415069,71.5,404233,69.7,10836,2.6
25229,March 2017,Ohio,9176398,5771386,62.9,5478856,59.7,292530,5.1
25230,March 2017,Oklahoma,2993896,1826610,61.0,1744968,58.3,81642,4.5
25231,March 2017,Oregon,3313243,2085582,62.9,2000905,60.4,84677,4.1
25232,March 2017,Pennsylvania,10252466,6439586,62.8,6115395,59.6,324191,5.0
25233,March 2017,Rhode Island,861072,553052,64.2,528522,61.4,24530,4.4
25234,March 2017,South Carolina,3930047,2306520,58.7,2206646,56.1,99874,4.3
25235,March 2017,South Dakota,657489,454084,69.1,439419,66.8,14665,3.2
25236,March 2017,Tennessee,5258943,3177852,60.4,3044968,57.9,132884,4.2
25237,March 2017,Texas,21155611,13490959,63.8,12865522,60.8,625437,4.6
25238,March 2017,Utah,2232455,1547553,69.3,1496623,67.0,50930,3.3
25239,March 2017,Vermont,515128,344685,66.9,333970,64.8,10715,3.1
25240,March 2017,Virginia,6588582,4294747,65.2,4127449,62.6,167298,3.9
25241,March 2017,Washington,5796957,3691803,63.7,3515646,60.6,176157,4.8
25242,March 2017,West Virginia,1464666,776230,53.0,737241,50.3,38989,5.0
25243,March 2017,Wisconsin,4584182,3142668,68.6,3038394,66.3,104274,3.3
25244,March 2017,Wyoming,448865,294530,65.6,281799,62.8,12731,4.3
25245,April 2017,Alabama,3826309,2170809,56.7,2066782,54.0,104027,4.8
25246,April 2017,Alaska,546835,362984,66.4,337254,61.7,25730,7.1
25247,April 2017,Arizona,5439360,3292255,60.5,3127775,57.5,164480,5.0
25248,April 2017,Arkansas,2321514,1352265,58.2,1303273,56.1,48992,3.6
25249,April 2017,California,30934047,19252075,62.2,18298037,59.2,954038,5.0
25250,April 2017,Colorado,4375484,2963090,67.7,2885928,66.0,77162,2.6
25251,April 2017,Connecticut,2888333,1924999,66.6,1832273,63.4,92726,4.8
25252,April 2017,Delaware,764027,477106,62.4,454941,59.5,22165,4.6
25253,April 2017,District of Columbia,568226,400935,70.6,376151,66.2,24784,6.2
25254,April 2017,Florida,16886571,10078857,59.7,9644498,57.1,434359,4.3
25255,April 2017,Georgia,7983198,5039010,63.1,4791193,60.0,247817,4.9
25256,April 2017,Hawaii,1095625,687832,62.8,670514,61.2,17318,2.5
25257,April 2017,Idaho,1295292,827201,63.9,800136,61.8,27065,3.3
25258,April 2017,Illinois,10059290,6481451,64.4,6163524,61.3,317927,4.9
25259,April 2017,Indiana,5173397,3318098,64.1,3202201,61.9,115897,3.5
25260,April 2017,Iowa,2451353,1680914,68.6,1626231,66.3,54683,3.3
25261,April 2017,Kansas,2216971,1478150,66.7,1424267,64.2,53883,3.6
25262,April 2017,Kentucky,3471442,2051757,59.1,1946003,56.1,105754,5.2
25263,April 2017,Louisiana,3594323,2109702,58.7,1994841,55.5,114861,5.4
25264,April 2017,Maine,1099035,699959,63.7,676518,61.6,23441,3.3
25265,April 2017,Maryland,4757294,3218257,67.6,3083267,64.8,134990,4.2
25266,April 2017,Massachusetts,5574788,3658885,65.6,3517167,63.1,141718,3.9
25267,April 2017,Michigan,7933952,4866804,61.3,4651155,58.6,215649,4.4
25268,April 2017,Minnesota,4355258,3058271,70.2,2950655,67.7,107616,3.5
25269,April 2017,Mississippi,2287791,1282320,56.1,1214402,53.1,67918,5.3
25270,April 2017,Missouri,4775027,3051259,63.9,2935577,61.5,115682,3.8
25271,April 2017,Montana,829255,524311,63.2,503467,60.7,20844,4.0
25272,April 2017,Nebraska,1463036,1006949,68.8,977386,66.8,29563,2.9
25273,April 2017,Nevada,2338122,1455078,62.2,1380279,59.0,74799,5.1
25274,April 2017,New Hampshire,1097755,746313,68.0,726075,66.1,20238,2.7
25275,April 2017,New Jersey,7150924,4521156,63.2,4318031,60.4,203125,4.5
25276,April 2017,New Mexico,1618267,928084,57.4,870059,53.8,58025,6.3
25277,April 2017,New York,15931938,9701159,60.9,9248623,58.1,452536,4.7
25278,April 2017,North Carolina,8004370,4922244,61.5,4697516,58.7,224728,4.6
25279,April 2017,North Dakota,580109,415116,71.6,404591,69.7,10525,2.5
25280,April 2017,Ohio,9179387,5776848,62.9,5484806,59.8,292042,5.1
25281,April 2017,Oklahoma,2994708,1827979,61.0,1747786,58.4,80193,4.4
25282,April 2017,Oregon,3317335,2091885,63.1,2007058,60.5,84827,4.1
25283,April 2017,Pennsylvania,10253844,6434898,62.8,6116745,59.7,318153,4.9
25284,April 2017,Rhode Island,861323,553253,64.2,528916,61.4,24337,4.4
25285,April 2017,South Carolina,3935326,2307576,58.6,2209304,56.1,98272,4.3
25286,April 2017,South Dakota,657974,454370,69.1,439583,66.8,14787,3.3
25287,April 2017,Tennessee,5263843,3181251,60.4,3054966,58.0,126285,4.0
25288,April 2017,Texas,21184555,13501719,63.7,12892632,60.9,609087,4.5
25289,April 2017,Utah,2236701,1552001,69.4,1500897,67.1,51104,3.3
25290,April 2017,Vermont,515177,344587,66.9,333951,64.8,10636,3.1
25291,April 2017,Virginia,6593707,4299995,65.2,4135236,62.7,164759,3.8
25292,April 2017,Washington,5806004,3701218,63.7,3525093,60.7,176125,4.8
25293,April 2017,West Virginia,1463802,775852,53.0,737352,50.4,38500,5.0
25294,April 2017,Wisconsin,4586055,3146688,68.6,3043378,66.4,103310,3.3
25295,April 2017,Wyoming,448532,293812,65.5,281632,62.8,12180,4.1
25296,May 2017,Alabama,3827696,2168875,56.7,2070162,54.1,98713,4.6
25297,May 2017,Alaska,546809,362979,66.4,337104,61.6,25875,7.1
25298,May 2017,Arizona,5447926,3298810,60.6,3137217,57.6,161593,4.9
25299,May 2017,Arkansas,2322767,1353883,58.3,1304613,56.2,49270,3.6
25300,May 2017,California,30954709,19275710,62.3,18336124,59.2,939586,4.9
25301,May 2017,Colorado,4381588,2974362,67.9,2895708,66.1,78654,2.6
25302,May 2017,Connecticut,2888886,1922862,66.6,1831621,63.4,91241,4.7
25303,May 2017,Delaware,764793,477378,62.4,455227,59.5,22151,4.6
25304,May 2017,District of Columbia,568735,401304,70.6,376327,66.2,24977,6.2
25305,May 2017,Florida,16910431,10092636,59.7,9667350,57.2,425286,4.2
25306,May 2017,Georgia,7992706,5048145,63.2,4806202,60.1,241943,4.8
25307,May 2017,Hawaii,1095597,686763,62.7,670018,61.2,16745,2.4
25308,May 2017,Idaho,1297942,829143,63.9,802522,61.8,26621,3.2
25309,May 2017,Illinois,10059054,6480259,64.4,6162849,61.3,317410,4.9
25310,May 2017,Indiana,5176276,3320149,64.1,3204470,61.9,115679,3.5
25311,May 2017,Iowa,2452514,1680648,68.5,1626764,66.3,53884,3.2
25312,May 2017,Kansas,2217566,1478423,66.7,1424904,64.3,53519,3.6
25313,May 2017,Kentucky,3473007,2055366,59.2,1949689,56.1,105677,5.1
25314,May 2017,Louisiana,3594525,2108990,58.7,1996966,55.6,112024,5.3
25315,May 2017,Maine,1099651,700650,63.7,676724,61.5,23926,3.4
25316,May 2017,Maryland,4759471,3220840,67.7,3087296,64.9,133544,4.1
25317,May 2017,Massachusetts,5578204,3660570,65.6,3520112,63.1,140458,3.8
25318,May 2017,Michigan,7937284,4868271,61.3,4656279,58.7,211992,4.4
25319,May 2017,Minnesota,4359069,3060752,70.2,2954733,67.8,106019,3.5
25320,May 2017,Mississippi,2288258,1281747,56.0,1214444,53.1,67303,5.3
25321,May 2017,Missouri,4777192,3051380,63.9,2937638,61.5,113742,3.7
25322,May 2017,Montana,830148,524941,63.2,504036,60.7,20905,4.0
25323,May 2017,Nebraska,1463963,1006961,68.8,977653,66.8,29308,2.9
25324,May 2017,Nevada,2342365,1458436,62.3,1384079,59.1,74357,5.1
25325,May 2017,New Hampshire,1098542,746481,68.0,726362,66.1,20119,2.7
25326,May 2017,New Jersey,7153747,4520848,63.2,4316982,60.3,203866,4.5
25327,May 2017,New Mexico,1618768,928131,57.3,870862,53.8,57269,6.2
25328,May 2017,New York,15934317,9714518,61.0,9258713,58.1,455805,4.7
25329,May 2017,North Carolina,8014435,4929648,61.5,4709310,58.8,220338,4.5
25330,May 2017,North Dakota,580000,415074,71.6,404741,69.8,10333,2.5
25331,May 2017,Ohio,9183026,5782912,63.0,5490456,59.8,292456,5.1
25332,May 2017,Oklahoma,2995635,1829992,61.1,1751059,58.5,78933,4.3
25333,May 2017,Oregon,3321738,2098213,63.2,2012722,60.6,85491,4.1
25334,May 2017,Pennsylvania,10256057,6429284,62.7,6116394,59.6,312890,4.9
25335,May 2017,Rhode Island,861639,553542,64.2,529296,61.4,24246,4.4
25336,May 2017,South Carolina,3940640,2308727,58.6,2211586,56.1,97141,4.2
25337,May 2017,South Dakota,658501,454659,69.0,439720,66.8,14939,3.3
25338,May 2017,Tennessee,5269033,3186566,60.5,3066692,58.2,119874,3.8
25339,May 2017,Texas,21213441,13511179,63.7,12920950,60.9,590229,4.4
25340,May 2017,Utah,2241086,1556059,69.4,1504854,67.1,51205,3.3
25341,May 2017,Vermont,515293,344562,66.9,334014,64.8,10548,3.1
25342,May 2017,Virginia,6598412,4305429,65.2,4142960,62.8,162469,3.8
25343,May 2017,Washington,5815106,3711259,63.8,3534736,60.8,176523,4.8
25344,May 2017,West Virginia,1463106,775974,53.0,737505,50.4,38469,5.0
25345,May 2017,Wisconsin,4588304,3151015,68.7,3047441,66.4,103574,3.3
25346,May 2017,Wyoming,448244,293264,65.4,281445,62.8,11819,4.0
25347,June 2017,Alabama,3829215,2167792,56.6,2073795,54.2,93997,4.3
25348,June 2017,Alaska,546712,362973,66.4,336937,61.6,26036,7.2
25349,June 2017,Arizona,5456526,3306223,60.6,3147523,57.7,158700,4.8
25350,June 2017,Arkansas,2324011,1355468,58.3,1305806,56.2,49662,3.7
25351,June 2017,California,30975332,19301417,62.3,18375569,59.3,925848,4.8
25352,June 2017,Colorado,4387646,2986332,68.1,2905055,66.2,81277,2.7
25353,June 2017,Connecticut,2889467,1919943,66.4,1830329,63.3,89614,4.7
25354,June 2017,Delaware,765552,477590,62.4,455508,59.5,22082,4.6
25355,June 2017,District of Columbia,569224,401414,70.5,376393,66.1,25021,6.2
25356,June 2017,Florida,16934622,10103119,59.7,9686052,57.2,417067,4.1
25357,June 2017,Georgia,8002031,5057845,63.2,4821290,60.3,236555,4.7
25358,June 2017,Hawaii,1095494,685501,62.6,669333,61.1,16168,2.4
25359,June 2017,Idaho,1300629,831313,63.9,805101,61.9,26212,3.2
25360,June 2017,Illinois,10058928,6482244,64.4,6162869,61.3,319375,4.9
25361,June 2017,Indiana,5179315,3323074,64.2,3206041,61.9,117033,3.5
25362,June 2017,Iowa,2453727,1680150,68.5,1627079,66.3,53071,3.2
25363,June 2017,Kansas,2218160,1478974,66.7,1425614,64.3,53360,3.6
25364,June 2017,Kentucky,3474619,2058267,59.2,1953242,56.2,105025,5.1
25365,June 2017,Louisiana,3594724,2108571,58.7,1999584,55.6,108987,5.2
25366,June 2017,Maine,1100238,701278,63.7,676956,61.5,24322,3.5
25367,June 2017,Maryland,4761717,3223156,67.7,3090945,64.9,132211,4.1
25368,June 2017,Massachusetts,5581720,3661300,65.6,3522725,63.1,138575,3.8
25369,June 2017,Michigan,7940832,4872750,61.4,4660020,58.7,212730,4.4
25370,June 2017,Minnesota,4362967,3063469,70.2,2958660,67.8,104809,3.4
25371,June 2017,Mississippi,2288676,1280865,56.0,1214378,53.1,66487,5.2
25372,June 2017,Missouri,4779424,3051514,63.8,2939403,61.5,112111,3.7
25373,June 2017,Montana,831039,525565,63.2,504533,60.7,21032,4.0
25374,June 2017,Nebraska,1464953,1006927,68.7,977762,66.7,29165,2.9
25375,June 2017,Nevada,2346637,1461705,62.3,1387888,59.1,73817,5.1
25376,June 2017,New Hampshire,1099349,746758,67.9,726706,66.1,20052,2.7
25377,June 2017,New Jersey,7156668,4521158,63.2,4315167,60.3,205991,4.6
25378,June 2017,New Mexico,1619276,928342,57.3,871658,53.8,56684,6.1
25379,June 2017,New York,15936970,9725796,61.0,9266727,58.1,459069,4.7
25380,June 2017,North Carolina,8024129,4937960,61.5,4720362,58.8,217598,4.4
25381,June 2017,North Dakota,579884,414953,71.6,404652,69.8,10301,2.5
25382,June 2017,Ohio,9186878,5788647,63.0,5495452,59.8,293195,5.1
25383,June 2017,Oklahoma,2996546,1832536,61.2,1754616,58.6,77920,4.3
25384,June 2017,Oregon,3326139,2104103,63.3,2017714,60.7,86389,4.1
25385,June 2017,Pennsylvania,10258498,6423804,62.6,6114818,59.6,308986,4.8
25386,June 2017,Rhode Island,861974,553964,64.3,529710,61.5,24254,4.4
25387,June 2017,South Carolina,3945797,2310505,58.6,2213831,56.1,96674,4.2
25388,June 2017,South Dakota,659038,454984,69.0,439862,66.7,15122,3.3
25389,June 2017,Tennessee,5274245,3193624,60.6,3079109,58.4,114515,3.6
25390,June 2017,Texas,21242514,13521702,63.7,12949702,61.0,572000,4.2
25391,June 2017,Utah,2245543,1559718,69.5,1508525,67.2,51193,3.3
25392,June 2017,Vermont,515406,344631,66.9,334172,64.8,10459,3.0
25393,June 2017,Virginia,6603095,4310752,65.3,4150174,62.9,160578,3.7
25394,June 2017,Washington,5824183,3721663,63.9,3544610,60.9,177053,4.8
25395,June 2017,West Virginia,1462421,776543,53.1,737716,50.4,38827,5.0
25396,June 2017,Wisconsin,4590703,3155117,68.7,3050570,66.5,104547,3.3
25397,June 2017,Wyoming,447936,292932,65.4,281224,62.8,11708,4.0
25398,July 2017,Alabama,3830854,2167264,56.6,2077406,54.2,89858,4.1
25399,July 2017,Alaska,546610,362938,66.4,336758,61.6,26180,7.2
25400,July 2017,Arizona,5465447,3315606,60.7,3158946,57.8,156660,4.7
25401,July 2017,Arkansas,2325466,1356874,58.3,1306789,56.2,50085,3.7
25402,July 2017,California,30996834,19331124,62.4,18419983,59.4,911141,4.7
25403,July 2017,Colorado,4393957,2999765,68.3,2914991,66.3,84774,2.8
25404,July 2017,Connecticut,2890225,1916978,66.3,1828819,63.3,88159,4.6
25405,July 2017,Delaware,766340,477798,62.3,455825,59.5,21973,4.6
25406,July 2017,District of Columbia,569795,401403,70.4,376548,66.1,24855,6.2
25407,July 2017,Florida,16959581,10113656,59.6,9703693,57.2,409963,4.1
25408,July 2017,Georgia,8011075,5069004,63.3,4836657,60.4,232347,4.6
25409,July 2017,Hawaii,1095354,684301,62.5,668688,61.0,15613,2.3
25410,July 2017,Idaho,1303370,834069,64.0,808229,62.0,25840,3.1
25411,July 2017,Illinois,10058951,6487687,64.5,6165596,61.3,322091,5.0
25412,July 2017,Indiana,5182675,3325829,64.2,3207240,61.9,118589,3.6
25413,July 2017,Iowa,2455098,1679261,68.4,1627122,66.3,52139,3.1
25414,July 2017,Kansas,2218860,1479529,66.7,1426310,64.3,53219,3.6
25415,July 2017,Kentucky,3476399,2059784,59.3,1956575,56.3,103209,5.0
25416,July 2017,Louisiana,3595191,2109398,58.7,2003525,55.7,105873,5.0
25417,July 2017,Maine,1100916,701632,63.7,677317,61.5,24315,3.5
25418,July 2017,Maryland,4764295,3224892,67.7,3093664,64.9,131228,4.1
25419,July 2017,Massachusetts,5585614,3661353,65.5,3525238,63.1,136115,3.7
25420,July 2017,Michigan,7944890,4880845,61.4,4663173,58.7,217672,4.5
25421,July 2017,Minnesota,4367149,3066447,70.2,2962549,67.8,103898,3.4
25422,July 2017,Mississippi,2289241,1279873,55.9,1214572,53.1,65301,5.1
25423,July 2017,Missouri,4781604,3051495,63.8,2940450,61.5,111045,3.6
25424,July 2017,Montana,831968,526162,63.2,504943,60.7,21219,4.0
25425,July 2017,Nebraska,1465976,1006976,68.7,977827,66.7,29149,2.9
25426,July 2017,Nevada,2351030,1465290,62.3,1392091,59.2,73199,5.0
25427,July 2017,New Hampshire,1100210,747053,67.9,727082,66.1,19971,2.7
25428,July 2017,New Jersey,7159985,4521445,63.1,4312397,60.2,209048,4.6
25429,July 2017,New Mexico,1619858,928948,57.3,872679,53.9,56269,6.1
25430,July 2017,New York,15940589,9732085,61.1,9270898,58.2,461187,4.7
25431,July 2017,North Carolina,8034183,4947650,61.6,4730565,58.9,217085,4.4
25432,July 2017,North Dakota,579809,414729,71.5,404307,69.7,10422,2.5
25433,July 2017,Ohio,9191355,5792693,63.0,5499672,59.8,293021,5.1
25434,July 2017,Oklahoma,2997427,1835587,61.2,1758436,58.7,77151,4.2
25435,July 2017,Oregon,3330800,2109864,63.3,2022547,60.7,87317,4.1
25436,July 2017,Pennsylvania,10261604,6420179,62.6,6112950,59.6,307229,4.8
25437,July 2017,Rhode Island,862297,554618,64.3,530224,61.5,24394,4.4
25438,July 2017,South Carolina,3950287,2313222,58.6,2216343,56.1,96879,4.2
25439,July 2017,South Dakota,659597,455387,69.0,440067,66.7,15320,3.4
25440,July 2017,Tennessee,5279799,3202347,60.7,3091739,58.6,110608,3.5
25441,July 2017,Texas,21272034,13538176,63.6,12981460,61.0,556716,4.1
25442,July 2017,Utah,2250128,1563668,69.5,1512633,67.2,51035,3.3
25443,July 2017,Vermont,515536,344771,66.9,334414,64.9,10357,3.0
25444,July 2017,Virginia,6607903,4315694,65.3,4156594,62.9,159100,3.7
25445,July 2017,Washington,5833527,3732981,64.0,3555370,60.9,177611,4.8
25446,July 2017,West Virginia,1461823,777725,53.2,738132,50.5,39593,5.1
25447,July 2017,Wisconsin,4593365,3158485,68.8,3053208,66.5,105277,3.3
25448,July 2017,Wyoming,447665,292765,65.4,280961,62.8,11804,4.0
25449,August 2017,Alabama,3832595,2166556,56.5,2080173,54.3,86383,4.0
25450,August 2017,Alaska,546598,362802,66.4,336540,61.6,26262,7.2
25451,August 2017,Arizona,5474942,3325430,60.7,3169571,57.9,155859,4.7
25452,August 2017,Arkansas,2327002,1357615,58.3,1307228,56.2,50387,3.7
25453,August 2017,California,31020371,19357883,62.4,18462776,59.5,895107,4.6
25454,August 2017,Colorado,4400684,3012679,68.5,2924477,66.5,88202,2.9
25455,August 2017,Connecticut,2891040,1914331,66.2,1827299,63.2,87032,4.5
25456,August 2017,Delaware,767186,477907,62.3,456059,59.4,21848,4.6
25457,August 2017,District of Columbia,570360,401321,70.4,376810,66.1,24511,6.1
25458,August 2017,Florida,16986475,10123142,59.6,9719243,57.2,403899,4.0
25459,August 2017,Georgia,8020925,5079464,63.3,4849918,60.5,229546,4.5
25460,August 2017,Hawaii,1095414,683307,62.4,668174,61.0,15133,2.2
25461,August 2017,Idaho,1306182,836994,64.1,811464,62.1,25530,3.1
25462,August 2017,Illinois,10059308,6493549,64.6,6170372,61.3,323177,5.0
25463,August 2017,Indiana,5185849,3326633,64.1,3207716,61.9,118917,3.6
25464,August 2017,Iowa,2456418,1677745,68.3,1626667,66.2,51078,3.0
25465,August 2017,Kansas,2219753,1479592,66.7,1426624,64.3,52968,3.6
25466,August 2017,Kentucky,3478034,2059316,59.2,1959110,56.3,100206,4.9
25467,August 2017,Louisiana,3595714,2111175,58.7,2008207,55.9,102968,4.9
25468,August 2017,Maine,1101570,701481,63.7,677657,61.5,23824,3.4
25469,August 2017,Maryland,4766968,3225083,67.7,3094512,64.9,130571,4.0
25470,August 2017,Massachusetts,5589404,3660376,65.5,3526995,63.1,133381,3.6
25471,August 2017,Michigan,7948706,4889985,61.5,4665595,58.7,224390,4.6
25472,August 2017,Minnesota,4371226,3068539,70.2,2965558,67.8,102981,3.4
25473,August 2017,Mississippi,2289815,1278839,55.8,1215026,53.1,63813,5.0
25474,August 2017,Missouri,4784101,3050689,63.8,2940217,61.5,110472,3.6
25475,August 2017,Montana,832928,526553,63.2,505168,60.6,21385,4.1
25476,August 2017,Nebraska,1467070,1006930,68.6,977748,66.6,29182,2.9
25477,August 2017,Nevada,2355649,1468711,62.3,1396126,59.3,72585,4.9
25478,August 2017,New Hampshire,1101087,747101,67.9,727261,66.0,19840,2.7
25479,August 2017,New Jersey,7163572,4520146,63.1,4308354,60.1,211792,4.7
25480,August 2017,New Mexico,1620646,929744,57.4,873743,53.9,56001,6.0
25481,August 2017,New York,15944689,9730710,61.0,9269669,58.1,461041,4.7
25482,August 2017,North Carolina,8044409,4956805,61.6,4738606,58.9,218199,4.4
25483,August 2017,North Dakota,579774,414350,71.5,403736,69.6,10614,2.6
25484,August 2017,Ohio,9195272,5793074,63.0,5502146,59.8,290928,5.0
25485,August 2017,Oklahoma,2998679,1838382,61.3,1761777,58.8,76605,4.2
25486,August 2017,Oregon,3335482,2114842,63.4,2026884,60.8,87958,4.2
25487,August 2017,Pennsylvania,10264714,6418186,62.5,6110992,59.5,307194,4.8
25488,August 2017,Rhode Island,862659,555295,64.4,530676,61.5,24619,4.4
25489,August 2017,South Carolina,3955758,2315916,58.5,2218539,56.1,97377,4.2
25490,August 2017,South Dakota,660206,455739,69.0,440262,66.7,15477,3.4
25491,August 2017,Tennessee,5285340,3210630,60.7,3102518,58.7,108112,3.4
25492,August 2017,Texas,21303690,13557380,63.6,13011807,61.1,545573,4.0
25493,August 2017,Utah,2254579,1567493,69.5,1516761,67.3,50732,3.2
25494,August 2017,Vermont,515667,344853,66.9,334607,64.9,10246,3.0
25495,August 2017,Virginia,6613048,4318898,65.3,4161031,62.9,157867,3.7
25496,August 2017,Washington,5843014,3743241,64.1,3565350,61.0,177891,4.8
25497,August 2017,West Virginia,1461213,779200,53.3,738655,50.6,40545,5.2
25498,August 2017,Wisconsin,4595931,3160064,68.8,3055061,66.5,105003,3.3
25499,August 2017,Wyoming,447422,292617,65.4,280643,62.7,11974,4.1
25500,September 2017,Alabama,3834293,2165752,56.5,2082085,54.3,83667,3.9
25501,September 2017,Alaska,546609,362660,66.3,336377,61.5,26283,7.2
25502,September 2017,Arizona,5484427,3334438,60.8,3178341,58.0,156097,4.7
25503,September 2017,Arkansas,2328549,1357918,58.3,1307414,56.1,50504,3.7
25504,September 2017,California,31043937,19380546,62.4,18501320,59.6,879226,4.5
25505,September 2017,Colorado,4407421,3023747,68.6,2932976,66.5,90771,3.0
25506,September 2017,Connecticut,2891886,1912788,66.1,1826437,63.2,86351,4.5
25507,September 2017,Delaware,768080,477990,62.2,456252,59.4,21738,4.5
25508,September 2017,District of Columbia,570967,401322,70.3,377212,66.1,24110,6.0
25509,September 2017,Florida,17013401,10132775,59.6,9733804,57.2,398971,3.9
25510,September 2017,Georgia,8030844,5088500,63.4,4860568,60.5,227932,4.5
25511,September 2017,Hawaii,1095441,682773,62.3,667996,61.0,14777,2.2
25512,September 2017,Idaho,1309002,839790,64.2,814500,62.2,25290,3.0
25513,September 2017,Illinois,10059706,6499081,64.6,6177211,61.4,321870,5.0
25514,September 2017,Indiana,5189029,3325561,64.1,3208113,61.8,117448,3.5
25515,September 2017,Iowa,2457762,1676271,68.2,1626240,66.2,50031,3.0
25516,September 2017,Kansas,2220645,1479401,66.6,1426787,64.3,52614,3.6
25517,September 2017,Kentucky,3479753,2057649,59.1,1960964,56.4,96685,4.7
25518,September 2017,Louisiana,3596279,2113558,58.8,2012936,56.0,100622,4.8
25519,September 2017,Maine,1102186,701068,63.6,678016,61.5,23052,3.3
25520,September 2017,Maryland,4769679,3224463,67.6,3094219,64.9,130244,4.0
25521,September 2017,Massachusetts,5593228,3659358,65.4,3528571,63.1,130787,3.6
25522,September 2017,Michigan,7952585,4897928,61.6,4668421,58.7,229507,4.7
25523,September 2017,Minnesota,4375279,3070030,70.2,2967990,67.8,102040,3.3
25524,September 2017,Mississippi,2290379,1278158,55.8,1215859,53.1,62299,4.9
25525,September 2017,Missouri,4786641,3049893,63.7,2939528,61.4,110365,3.6
25526,September 2017,Montana,833926,526852,63.2,505340,60.6,21512,4.1
25527,September 2017,Nebraska,1468196,1006987,68.6,977765,66.6,29222,2.9
25528,September 2017,Nevada,2360240,1471791,62.4,1399686,59.3,72105,4.9
25529,September 2017,New Hampshire,1101973,747062,67.8,727391,66.0,19671,2.6
25530,September 2017,New Jersey,7167163,4518109,63.0,4304556,60.1,213553,4.7
25531,September 2017,New Mexico,1621429,930756,57.4,874914,54.0,55842,6.0
25532,September 2017,New York,15948874,9724760,61.0,9265933,58.1,458827,4.7
25533,September 2017,North Carolina,8054617,4964461,61.6,4744582,58.9,219879,4.4
25534,September 2017,North Dakota,579720,413976,71.4,403175,69.5,10801,2.6
25535,September 2017,Ohio,9199250,5790537,62.9,5503699,59.8,286838,5.0
25536,September 2017,Oklahoma,2999919,1840852,61.4,1764595,58.8,76257,4.1
25537,September 2017,Oregon,3340216,2119032,63.4,2030817,60.8,88215,4.2
25538,September 2017,Pennsylvania,10267837,6418386,62.5,6110417,59.5,307969,4.8
25539,September 2017,Rhode Island,862998,555930,64.4,531065,61.5,24865,4.5
25540,September 2017,South Carolina,3961228,2318235,58.5,2220466,56.1,97769,4.2
25541,September 2017,South Dakota,660805,456095,69.0,440524,66.7,15571,3.4
25542,September 2017,Tennessee,5290907,3217261,60.8,3110603,58.8,106658,3.3
25543,September 2017,Texas,21335340,13577714,63.6,13039301,61.1,538413,4.0
25544,September 2017,Utah,2259055,1571151,69.5,1520746,67.3,50405,3.2
25545,September 2017,Vermont,515827,344932,66.9,334790,64.9,10142,2.9
25546,September 2017,Virginia,6618234,4320845,65.3,4164002,62.9,156843,3.6
25547,September 2017,Washington,5852506,3751574,64.1,3573965,61.1,177609,4.7
25548,September 2017,West Virginia,1460625,780761,53.5,739290,50.6,41471,5.3
25549,September 2017,Wisconsin,4598522,3160464,68.7,3056887,66.5,103577,3.3
25550,September 2017,Wyoming,447172,292490,65.4,280381,62.7,12109,4.1
25551,October 2017,Alabama,3836070,2164470,56.4,2082593,54.3,81877,3.8
25552,October 2017,Alaska,546588,362514,66.3,336249,61.5,26265,7.2
25553,October 2017,Arizona,5493903,3340425,60.8,3183588,57.9,156837,4.7
25554,October 2017,Arkansas,2330094,1357679,58.3,1307175,56.1,50504,3.7
25555,October 2017,California,31067364,19392851,62.4,18526266,59.6,866585,4.5
25556,October 2017,Colorado,4414152,3031110,68.7,2938819,66.6,92291,3.0
25557,October 2017,Connecticut,2892702,1912024,66.1,1825953,63.1,86071,4.5
25558,October 2017,Delaware,768949,477983,62.2,456314,59.3,21669,4.5
25559,October 2017,District of Columbia,571548,401373,70.2,377589,66.1,23784,5.9
25560,October 2017,Florida,17040366,10139339,59.5,9743503,57.2,395836,3.9
25561,October 2017,Georgia,8040738,5093754,63.3,4866501,60.5,227253,4.5
25562,October 2017,Hawaii,1095478,682569,62.3,667998,61.0,14571,2.1
25563,October 2017,Idaho,1311822,841857,64.2,816726,62.3,25131,3.0
25564,October 2017,Illinois,10060091,6501975,64.6,6182414,61.5,319561,4.9
25565,October 2017,Indiana,5192261,3322852,64.0,3207794,61.8,115058,3.5
25566,October 2017,Iowa,2459122,1675041,68.1,1625795,66.1,49246,2.9
25567,October 2017,Kansas,2221558,1478910,66.6,1426621,64.2,52289,3.5
25568,October 2017,Kentucky,3481447,2055308,59.0,1961625,56.3,93683,4.6
25569,October 2017,Louisiana,3596825,2115366,58.8,2016232,56.1,99134,4.7
25570,October 2017,Maine,1102861,700529,63.5,678223,61.5,22306,3.2
25571,October 2017,Maryland,4772360,3223061,67.5,3092834,64.8,130227,4.0
25572,October 2017,Massachusetts,5597079,3658063,65.4,3529226,63.1,128837,3.5
25573,October 2017,Michigan,7956497,4902141,61.6,4670149,58.7,231992,4.7
25574,October 2017,Minnesota,4379442,3070582,70.1,2969194,67.8,101388,3.3
25575,October 2017,Mississippi,2290974,1277620,55.8,1216553,53.1,61067,4.8
25576,October 2017,Missouri,4789210,3048881,63.7,2938214,61.4,110667,3.6
25577,October 2017,Montana,834904,527027,63.1,505448,60.5,21579,4.1
25578,October 2017,Nebraska,1469334,1007035,68.5,977763,66.5,29272,2.9
25579,October 2017,Nevada,2364860,1473938,62.3,1402099,59.3,71839,4.9
25580,October 2017,New Hampshire,1102880,746893,67.7,727395,66.0,19498,2.6
25581,October 2017,New Jersey,7170755,4515353,63.0,4301089,60.0,214264,4.7
25582,October 2017,New Mexico,1622211,931539,57.4,875803,54.0,55736,6.0
25583,October 2017,New York,15953016,9715583,60.9,9259461,58.0,456122,4.7
25584,October 2017,North Carolina,8064872,4968481,61.6,4747159,58.9,221322,4.5
25585,October 2017,North Dakota,579688,413648,71.4,402725,69.5,10923,2.6
25586,October 2017,Ohio,9203241,5785775,62.9,5503328,59.8,282447,4.9
25587,October 2017,Oklahoma,3001179,1842332,61.4,1766262,58.9,76070,4.1
25588,October 2017,Oregon,3344893,2121693,63.4,2033478,60.8,88215,4.2
25589,October 2017,Pennsylvania,10271021,6418284,62.5,6109456,59.5,308828,4.8
25590,October 2017,Rhode Island,863369,556339,64.4,531268,61.5,25071,4.5
25591,October 2017,South Carolina,3966728,2319409,58.5,2221475,56.0,97934,4.2
25592,October 2017,South Dakota,661410,456331,69.0,440726,66.6,15605,3.4
25593,October 2017,Tennessee,5296525,3220679,60.8,3114718,58.8,105961,3.3
25594,October 2017,Texas,21366983,13592091,63.6,13057389,61.1,534702,3.9
25595,October 2017,Utah,2263540,1573918,69.5,1523759,67.3,50159,3.2
25596,October 2017,Vermont,515977,344945,66.9,334886,64.9,10059,2.9
25597,October 2017,Virginia,6623426,4320772,65.2,4164655,62.9,156117,3.6
25598,October 2017,Washington,5862032,3756619,64.1,3579503,61.1,177116,4.7
25599,October 2017,West Virginia,1460051,781886,53.6,739699,50.7,42187,5.4
25600,October 2017,Wisconsin,4601113,3159757,68.7,3057975,66.5,101782,3.2
25601,October 2017,Wyoming,446958,292348,65.4,280189,62.7,12159,4.2
25602,November 2017,Alabama,3837447,2163722,56.4,2081752,54.2,81970,3.8
25603,November 2017,Alaska,546554,362458,66.3,336224,61.5,26234,7.2
25604,November 2017,Arizona,5502915,3340656,60.7,3183120,57.8,157536,4.7
25605,November 2017,Arkansas,2331443,1357161,58.2,1306710,56.0,50451,3.7
25606,November 2017,California,31088978,19390563,62.4,18525773,59.6,864790,4.5
25607,November 2017,Colorado,4420557,3031291,68.6,2939071,66.5,92220,3.0
25608,November 2017,Connecticut,2893280,1912251,66.1,1826004,63.1,86247,4.5
25609,November 2017,Delaware,769760,477911,62.1,456236,59.3,21675,4.5
25610,November 2017,District of Columbia,572100,401402,70.2,377694,66.0,23708,5.9
25611,November 2017,Florida,17065606,10139552,59.4,9743382,57.1,396170,3.9
25612,November 2017,Georgia,8050028,5093090,63.3,4865264,60.4,227826,4.5
25613,November 2017,Hawaii,1095534,682710,62.3,668104,61.0,14606,2.1
25614,November 2017,Idaho,1314519,842083,64.1,816951,62.1,25132,3.0
25615,November 2017,Illinois,10059631,6501460,64.6,6183083,61.5,318377,4.9
25616,November 2017,Indiana,5195016,3320822,63.9,3207096,61.7,113726,3.4
25617,November 2017,Iowa,2460207,1674753,68.1,1625600,66.1,49153,2.9
25618,November 2017,Kansas,2222227,1478545,66.5,1426326,64.2,52219,3.5
25619,November 2017,Kentucky,3482831,2053968,59.0,1961014,56.3,92954,4.5
25620,November 2017,Louisiana,3597072,2115739,58.8,2016469,56.1,99270,4.7
25621,November 2017,Maine,1103372,700226,63.5,678193,61.5,22033,3.1
25622,November 2017,Maryland,4774637,3221982,67.5,3091482,64.7,130500,4.1
25623,November 2017,Massachusetts,5600438,3657358,65.3,3528769,63.0,128589,3.5
25624,November 2017,Michigan,7959650,4901592,61.6,4669834,58.7,231758,4.7
25625,November 2017,Minnesota,4383120,3070156,70.0,2968697,67.7,101459,3.3
25626,November 2017,Mississippi,2291366,1277521,55.8,1216703,53.1,60818,4.8
25627,November 2017,Missouri,4791278,3048438,63.6,2937251,61.3,111187,3.6
25628,November 2017,Montana,835793,526986,63.1,505427,60.5,21559,4.1
25629,November 2017,Nebraska,1470332,1007038,68.5,977730,66.5,29308,2.9
25630,November 2017,Nevada,2369284,1474055,62.2,1402164,59.2,71891,4.9
25631,November 2017,New Hampshire,1103692,746717,67.7,727286,65.9,19431,2.6
25632,November 2017,New Jersey,7173770,4513889,62.9,4299951,59.9,213938,4.7
25633,November 2017,New Mexico,1622885,931671,57.4,875923,54.0,55748,6.0
25634,November 2017,New York,15955923,9709880,60.9,9254869,58.0,455011,4.7
25635,November 2017,North Carolina,8074422,4967600,61.5,4745680,58.8,221920,4.5
25636,November 2017,North Dakota,579613,413548,71.3,402616,69.5,10932,2.6
25637,November 2017,Ohio,9206335,5782715,62.8,5501798,59.8,280917,4.9
25638,November 2017,Oklahoma,3002154,1842189,61.4,1766036,58.8,76153,4.1
25639,November 2017,Oregon,3349305,2121596,63.3,2033520,60.7,88076,4.2
25640,November 2017,Pennsylvania,10273110,6418195,62.5,6108750,59.5,309445,4.8
25641,November 2017,Rhode Island,863651,556343,64.4,531210,61.5,25133,4.5
25642,November 2017,South Carolina,3971849,2319133,58.4,2221189,55.9,97944,4.2
25643,November 2017,South Dakota,661976,456318,68.9,440740,66.6,15578,3.4
25644,November 2017,Tennessee,5301665,3219852,60.7,3113474,58.7,106378,3.3
25645,November 2017,Texas,21397145,13593505,63.5,13057329,61.0,536176,3.9
25646,November 2017,Utah,2267869,1574271,69.4,1524148,67.2,50123,3.2
25647,November 2017,Vermont,516083,344895,66.8,334853,64.9,10042,2.9
25648,November 2017,Virginia,6628097,4319320,65.2,4163169,62.8,156151,3.6
25649,November 2017,Washington,5871043,3756204,64.0,3579304,61.0,176900,4.7
25650,November 2017,West Virginia,1459313,782030,53.6,739693,50.7,42337,5.4
25651,November 2017,Wisconsin,4603329,3158682,68.6,3057730,66.4,100952,3.2
25652,November 2017,Wyoming,446659,292293,65.4,280162,62.7,12131,4.2
25653,December 2017,Alabama,3838682,2163554,56.4,2081176,54.2,82378,3.8
25654,December 2017,Alaska,546490,362473,66.3,336253,61.5,26220,7.2
25655,December 2017,Arizona,5511612,3339431,60.6,3181684,57.7,157747,4.7
25656,December 2017,Arkansas,2332681,1356940,58.2,1306527,56.0,50413,3.7
25657,December 2017,California,31108823,19386465,62.3,18520093,59.5,866372,4.5
25658,December 2017,Colorado,4426730,3029796,68.4,2937962,66.4,91834,3.0
25659,December 2017,Connecticut,2893704,1912551,66.1,1826167,63.1,86384,4.5
25660,December 2017,Delaware,770502,477882,62.0,456188,59.2,21694,4.5
25661,December 2017,District of Columbia,572603,401428,70.1,377688,66.0,23740,5.9
25662,December 2017,Florida,17089961,10138193,59.3,9741161,57.0,397032,3.9
25663,December 2017,Georgia,8058945,5091491,63.2,4863272,60.3,228219,4.5
25664,December 2017,Hawaii,1095528,682852,62.3,668182,61.0,14670,2.1
25665,December 2017,Idaho,1317182,841774,63.9,816611,62.0,25163,3.0
25666,December 2017,Illinois,10058678,6500446,64.6,6182324,61.5,318122,4.9
25667,December 2017,Indiana,5197550,3320260,63.9,3206787,61.7,113473,3.4
25668,December 2017,Iowa,2461202,1674894,68.1,1625627,66.1,49267,2.9
25669,December 2017,Kansas,2222794,1478476,66.5,1426227,64.2,52249,3.5
25670,December 2017,Kentucky,3484091,2053713,58.9,1960525,56.3,93188,4.5
25671,December 2017,Louisiana,3597152,2115536,58.8,2015897,56.0,99639,4.7
25672,December 2017,Maine,1103883,700192,63.4,678144,61.4,22048,3.1
25673,December 2017,Maryland,4776739,3221685,67.4,3091074,64.7,130611,4.1
25674,December 2017,Massachusetts,5603545,3657291,65.3,3528413,63.0,128878,3.5
25675,December 2017,Michigan,7962516,4900207,61.5,4669268,58.6,230939,4.7
25676,December 2017,Minnesota,4386635,3069832,70.0,2968202,67.7,101630,3.3
25677,December 2017,Mississippi,2291644,1277573,55.7,1216640,53.1,60933,4.8
25678,December 2017,Missouri,4793175,3048394,63.6,2937008,61.3,111386,3.7
25679,December 2017,Montana,836669,526944,63.0,505413,60.4,21531,4.1
25680,December 2017,Nebraska,1471244,1007050,68.4,977741,66.5,29309,2.9
25681,December 2017,Nevada,2373573,1473704,62.1,1401723,59.1,71981,4.9
25682,December 2017,New Hampshire,1104428,746676,67.6,727245,65.8,19431,2.6
25683,December 2017,New Jersey,7176397,4513664,62.9,4300174,59.9,213490,4.7
25684,December 2017,New Mexico,1623447,931571,57.4,875799,53.9,55772,6.0
25685,December 2017,New York,15958017,9708580,60.8,9253641,58.0,454939,4.7
25686,December 2017,North Carolina,8083590,4966113,61.4,4744264,58.7,221849,4.5
25687,December 2017,North Dakota,579509,413573,71.4,402668,69.5,10905,2.6
25688,December 2017,Ohio,9209056,5782017,62.8,5501017,59.7,281000,4.9
25689,December 2017,Oklahoma,3002984,1841801,61.3,1765566,58.8,76235,4.1
25690,December 2017,Oregon,3353525,2120955,63.2,2032976,60.6,87979,4.1
25691,December 2017,Pennsylvania,10274760,6418025,62.5,6108483,59.5,309542,4.8
25692,December 2017,Rhode Island,863923,556267,64.4,531149,61.5,25118,4.5
25693,December 2017,South Carolina,3976814,2318724,58.3,2220845,55.8,97879,4.2
25694,December 2017,South Dakota,662490,456271,68.9,440716,66.5,15555,3.4
25695,December 2017,Tennessee,5306547,3218569,60.7,3111843,58.6,106726,3.3
25696,December 2017,Texas,21426063,13591013,63.4,13053325,60.9,537688,4.0
25697,December 2017,Utah,2272091,1573889,69.3,1523739,67.1,50150,3.2
25698,December 2017,Vermont,516151,344870,66.8,334820,64.9,10050,2.9
25699,December 2017,Virginia,6632449,4318483,65.1,4162203,62.8,156280,3.6
25700,December 2017,Washington,5879807,3754871,63.9,3578007,60.9,176864,4.7
25701,December 2017,West Virginia,1458505,781852,53.6,739601,50.7,42251,5.4
25702,December 2017,Wisconsin,4605309,3158257,68.6,3057396,66.4,100861,3.2
25703,December 2017,Wyoming,446348,292305,65.5,280200,62.8,12105,4.1
25704,January 2018,Alabama,3839921,2160683,56.3,2079876,54.2,80807,3.7
25705,January 2018,Alaska,546429,362500,66.3,336189,61.5,26311,7.3
25706,January 2018,Arizona,5520395,3345206,60.6,3185080,57.7,160126,4.8
25707,January 2018,Arkansas,2333939,1355383,58.1,1304610,55.9,50773,3.7
25708,January 2018,California,31129325,19389063,62.3,18536734,59.5,852329,4.4
25709,January 2018,Colorado,4432917,3034093,68.4,2941725,66.4,92368,3.0
25710,January 2018,Connecticut,2894185,1909934,66.0,1823176,63.0,86758,4.5
25711,January 2018,Delaware,771283,478399,62.0,456885,59.2,21514,4.5
25712,January 2018,District of Columbia,573172,401749,70.1,378592,66.1,23157,5.8
25713,January 2018,Florida,17114515,10151618,59.3,9754409,57.0,397209,3.9
25714,January 2018,Georgia,8067876,5100106,63.2,4872477,60.4,227629,4.5
25715,January 2018,Hawaii,1095553,683024,62.3,668653,61.0,14371,2.1
25716,January 2018,Idaho,1319813,844203,64.0,818983,62.1,25220,3.0
25717,January 2018,Illinois,10057795,6491908,64.5,6180403,61.4,311505,4.8
25718,January 2018,Indiana,5200045,3313103,63.7,3203741,61.6,109362,3.3
25719,January 2018,Iowa,2462194,1673405,68.0,1625074,66.0,48331,2.9
25720,January 2018,Kansas,2223399,1476833,66.4,1425843,64.1,50990,3.5
25721,January 2018,Kentucky,3485325,2049817,58.8,1961941,56.3,87876,4.3
25722,January 2018,Louisiana,3597236,2120684,59.0,2024116,56.3,96568,4.6
25723,January 2018,Maine,1104341,699711,63.4,678703,61.5,21008,3.0
25724,January 2018,Maryland,4778833,3221345,67.4,3089278,64.6,132067,4.1
25725,January 2018,Massachusetts,5606659,3659563,65.3,3532436,63.0,127127,3.5
25726,January 2018,Michigan,7965298,4897006,61.5,4665379,58.6,231627,4.7
25727,January 2018,Minnesota,4390101,3076674,70.1,2975997,67.8,100677,3.3
25728,January 2018,Mississippi,2291947,1274795,55.6,1216518,53.1,58277,4.6
25729,January 2018,Missouri,4795064,3042751,63.5,2930430,61.1,112321,3.7
25730,January 2018,Montana,837531,526694,62.9,505165,60.3,21529,4.1
25731,January 2018,Nebraska,1472178,1007856,68.5,979018,66.5,28838,2.9
25732,January 2018,Nevada,2377904,1476359,62.1,1404231,59.1,72128,4.9
25733,January 2018,New Hampshire,1105169,746570,67.6,727206,65.8,19364,2.6
25734,January 2018,New Jersey,7179101,4508665,62.8,4296896,59.9,211769,4.7
25735,January 2018,New Mexico,1624062,933250,57.5,878253,54.1,54997,5.9
25736,January 2018,New York,15960241,9701691,60.8,9249282,58.0,452409,4.7
25737,January 2018,North Carolina,8092789,4969893,61.4,4747637,58.7,222256,4.5
25738,January 2018,North Dakota,579378,413567,71.4,402629,69.5,10938,2.6
25739,January 2018,Ohio,9211712,5768713,62.6,5497444,59.7,271269,4.7
25740,January 2018,Oklahoma,3003840,1842471,61.3,1766250,58.8,76221,4.1
25741,January 2018,Oregon,3357767,2125221,63.3,2037526,60.7,87695,4.1
25742,January 2018,Pennsylvania,10276393,6413906,62.4,6103687,59.4,310219,4.8
25743,January 2018,Rhode Island,864163,556621,64.4,531462,61.5,25159,4.5
25744,January 2018,South Carolina,3981761,2321233,58.3,2221051,55.8,100182,4.3
25745,January 2018,South Dakota,662992,457257,69.0,441652,66.6,15605,3.4
25746,January 2018,Tennessee,5311419,3218407,60.6,3111641,58.6,106766,3.3
25747,January 2018,Texas,21455392,13612743,63.4,13074211,60.9,538532,4.0
25748,January 2018,Utah,2276260,1575767,69.2,1526565,67.1,49202,3.1
25749,January 2018,Vermont,516251,345116,66.9,335233,64.9,9883,2.9
25750,January 2018,Virginia,6636793,4317044,65.0,4163085,62.7,153959,3.6
25751,January 2018,Washington,5888544,3757119,63.8,3579847,60.8,177272,4.7
25752,January 2018,West Virginia,1457694,783071,53.7,740933,50.8,42138,5.4
25753,January 2018,Wisconsin,4607252,3157487,68.5,3060817,66.4,96670,3.1
25754,January 2018,Wyoming,446015,291790,65.4,279969,62.8,11821,4.1
25755,February 2018,Alabama,3840664,2160917,56.3,2080346,54.2,80571,3.7
25756,February 2018,Alaska,546321,362659,66.4,336265,61.6,26394,7.3
25757,February 2018,Arizona,5528429,3355522,60.7,3191923,57.7,163599,4.9
25758,February 2018,Arkansas,2334835,1353767,58.0,1302964,55.8,50803,3.8
25759,February 2018,California,31146399,19392828,62.3,18549799,59.6,843029,4.3
25760,February 2018,Colorado,4438713,3041965,68.5,2949473,66.4,92492,3.0
25761,February 2018,Connecticut,2894278,1908154,65.9,1821246,62.9,86908,4.6
25762,February 2018,Delaware,771915,479075,62.1,457936,59.3,21139,4.4
25763,February 2018,District of Columbia,573606,402588,70.2,379836,66.2,22752,5.7
25764,February 2018,Florida,17136282,10176274,59.4,9778056,57.1,398218,3.9
25765,February 2018,Georgia,8076006,5115288,63.3,4887760,60.5,227528,4.4
25766,February 2018,Hawaii,1095404,683547,62.4,669390,61.1,14157,2.1
25767,February 2018,Idaho,1322300,846451,64.0,821460,62.1,24991,3.0
25768,February 2018,Illinois,10055730,6491773,64.6,6186468,61.5,305305,4.7
25769,February 2018,Indiana,5202029,3315405,63.7,3208242,61.7,107163,3.2
25770,February 2018,Iowa,2462881,1673516,67.9,1625597,66.0,47919,2.9
25771,February 2018,Kansas,2223737,1476128,66.4,1425635,64.1,50493,3.4
25772,February 2018,Kentucky,3486173,2048993,58.8,1964153,56.3,84840,4.1
25773,February 2018,Louisiana,3596877,2128050,59.2,2032973,56.5,95077,4.5
25774,February 2018,Maine,1104689,699733,63.3,679724,61.5,20009,2.9
25775,February 2018,Maryland,4780345,3224669,67.5,3090292,64.6,134377,4.2
25776,February 2018,Massachusetts,5609183,3669508,65.4,3541921,63.1,127587,3.5
25777,February 2018,Michigan,7967153,4897455,61.5,4664810,58.6,232645,4.8
25778,February 2018,Minnesota,4393144,3086058,70.2,2986232,68.0,99826,3.2
25779,February 2018,Mississippi,2291935,1274112,55.6,1216454,53.1,57658,4.5
25780,February 2018,Missouri,4796357,3040806,63.4,2929743,61.1,111063,3.7
25781,February 2018,Montana,838288,526536,62.8,504846,60.2,21690,4.1
25782,February 2018,Nebraska,1472932,1009377,68.5,980984,66.6,28393,2.8
25783,February 2018,Nevada,2381974,1480396,62.1,1407901,59.1,72495,4.9
25784,February 2018,New Hampshire,1105804,747307,67.6,728082,65.8,19225,2.6
25785,February 2018,New Jersey,7180959,4506807,62.8,4297357,59.8,209450,4.6
25786,February 2018,New Mexico,1624419,935022,57.6,881113,54.2,53909,5.8
25787,February 2018,New York,15960578,9692597,60.7,9242710,57.9,449887,4.6
25788,February 2018,North Carolina,8101027,4974340,61.4,4751952,58.7,222388,4.5
25789,February 2018,North Dakota,579228,413613,71.4,402675,69.5,10938,2.6
25790,February 2018,Ohio,9213291,5765770,62.6,5504222,59.7,261548,4.5
25791,February 2018,Oklahoma,3004345,1845063,61.4,1769910,58.9,75153,4.1
25792,February 2018,Oregon,3361594,2129795,63.4,2041760,60.7,88035,4.1
25793,February 2018,Pennsylvania,10276743,6410542,62.4,6100672,59.4,309870,4.8
25794,February 2018,Rhode Island,864323,557365,64.5,532000,61.6,25365,4.6
25795,February 2018,South Carolina,3986188,2324812,58.3,2223397,55.8,101415,4.4
25796,February 2018,South Dakota,663431,458329,69.1,442692,66.7,15637,3.4
25797,February 2018,Tennessee,5315710,3221992,60.6,3113541,58.6,108451,3.4
25798,February 2018,Texas,21482555,13656938,63.6,13112824,61.0,544114,4.0
25799,February 2018,Utah,2280339,1579114,69.2,1530499,67.1,48615,3.1
25800,February 2018,Vermont,516278,345923,67.0,336203,65.1,9720,2.8
25801,February 2018,Virginia,6640456,4320832,65.1,4171108,62.8,149724,3.5
25802,February 2018,Washington,5896689,3759978,63.8,3581914,60.7,178064,4.7
25803,February 2018,West Virginia,1456688,784765,53.9,742555,51.0,42210,5.4
25804,February 2018,Wisconsin,4608690,3161193,68.6,3068360,66.6,92833,2.9
25805,February 2018,Wyoming,445707,291482,65.4,279930,62.8,11552,4.0
25806,March 2018,Alabama,3841601,2162897,56.3,2081731,54.2,81166,3.8
25807,March 2018,Alaska,546229,362922,66.4,336510,61.6,26412,7.3
25808,March 2018,Arizona,5536593,3364525,60.8,3200073,57.8,164452,4.9
25809,March 2018,Arkansas,2335908,1353076,57.9,1301725,55.7,51351,3.8
25810,March 2018,California,31163550,19379922,62.2,18552167,59.5,827755,4.3
25811,March 2018,Colorado,4444676,3049371,68.6,2958793,66.6,90578,3.0
25812,March 2018,Connecticut,2894526,1904716,65.8,1818377,62.8,86339,4.5
25813,March 2018,Delaware,772616,480244,62.2,459547,59.5,20697,4.3
25814,March 2018,District of Columbia,574091,403727,70.3,380985,66.4,22742,5.6
25815,March 2018,Florida,17158582,10193386,59.4,9792976,57.1,400410,3.9
25816,March 2018,Georgia,8084437,5128566,63.4,4902544,60.6,226022,4.4
25817,March 2018,Hawaii,1095231,684631,62.5,670547,61.2,14084,2.1
25818,March 2018,Idaho,1324872,848131,64.0,823461,62.2,24670,2.9
25819,March 2018,Illinois,10054114,6492969,64.6,6195330,61.6,297639,4.6
25820,March 2018,Indiana,5204312,3323026,63.9,3217955,61.8,105071,3.2
25821,March 2018,Iowa,2463743,1673572,67.9,1626240,66.0,47332,2.8
25822,March 2018,Kansas,2224224,1475242,66.3,1425172,64.1,50070,3.4
25823,March 2018,Kentucky,3487275,2050194,58.8,1967164,56.4,83030,4.0
25824,March 2018,Louisiana,3596726,2133758,59.3,2038997,56.7,94761,4.4
25825,March 2018,Maine,1105106,700190,63.4,681003,61.6,19187,2.7
25826,March 2018,Maryland,4782072,3228185,67.5,3090652,64.6,137533,4.3
25827,March 2018,Massachusetts,5612017,3683675,65.6,3554923,63.3,128752,3.5
25828,March 2018,Michigan,7969510,4898245,61.5,4668345,58.6,229900,4.7
25829,March 2018,Minnesota,4396435,3093831,70.4,2994723,68.1,99108,3.2
25830,March 2018,Mississippi,2292017,1273764,55.6,1216489,53.1,57275,4.5
25831,March 2018,Missouri,4797962,3039505,63.3,2929511,61.1,109994,3.6
25832,March 2018,Montana,839081,525950,62.7,504330,60.1,21620,4.1
25833,March 2018,Nebraska,1473784,1011002,68.6,982787,66.7,28215,2.8
25834,March 2018,Nevada,2386090,1484904,62.2,1411904,59.2,73000,4.9
25835,March 2018,New Hampshire,1106486,748688,67.7,729429,65.9,19259,2.6
25836,March 2018,New Jersey,7183018,4500017,62.6,4292899,59.8,207118,4.6
25837,March 2018,New Mexico,1624786,936511,57.6,884079,54.4,52432,5.6
25838,March 2018,New York,15961491,9675414,60.6,9226464,57.8,448950,4.6
25839,March 2018,North Carolina,8109696,4977843,61.4,4755326,58.6,222517,4.5
25840,March 2018,North Dakota,579087,413361,71.4,402610,69.5,10751,2.6
25841,March 2018,Ohio,9215482,5770546,62.6,5517975,59.9,252571,4.4
25842,March 2018,Oklahoma,3004999,1848315,61.5,1773774,59.0,74541,4.0
25843,March 2018,Oregon,3365601,2131620,63.3,2043490,60.7,88130,4.1
25844,March 2018,Pennsylvania,10277718,6393600,62.2,6089402,59.2,304198,4.8
25845,March 2018,Rhode Island,864493,558040,64.6,532745,61.6,25295,4.5
25846,March 2018,South Carolina,3990832,2327331,58.3,2225252,55.8,102079,4.4
25847,March 2018,South Dakota,663914,459143,69.2,443689,66.8,15454,3.4
25848,March 2018,Tennessee,5320310,3224893,60.6,3114752,58.5,110141,3.4
25849,March 2018,Texas,21509921,13702943,63.7,13150595,61.1,552348,4.0
25850,March 2018,Utah,2284523,1582790,69.3,1534287,67.2,48503,3.1
25851,March 2018,Vermont,516340,346963,67.2,337376,65.3,9587,2.8
25852,March 2018,Virginia,6644390,4325344,65.1,4178350,62.9,146994,3.4
25853,March 2018,Washington,5905106,3761537,63.7,3583088,60.7,178449,4.7
25854,March 2018,West Virginia,1455825,785418,54.0,743225,51.1,42193,5.4
25855,March 2018,Wisconsin,4610451,3168552,68.7,3078038,66.8,90514,2.9
25856,March 2018,Wyoming,445364,291076,65.4,279855,62.8,11221,3.9
25857,April 2018,Alabama,3842724,2169509,56.5,2086358,54.3,83151,3.8
25858,April 2018,Alaska,546137,362949,66.5,336494,61.6,26455,7.3
25859,April 2018,Arizona,5545069,3370639,60.8,3206798,57.8,163841,4.9
25860,April 2018,Arkansas,2337096,1351935,57.8,1300292,55.6,51643,3.8
25861,April 2018,California,31182686,19358521,62.1,18543030,59.5,815491,4.2
25862,April 2018,Colorado,4450796,3056040,68.7,2967998,66.7,88042,2.9
25863,April 2018,Connecticut,2894856,1900950,65.7,1815200,62.7,85750,4.5
25864,April 2018,Delaware,773327,481417,62.3,461305,59.7,20112,4.2
25865,April 2018,District of Columbia,574625,405379,70.5,382638,66.6,22741,5.6
25866,April 2018,Florida,17181707,10204507,59.4,9806859,57.1,397648,3.9
25867,April 2018,Georgia,8093219,5137984,63.5,4915689,60.7,222295,4.3
25868,April 2018,Hawaii,1095186,685777,62.6,671760,61.3,14017,2.0
25869,April 2018,Idaho,1327475,849383,64.0,824823,62.1,24560,2.9
25870,April 2018,Illinois,10052920,6489223,64.6,6202079,61.7,287144,4.4
25871,April 2018,Indiana,5206756,3335033,64.1,3229231,62.0,105802,3.2
25872,April 2018,Iowa,2464685,1674213,67.9,1627248,66.0,46965,2.8
25873,April 2018,Kansas,2224740,1474574,66.3,1424561,64.0,50013,3.4
25874,April 2018,Kentucky,3488454,2054136,58.9,1971026,56.5,83110,4.0
25875,April 2018,Louisiana,3596728,2137983,59.4,2042325,56.8,95658,4.5
25876,April 2018,Maine,1105568,701228,63.4,682066,61.7,19162,2.7
25877,April 2018,Maryland,4783988,3229782,67.5,3091094,64.6,138688,4.3
25878,April 2018,Massachusetts,5615038,3704674,66.0,3574653,63.7,130021,3.5
25879,April 2018,Michigan,7972075,4902592,61.5,4674373,58.6,228219,4.7
25880,April 2018,Minnesota,4399847,3100993,70.5,3001827,68.2,99166,3.2
25881,April 2018,Mississippi,2292237,1275321,55.6,1217089,53.1,58232,4.6
25882,April 2018,Missouri,4799702,3039824,63.3,2930473,61.1,109351,3.6
25883,April 2018,Montana,839905,524864,62.5,503625,60.0,21239,4.0
25884,April 2018,Nebraska,1474673,1012250,68.6,983754,66.7,28496,2.8
25885,April 2018,Nevada,2390284,1488928,62.3,1415803,59.2,73125,4.9
25886,April 2018,New Hampshire,1107200,750748,67.8,731103,66.0,19645,2.6
25887,April 2018,New Jersey,7185433,4489212,62.5,4285851,59.6,203361,4.5
25888,April 2018,New Mexico,1625268,937560,57.7,886989,54.6,50571,5.4
25889,April 2018,New York,15963114,9665693,60.6,9217012,57.7,448681,4.6
25890,April 2018,North Carolina,8118635,4981554,61.4,4761974,58.7,219580,4.4
25891,April 2018,North Dakota,578962,412466,71.2,401686,69.4,10780,2.6
25892,April 2018,Ohio,9217903,5777645,62.7,5528734,60.0,248911,4.3
25893,April 2018,Oklahoma,3005776,1851095,61.6,1776424,59.1,74671,4.0
25894,April 2018,Oregon,3369751,2129328,63.2,2041394,60.6,87934,4.1
25895,April 2018,Pennsylvania,10278935,6378191,62.1,6080453,59.2,297738,4.7
25896,April 2018,Rhode Island,864733,558845,64.6,533689,61.7,25156,4.5
25897,April 2018,South Carolina,3995602,2323584,58.2,2225655,55.7,97929,4.2
25898,April 2018,South Dakota,664408,459655,69.2,444131,66.8,15524,3.4
25899,April 2018,Tennessee,5325057,3231665,60.7,3120784,58.6,110881,3.4
25900,April 2018,Texas,21538599,13750815,63.8,13192212,61.2,558603,4.1
25901,April 2018,Utah,2288797,1586291,69.3,1537703,67.2,48588,3.1
25902,April 2018,Vermont,516397,348024,67.4,338423,65.5,9601,2.8
25903,April 2018,Virginia,6648582,4330963,65.1,4187005,63.0,143958,3.3
25904,April 2018,Washington,5913746,3760565,63.6,3581853,60.6,178712,4.8
25905,April 2018,West Virginia,1454976,785359,54.0,743135,51.1,42224,5.4
25906,April 2018,Wisconsin,4612300,3175403,68.8,3085895,66.9,89508,2.8
25907,April 2018,Wyoming,445058,290322,65.2,279354,62.8,10968,3.8
25908,May 2018,Alabama,3843911,2177094,56.6,2091505,54.4,85589,3.9
25909,May 2018,Alaska,546084,362458,66.4,336210,61.6,26248,7.2
25910,May 2018,Arizona,5553666,3373872,60.8,3214290,57.9,159582,4.7
25911,May 2018,Arkansas,2338348,1350562,57.8,1299314,55.6,51248,3.8
25912,May 2018,California,31201805,19344513,62.0,18536202,59.4,808311,4.2
25913,May 2018,Colorado,4457095,3064511,68.8,2979410,66.8,85101,2.8
25914,May 2018,Connecticut,2895286,1898510,65.6,1813617,62.6,84893,4.5
25915,May 2018,Delaware,774098,482952,62.4,463437,59.9,19515,4.0
25916,May 2018,District of Columbia,575138,407095,70.8,384293,66.8,22802,5.6
25917,May 2018,Florida,17205393,10217273,59.4,9826113,57.1,391160,3.8
25918,May 2018,Georgia,8102116,5144954,63.5,4929397,60.8,215557,4.2
25919,May 2018,Hawaii,1095078,686831,62.7,672857,61.4,13974,2.0
25920,May 2018,Idaho,1330159,850628,63.9,826052,62.1,24576,2.9
25921,May 2018,Illinois,10052004,6488091,64.5,6209242,61.8,278849,4.3
25922,May 2018,Indiana,5209436,3350540,64.3,3242074,62.2,108466,3.2
25923,May 2018,Iowa,2465741,1675965,68.0,1629926,66.1,46039,2.7
25924,May 2018,Kansas,2225394,1475552,66.3,1425595,64.1,49957,3.4
25925,May 2018,Kentucky,3489836,2058425,59.0,1974154,56.6,84271,4.1
25926,May 2018,Louisiana,3596791,2138890,59.5,2041355,56.8,97535,4.6
25927,May 2018,Maine,1106089,702751,63.5,683200,61.8,19551,2.8
25928,May 2018,Maryland,4785967,3230859,67.5,3092458,64.6,138401,4.3
25929,May 2018,Massachusetts,5618263,3732164,66.4,3601127,64.1,131037,3.5
25930,May 2018,Michigan,7974986,4907923,61.5,4684447,58.7,223476,4.6
25931,May 2018,Minnesota,4403551,3107000,70.6,3009521,68.3,97479,3.1
25932,May 2018,Mississippi,2292502,1278295,55.8,1218779,53.2,59516,4.7
25933,May 2018,Missouri,4801722,3045409,63.4,2937164,61.2,108245,3.6
25934,May 2018,Montana,840796,523767,62.3,503226,59.9,20541,3.9
25935,May 2018,Nebraska,1475648,1013245,68.7,984453,66.7,28792,2.8
25936,May 2018,Nevada,2394563,1492338,62.3,1420529,59.3,71809,4.8
25937,May 2018,New Hampshire,1107990,753166,68.0,733188,66.2,19978,2.7
25938,May 2018,New Jersey,7188040,4477907,62.3,4282401,59.6,195506,4.4
25939,May 2018,New Mexico,1625768,938268,57.7,890173,54.8,48095,5.1
25940,May 2018,New York,15965066,9658546,60.5,9221017,57.8,437529,4.5
25941,May 2018,North Carolina,8127829,4987880,61.4,4774249,58.7,213631,4.3
25942,May 2018,North Dakota,578887,411214,71.0,400548,69.2,10666,2.6
25943,May 2018,Ohio,9220768,5787603,62.8,5537663,60.1,249940,4.3
25944,May 2018,Oklahoma,3006663,1854897,61.7,1781093,59.2,73804,4.0
25945,May 2018,Oregon,3374087,2125668,63.0,2039028,60.4,86640,4.1
25946,May 2018,Pennsylvania,10280730,6363558,61.9,6080356,59.1,283202,4.5
25947,May 2018,Rhode Island,864999,559938,64.7,535161,61.9,24777,4.4
25948,May 2018,South Carolina,4000476,2317919,57.9,2225414,55.6,92505,4.0
25949,May 2018,South Dakota,664975,459682,69.1,444501,66.8,15181,3.3
25950,May 2018,Tennessee,5330022,3237502,60.7,3125756,58.6,111746,3.5
25951,May 2018,Texas,21567361,13788872,63.9,13229219,61.3,559653,4.1
25952,May 2018,Utah,2293144,1589200,69.3,1541115,67.2,48085,3.0
25953,May 2018,Vermont,516504,348861,67.5,339187,65.7,9674,2.8
25954,May 2018,Virginia,6652982,4338497,65.2,4198461,63.1,140036,3.2
25955,May 2018,Washington,5922637,3760423,63.5,3582502,60.5,177921,4.7
25956,May 2018,West Virginia,1454227,785713,54.0,743440,51.1,42273,5.4
25957,May 2018,Wisconsin,4614433,3179816,68.9,3090608,67.0,89208,2.8
25958,May 2018,Wyoming,444764,289195,65.0,278451,62.6,10744,3.7
25959,June 2018,Alabama,3845207,2187423,56.9,2098121,54.6,89302,4.1
25960,June 2018,Alaska,546072,361232,66.2,335535,61.4,25697,7.1
25961,June 2018,Arizona,5562398,3373685,60.7,3216667,57.8,157018,4.7
25962,June 2018,Arkansas,2339625,1349266,57.7,1298410,55.5,50856,3.8
25963,June 2018,California,31221735,19341314,61.9,18527105,59.3,814209,4.2
25964,June 2018,Colorado,4463503,3074507,68.9,2990450,67.0,84057,2.7
25965,June 2018,Connecticut,2895799,1896528,65.5,1812585,62.6,83943,4.4
25966,June 2018,Delaware,774847,484465,62.5,465436,60.1,19029,3.9
25967,June 2018,District of Columbia,575660,408343,70.9,385442,67.0,22901,5.6
25968,June 2018,Florida,17229531,10232909,59.4,9846089,57.1,386820,3.8
25969,June 2018,Georgia,8111175,5155125,63.6,4944486,61.0,210639,4.1
25970,June 2018,Hawaii,1095045,687551,62.8,673360,61.5,14191,2.1
25971,June 2018,Idaho,1332892,851628,63.9,827113,62.1,24515,2.9
25972,June 2018,Illinois,10051334,6487019,64.5,6211298,61.8,275721,4.3
25973,June 2018,Indiana,5212248,3365058,64.6,3252823,62.4,112235,3.3
25974,June 2018,Iowa,2466907,1680041,68.1,1635136,66.3,44905,2.7
25975,June 2018,Kansas,2226105,1477186,66.4,1427301,64.1,49885,3.4
25976,June 2018,Kentucky,3491286,2063526,59.1,1976444,56.6,87082,4.2
25977,June 2018,Louisiana,3596935,2137617,59.4,2036266,56.6,101351,4.7
25978,June 2018,Maine,1106615,704181,63.6,683791,61.8,20390,2.9
25979,June 2018,Maryland,4788055,3233776,67.5,3095317,64.6,138459,4.3
25980,June 2018,Massachusetts,5621670,3758872,66.9,3625463,64.5,133409,3.5
25981,June 2018,Michigan,7978085,4910977,61.6,4692461,58.8,218516,4.4
25982,June 2018,Minnesota,4407348,3110795,70.6,3015451,68.4,95344,3.1
25983,June 2018,Mississippi,2292770,1281523,55.9,1220882,53.2,60641,4.7
25984,June 2018,Missouri,4803814,3053048,63.6,2946818,61.3,106230,3.5
25985,June 2018,Montana,841705,523100,62.1,503182,59.8,19918,3.8
25986,June 2018,Nebraska,1476685,1013967,68.7,985000,66.7,28967,2.9
25987,June 2018,Nevada,2398863,1495032,62.3,1424981,59.4,70051,4.7
25988,June 2018,New Hampshire,1108825,756000,68.2,735815,66.4,20185,2.7
25989,June 2018,New Jersey,7190777,4475465,62.2,4283711,59.6,191754,4.3
25990,June 2018,New Mexico,1626312,939292,57.8,893250,54.9,46042,4.9
25991,June 2018,New York,15967397,9669875,60.6,9239435,57.9,430440,4.5
25992,June 2018,North Carolina,8137153,4997161,61.4,4787584,58.8,209577,4.2
25993,June 2018,North Dakota,578816,409618,70.8,398977,68.9,10641,2.6
25994,June 2018,Ohio,9223830,5799958,62.9,5540578,60.1,259380,4.5
25995,June 2018,Oklahoma,3007630,1859187,61.8,1787007,59.4,72180,3.9
25996,June 2018,Oregon,3378469,2120255,62.8,2035486,60.2,84769,4.0
25997,June 2018,Pennsylvania,10282748,6363114,61.9,6087862,59.2,275252,4.3
25998,June 2018,Rhode Island,865279,560850,64.8,536832,62.0,24018,4.3
25999,June 2018,South Carolina,4005467,2313069,57.7,2225973,55.6,87096,3.8
26000,June 2018,South Dakota,665544,459512,69.0,444687,66.8,14825,3.2
26001,June 2018,Tennessee,5335124,3245778,60.8,3132172,58.7,113606,3.5
26002,June 2018,Texas,21596694,13813349,64.0,13255570,61.4,557779,4.0
26003,June 2018,Utah,2297579,1591474,69.3,1543086,67.2,48388,3.0
26004,June 2018,Vermont,516627,349291,67.6,339509,65.7,9782,2.8
26005,June 2018,Virginia,6657522,4348833,65.3,4211129,63.3,137704,3.2
26006,June 2018,Washington,5931663,3760156,63.4,3583492,60.4,176664,4.7
26007,June 2018,West Virginia,1453524,785039,54.0,743056,51.1,41983,5.3
26008,June 2018,Wisconsin,4616689,3183045,68.9,3091976,67.0,91069,2.9
26009,June 2018,Wyoming,444485,287889,64.8,277101,62.3,10788,3.7
26010,July 2018,Alabama,3846695,2196505,57.1,2105577,54.7,90928,4.1
26011,July 2018,Alaska,546057,359825,65.9,334906,61.3,24919,6.9
26012,July 2018,Arizona,5571388,3375231,60.6,3219758,57.8,155473,4.6
26013,July 2018,Arkansas,2341080,1348451,57.6,1298901,55.5,49550,3.7
26014,July 2018,California,31242927,19348114,61.9,18540596,59.3,807518,4.2
26015,July 2018,Colorado,4470137,3084859,69.0,2999367,67.1,85492,2.8
26016,July 2018,Connecticut,2896448,1898520,65.5,1815770,62.7,82750,4.4
26017,July 2018,Delaware,775642,485735,62.6,466853,60.2,18882,3.9
26018,July 2018,District of Columbia,576219,409028,71.0,386108,67.0,22920,5.6
26019,July 2018,Florida,17254483,10246521,59.4,9863866,57.2,382655,3.7
26020,July 2018,Georgia,8120650,5162235,63.6,4958420,61.1,203815,3.9
26021,July 2018,Hawaii,1095045,687731,62.8,673369,61.5,14362,2.1
26022,July 2018,Idaho,1335663,852790,63.8,828188,62.0,24602,2.9
26023,July 2018,Illinois,10051160,6486738,64.5,6214537,61.8,272201,4.2
26024,July 2018,Indiana,5215307,3381289,64.8,3266103,62.6,115186,3.4
26025,July 2018,Iowa,2468160,1684237,68.2,1640279,66.5,43958,2.6
26026,July 2018,Kansas,2226928,1478313,66.4,1428472,64.1,49841,3.4
26027,July 2018,Kentucky,3492933,2068903,59.2,1978907,56.7,89996,4.3
26028,July 2018,Louisiana,3597277,2136087,59.4,2031068,56.5,105019,4.9
26029,July 2018,Maine,1107218,705870,63.8,684374,61.8,21496,3.0
26030,July 2018,Maryland,4790406,3235032,67.5,3097101,64.7,137931,4.3
26031,July 2018,Massachusetts,5625332,3785804,67.3,3650027,64.9,135777,3.6
26032,July 2018,Michigan,7981599,4909849,61.5,4697900,58.9,211949,4.3
26033,July 2018,Minnesota,4411356,3111750,70.5,3018643,68.4,93107,3.0
26034,July 2018,Mississippi,2293198,1284971,56.0,1223887,53.4,61084,4.8
26035,July 2018,Missouri,4806172,3060739,63.7,2956648,61.5,104091,3.4
26036,July 2018,Montana,842653,522921,62.1,503495,59.8,19426,3.7
26037,July 2018,Nebraska,1477743,1014634,68.7,985633,66.7,29001,2.9
26038,July 2018,Nevada,2403302,1498383,62.3,1429941,59.5,68442,4.6
26039,July 2018,New Hampshire,1109676,758519,68.4,738112,66.5,20407,2.7
26040,July 2018,New Jersey,7193874,4480352,62.3,4290691,59.6,189661,4.2
26041,July 2018,New Mexico,1626919,939864,57.8,895580,55.0,44284,4.7
26042,July 2018,New York,15970486,9679716,60.6,9260218,58.0,419498,4.3
26043,July 2018,North Carolina,8146940,5004054,61.4,4800626,58.9,203428,4.1
26044,July 2018,North Dakota,578784,407800,70.5,397170,68.6,10630,2.6
26045,July 2018,Ohio,9227398,5802017,62.9,5536841,60.0,265176,4.6
26046,July 2018,Oklahoma,3008746,1862880,61.9,1792477,59.6,70403,3.8
26047,July 2018,Oregon,3383022,2116629,62.6,2034108,60.1,82521,3.9
26048,July 2018,Pennsylvania,10285283,6370918,61.9,6103596,59.3,267322,4.2
26049,July 2018,Rhode Island,865608,561956,64.9,538641,62.2,23315,4.1
26050,July 2018,South Carolina,4010654,2309889,57.6,2227550,55.5,82339,3.6
26051,July 2018,South Dakota,666123,459201,68.9,444833,66.8,14368,3.1
26052,July 2018,Tennessee,5340505,3253631,60.9,3138421,58.8,115210,3.5
26053,July 2018,Texas,21626941,13824491,63.9,13276752,61.4,547739,4.0
26054,July 2018,Utah,2302102,1592960,69.2,1544217,67.1,48743,3.1
26055,July 2018,Vermont,516756,349036,67.5,339185,65.6,9851,2.8
26056,July 2018,Virginia,6662396,4356114,65.4,4222789,63.4,133325,3.1
26057,July 2018,Washington,5940974,3763188,63.3,3589816,60.4,173372,4.6
26058,July 2018,West Virginia,1452878,784220,54.0,742078,51.1,42142,5.4
26059,July 2018,Wisconsin,4619173,3183097,68.9,3090033,66.9,93064,2.9
26060,July 2018,Wyoming,444238,286745,64.5,275765,62.1,10980,3.8
26061,August 2018,Alabama,3848470,2203282,57.3,2112099,54.9,91183,4.1
26062,August 2018,Alaska,546038,358293,65.6,334195,61.2,24098,6.7
26063,August 2018,Arizona,5581119,3374642,60.5,3218480,57.7,156162,4.6
26064,August 2018,Arkansas,2342704,1346866,57.5,1298731,55.4,48135,3.6
26065,August 2018,California,31267410,19351060,61.9,18547804,59.3,803256,4.2
26066,August 2018,Colorado,4477149,3090695,69.0,3000187,67.0,90508,2.9
26067,August 2018,Connecticut,2897277,1899242,65.6,1818373,62.8,80869,4.3
26068,August 2018,Delaware,776538,486397,62.6,467400,60.2,18997,3.9
26069,August 2018,District of Columbia,576803,408116,70.8,385083,66.8,23033,5.6
26070,August 2018,Florida,17281881,10243298,59.3,9867967,57.1,375331,3.7
26071,August 2018,Georgia,8130805,5161624,63.5,4964665,61.1,196959,3.8
26072,August 2018,Hawaii,1095142,687369,62.8,672736,61.4,14633,2.1
26073,August 2018,Idaho,1338592,852920,63.7,828908,61.9,24012,2.8
26074,August 2018,Illinois,10051670,6480152,64.5,6211463,61.8,268689,4.1
26075,August 2018,Indiana,5218596,3392408,65.0,3274649,62.7,117759,3.5
26076,August 2018,Iowa,2469613,1685186,68.2,1642463,66.5,42723,2.5
26077,August 2018,Kansas,2227943,1479442,66.4,1430327,64.2,49115,3.3
26078,August 2018,Kentucky,3494761,2071442,59.3,1980418,56.7,91024,4.4
26079,August 2018,Louisiana,3597875,2130849,59.2,2024043,56.3,106806,5.0
26080,August 2018,Maine,1107879,706530,63.8,684096,61.7,22434,3.2
26081,August 2018,Maryland,4793200,3233747,67.5,3097645,64.6,136102,4.2
26082,August 2018,Massachusetts,5629253,3806037,67.6,3668767,65.2,137270,3.6
26083,August 2018,Michigan,7985516,4898068,61.3,4696685,58.8,201383,4.1
26084,August 2018,Minnesota,4415635,3104981,70.3,3015171,68.3,89810,2.9
26085,August 2018,Mississippi,2293854,1287792,56.1,1226113,53.5,61679,4.8
26086,August 2018,Missouri,4808782,3060860,63.7,2960338,61.6,100522,3.3
26087,August 2018,Montana,843665,523002,62.0,503907,59.7,19095,3.7
26088,August 2018,Nebraska,1478916,1015038,68.6,986199,66.7,28839,2.8
26089,August 2018,Nevada,2408066,1502167,62.4,1434167,59.6,68000,4.5
26090,August 2018,New Hampshire,1110549,760558,68.5,740046,66.6,20512,2.7
26091,August 2018,New Jersey,7197585,4485541,62.3,4297240,59.7,188301,4.2
26092,August 2018,New Mexico,1627758,939866,57.7,896521,55.1,43345,4.6
26093,August 2018,New York,15974769,9690939,60.7,9282019,58.1,408920,4.2
26094,August 2018,North Carolina,8157451,5002552,61.3,4805636,58.9,196916,3.9
26095,August 2018,North Dakota,578780,405865,70.1,395138,68.3,10727,2.6
26096,August 2018,Ohio,9231487,5789423,62.7,5521659,59.8,267764,4.6
26097,August 2018,Oklahoma,3010108,1864493,61.9,1796169,59.7,68324,3.7
26098,August 2018,Oregon,3387866,2112282,62.3,2031670,60.0,80612,3.8
26099,August 2018,Pennsylvania,10288626,6381093,62.0,6118702,59.5,262391,4.1
26100,August 2018,Rhode Island,865959,562187,64.9,539620,62.3,22567,4.0
26101,August 2018,South Carolina,4016345,2306520,57.4,2227762,55.5,78758,3.4
26102,August 2018,South Dakota,666775,458770,68.8,444813,66.7,13957,3.0
26103,August 2018,Tennessee,5346281,3255943,60.9,3139741,58.7,116202,3.6
26104,August 2018,Texas,21659971,13821915,63.8,13285987,61.3,535928,3.9
26105,August 2018,Utah,2306808,1592018,69.0,1542237,66.9,49781,3.1
26106,August 2018,Vermont,516907,348192,67.4,338297,65.4,9895,2.8
26107,August 2018,Virginia,6667726,4356573,65.3,4226502,63.4,130071,3.0
26108,August 2018,Washington,5950775,3765672,63.3,3596666,60.4,169006,4.5
26109,August 2018,West Virginia,1452298,782117,53.9,740852,51.0,41265,5.3
26110,August 2018,Wisconsin,4621832,3178087,68.8,3082978,66.7,95109,3.0
26111,August 2018,Wyoming,444049,285694,64.3,274441,61.8,11253,3.9
26112,September 2018,Alabama,3850228,2208177,57.4,2117359,55.0,90818,4.1
26113,September 2018,Alaska,546015,356985,65.4,333648,61.1,23337,6.5
26114,September 2018,Arizona,5590825,3384701,60.5,3227354,57.7,157347,4.6
26115,September 2018,Arkansas,2344392,1345675,57.4,1298445,55.4,47230,3.5
26116,September 2018,California,31291936,19384803,61.9,18582059,59.4,802744,4.1
26117,September 2018,Colorado,4484174,3095724,69.0,3001205,66.9,94519,3.1
26118,September 2018,Connecticut,2898104,1903469,65.7,1823420,62.9,80049,4.2
26119,September 2018,Delaware,777489,486631,62.6,467367,60.1,19264,4.0
26120,September 2018,District of Columbia,577403,406600,70.4,383579,66.4,23021,5.7
26121,September 2018,Florida,17309301,10240585,59.2,9881977,57.1,358608,3.5
26122,September 2018,Georgia,8141016,5155254,63.3,4966878,61.0,188376,3.7
26123,September 2018,Hawaii,1095224,686851,62.7,671784,61.3,15067,2.2
26124,September 2018,Idaho,1341539,853045,63.6,829763,61.9,23282,2.7
26125,September 2018,Illinois,10052201,6478147,64.4,6211315,61.8,266832,4.1
26126,September 2018,Indiana,5221928,3397226,65.1,3279882,62.8,117344,3.5
26127,September 2018,Iowa,2471084,1686130,68.2,1644366,66.5,41764,2.5
26128,September 2018,Kansas,2228927,1481564,66.5,1433120,64.3,48444,3.3
26129,September 2018,Kentucky,3496619,2073661,59.3,1981064,56.7,92597,4.5
26130,September 2018,Louisiana,3598495,2122778,59.0,2016366,56.0,106412,5.0
26131,September 2018,Maine,1108533,706160,63.7,682971,61.6,23189,3.3
26132,September 2018,Maryland,4796038,3229082,67.3,3094987,64.5,134095,4.2
26133,September 2018,Massachusetts,5633195,3822056,67.8,3686253,65.4,135803,3.6
26134,September 2018,Michigan,7989486,4891713,61.2,4698315,58.8,193398,4.0
26135,September 2018,Minnesota,4419955,3098407,70.1,3011251,68.1,87156,2.8
26136,September 2018,Mississippi,2294524,1288211,56.1,1226587,53.5,61624,4.8
26137,September 2018,Missouri,4811473,3061961,63.6,2965108,61.6,96853,3.2
26138,September 2018,Montana,844688,523380,62.0,504284,59.7,19096,3.6
26139,September 2018,Nebraska,1480138,1016175,68.7,987575,66.7,28600,2.8
26140,September 2018,Nevada,2412762,1506524,62.4,1439065,59.6,67459,4.5
26141,September 2018,New Hampshire,1111426,761794,68.5,741548,66.7,20246,2.7
26142,September 2018,New Jersey,7201332,4487632,62.3,4300600,59.7,187032,4.2
26143,September 2018,New Mexico,1628607,941119,57.8,898108,55.1,43011,4.6
26144,September 2018,New York,15979081,9709285,60.8,9311648,58.3,397637,4.1
26145,September 2018,North Carolina,8167921,4993059,61.1,4805713,58.8,187346,3.8
26146,September 2018,North Dakota,578769,404220,69.8,393272,67.9,10948,2.7
26147,September 2018,Ohio,9235610,5775488,62.5,5509733,59.7,265755,4.6
26148,September 2018,Oklahoma,3011439,1863224,61.9,1797930,59.7,65294,3.5
26149,September 2018,Oregon,3392732,2110339,62.2,2030498,59.8,79841,3.8
26150,September 2018,Pennsylvania,10292016,6396578,62.2,6134418,59.6,262160,4.1
26151,September 2018,Rhode Island,866315,561911,64.9,539839,62.3,22072,3.9
26152,September 2018,South Carolina,4022031,2304338,57.3,2227597,55.4,76741,3.3
26153,September 2018,South Dakota,667443,458661,68.7,444984,66.7,13677,3.0
26154,September 2018,Tennessee,5352058,3253703,60.8,3136366,58.6,117337,3.6
26155,September 2018,Texas,21693061,13816243,63.7,13290693,61.3,525550,3.8
26156,September 2018,Utah,2311595,1589104,68.7,1538745,66.6,50359,3.2
26157,September 2018,Vermont,517033,347167,67.1,337266,65.2,9901,2.9
26158,September 2018,Virginia,6673060,4353016,65.2,4226547,63.3,126469,2.9
26159,September 2018,Washington,5960555,3770743,63.3,3605716,60.5,165027,4.4
26160,September 2018,West Virginia,1451722,781017,53.8,740317,51.0,40700,5.2
26161,September 2018,Wisconsin,4624568,3170493,68.6,3075366,66.5,95127,3.0
26162,September 2018,Wyoming,443853,285315,64.3,273722,61.7,11593,4.1
26163,October 2018,Alabama,3852046,2212672,57.4,2122927,55.1,89745,4.1
26164,October 2018,Alaska,545987,356349,65.3,333572,61.1,22777,6.4
26165,October 2018,Arizona,5600527,3400870,60.7,3242742,57.9,158128,4.6
26166,October 2018,Arkansas,2346060,1346590,57.4,1299143,55.4,47447,3.5
26167,October 2018,California,31316310,19441591,62.1,18637290,59.5,804301,4.1
26168,October 2018,Colorado,4491231,3101129,69.0,3002970,66.9,98159,3.2
26169,October 2018,Connecticut,2898956,1909333,65.9,1829355,63.1,79978,4.2
26170,October 2018,Delaware,778396,486709,62.5,467581,60.1,19128,3.9
26171,October 2018,District of Columbia,577975,405221,70.1,382364,66.2,22857,5.6
26172,October 2018,Florida,17336739,10246102,59.1,9900995,57.1,345107,3.4
26173,October 2018,Georgia,8151255,5152449,63.2,4967882,60.9,184567,3.6
26174,October 2018,Hawaii,1095316,686178,62.6,670427,61.2,15751,2.3
26175,October 2018,Idaho,1344508,853478,63.5,830653,61.8,22825,2.7
26176,October 2018,Illinois,10052739,6488104,64.5,6218037,61.9,270067,4.2
26177,October 2018,Indiana,5225271,3402196,65.1,3282528,62.8,119668,3.5
26178,October 2018,Iowa,2472582,1688173,68.3,1647008,66.6,41165,2.4
26179,October 2018,Kansas,2229951,1485048,66.6,1436593,64.4,48455,3.3
26180,October 2018,Kentucky,3498502,2075387,59.3,1981358,56.6,94029,4.5
26181,October 2018,Louisiana,3599100,2117244,58.8,2011295,55.9,105949,5.0
26182,October 2018,Maine,1109238,705416,63.6,681585,61.4,23831,3.4
26183,October 2018,Maryland,4798834,3227308,67.3,3095928,64.5,131380,4.1
26184,October 2018,Massachusetts,5637139,3832804,68.0,3698734,65.6,134070,3.5
26185,October 2018,Michigan,7993479,4891985,61.2,4700638,58.8,191347,3.9
26186,October 2018,Minnesota,4424303,3095093,70.0,3008962,68.0,86131,2.8
26187,October 2018,Mississippi,2295190,1286545,56.1,1225713,53.4,60832,4.7
26188,October 2018,Missouri,4814169,3065464,63.7,2971103,61.7,94361,3.1
26189,October 2018,Montana,845717,524250,62.0,505099,59.7,19151,3.7
26190,October 2018,Nebraska,1481374,1018320,68.7,989614,66.8,28706,2.8
26191,October 2018,Nevada,2417548,1512276,62.6,1445131,59.8,67145,4.4
26192,October 2018,New Hampshire,1112325,762411,68.5,742687,66.8,19724,2.6
26193,October 2018,New Jersey,7205049,4492649,62.4,4308650,59.8,183999,4.1
26194,October 2018,New Mexico,1629467,943172,57.9,900018,55.2,43154,4.6
26195,October 2018,New York,15983392,9736073,60.9,9348531,58.5,387542,4.0
26196,October 2018,North Carolina,8178478,4992207,61.0,4810683,58.8,181524,3.6
26197,October 2018,North Dakota,578773,403110,69.6,392007,67.7,11103,2.8
26198,October 2018,Ohio,9239764,5770527,62.5,5504685,59.6,265842,4.6
26199,October 2018,Oklahoma,3012842,1861846,61.8,1799177,59.7,62669,3.4
26200,October 2018,Oregon,3397582,2111671,62.2,2030545,59.8,81126,3.8
26201,October 2018,Pennsylvania,10295413,6420029,62.4,6154514,59.8,265515,4.1
26202,October 2018,Rhode Island,866651,561241,64.8,539901,62.3,21340,3.8
26203,October 2018,South Carolina,4027753,2307307,57.3,2231087,55.4,76220,3.3
26204,October 2018,South Dakota,668092,458734,68.7,445132,66.6,13602,3.0
26205,October 2018,Tennessee,5357872,3253312,60.7,3134312,58.5,119000,3.7
26206,October 2018,Texas,21726074,13833006,63.7,13316320,61.3,516686,3.7
26207,October 2018,Utah,2316327,1584648,68.4,1534675,66.3,49973,3.2
26208,October 2018,Vermont,517208,346058,66.9,336422,65.0,9636,2.8
26209,October 2018,Virginia,6678451,4353411,65.2,4228655,63.3,124756,2.9
26210,October 2018,Washington,5970383,3781532,63.3,3618768,60.6,162764,4.3
26211,October 2018,West Virginia,1451187,780919,53.8,740408,51.0,40511,5.2
26212,October 2018,Wisconsin,4627238,3163914,68.4,3068801,66.3,95113,3.0
26213,October 2018,Wyoming,443649,285523,64.4,273797,61.7,11726,4.1
26214,November 2018,Alabama,3853316,2215688,57.5,2127934,55.2,87754,4.0
26215,November 2018,Alaska,545914,355986,65.2,333517,61.1,22469,6.3
26216,November 2018,Arizona,5609539,3423764,61.0,3263849,58.2,159915,4.7
26217,November 2018,Arkansas,2347388,1348197,57.4,1300012,55.4,48185,3.6
26218,November 2018,California,31337912,19517174,62.3,18710525,59.7,806649,4.1
26219,November 2018,Colorado,4497727,3108593,69.1,3006195,66.8,102398,3.3
26220,November 2018,Connecticut,2899436,1916633,66.1,1838961,63.4,77672,4.1
26221,November 2018,Delaware,779221,486610,62.4,467932,60.1,18678,3.8
26222,November 2018,District of Columbia,578507,404505,69.9,381864,66.0,22641,5.6
26223,November 2018,Florida,17361886,10255943,59.1,9920908,57.1,335035,3.3
26224,November 2018,Georgia,8160517,5148033,63.1,4965670,60.8,182363,3.5
26225,November 2018,Hawaii,1095387,685088,62.5,668727,61.0,16361,2.4
26226,November 2018,Idaho,1347267,854324,63.4,831933,61.7,22391,2.6
26227,November 2018,Illinois,10052053,6499383,64.7,6225560,61.9,273823,4.2
26228,November 2018,Indiana,5227931,3404512,65.1,3282730,62.8,121782,3.6
26229,November 2018,Iowa,2473701,1689650,68.3,1649039,66.7,40611,2.4
26230,November 2018,Kansas,2230636,1487086,66.7,1438800,64.5,48286,3.2
26231,November 2018,Kentucky,3499894,2075651,59.3,1983035,56.7,92616,4.5
26232,November 2018,Louisiana,3599265,2113704,58.7,2008492,55.8,105212,5.0
26233,November 2018,Maine,1109747,704588,63.5,680629,61.3,23959,3.4
26234,November 2018,Maryland,4801114,3226008,67.2,3098097,64.5,127911,4.0
26235,November 2018,Massachusetts,5640456,3836955,68.0,3706941,65.7,130014,3.4
26236,November 2018,Michigan,7996435,4893073,61.2,4701300,58.8,191773,3.9
26237,November 2018,Minnesota,4428035,3092089,69.8,3006763,67.9,85326,2.8
26238,November 2018,Mississippi,2295561,1284184,55.9,1224132,53.3,60052,4.7
26239,November 2018,Missouri,4816207,3065748,63.7,2972321,61.7,93427,3.0
26240,November 2018,Montana,846612,525538,62.1,506256,59.8,19282,3.7
26241,November 2018,Nebraska,1482393,1020898,68.9,992252,66.9,28646,2.8
26242,November 2018,Nevada,2422036,1518759,62.7,1451661,59.9,67098,4.4
26243,November 2018,New Hampshire,1113060,763003,68.6,743828,66.8,19175,2.5
26244,November 2018,New Jersey,7207939,4495138,62.4,4316524,59.9,178614,4.0
26245,November 2018,New Mexico,1630086,945752,58.0,902077,55.3,43675,4.6
26246,November 2018,New York,15985989,9757146,61.0,9377767,58.7,379379,3.9
26247,November 2018,North Carolina,8187958,4991418,61.0,4814155,58.8,177263,3.6
26248,November 2018,North Dakota,578712,402429,69.5,391356,67.6,11073,2.8
26249,November 2018,Ohio,9242656,5765675,62.4,5502496,59.5,263179,4.6
26250,November 2018,Oklahoma,3013819,1856839,61.6,1796457,59.6,60382,3.3
26251,November 2018,Oregon,3401984,2113776,62.1,2030762,59.7,83014,3.9
26252,November 2018,Pennsylvania,10297371,6440509,62.5,6171606,59.9,268903,4.2
26253,November 2018,Rhode Island,866937,560942,64.7,539620,62.2,21322,3.8
26254,November 2018,South Carolina,4032976,2312108,57.3,2235398,55.4,76710,3.3
26255,November 2018,South Dakota,668683,459213,68.7,445635,66.6,13578,3.0
26256,November 2018,Tennessee,5363026,3256234,60.7,3137593,58.5,118641,3.6
26257,November 2018,Texas,21756672,13859710,63.7,13347892,61.4,511818,3.7
26258,November 2018,Utah,2320793,1581453,68.1,1531423,66.0,50030,3.2
26259,November 2018,Vermont,517276,345113,66.7,335733,64.9,9380,2.7
26260,November 2018,Virginia,6683000,4355029,65.2,4231109,63.3,123920,2.8
26261,November 2018,Washington,5979484,3795986,63.5,3632837,60.8,163149,4.3
26262,November 2018,West Virginia,1450417,780996,53.8,740742,51.1,40254,5.2
26263,November 2018,Wisconsin,4629356,3156373,68.2,3062018,66.1,94355,3.0
26264,November 2018,Wyoming,443374,286248,64.6,274489,61.9,11759,4.1
26265,December 2018,Alabama,3854412,2216217,57.5,2130194,55.3,86023,3.9
26266,December 2018,Alaska,545816,355543,65.1,333153,61.0,22390,6.3
26267,December 2018,Arizona,5618267,3446535,61.3,3281027,58.4,165508,4.8
26268,December 2018,Arkansas,2348654,1350399,57.5,1301288,55.4,49111,3.6
26269,December 2018,California,31357678,19593041,62.5,18779183,59.9,813858,4.2
26270,December 2018,Colorado,4504017,3118212,69.2,3010324,66.8,107888,3.5
26271,December 2018,Connecticut,2899740,1923569,66.3,1847349,63.7,76220,4.0
26272,December 2018,Delaware,779984,487141,62.5,468966,60.1,18175,3.7
26273,December 2018,District of Columbia,579015,404563,69.9,382283,66.0,22280,5.5
26274,December 2018,Florida,17386130,10277514,59.1,9942962,57.2,334552,3.3
26275,December 2018,Georgia,8169389,5147244,63.0,4962612,60.7,184632,3.6
26276,December 2018,Hawaii,1095387,683405,62.4,666505,60.8,16900,2.5
26277,December 2018,Idaho,1349973,856337,63.4,833756,61.8,22581,2.6
26278,December 2018,Illinois,10050916,6500922,64.7,6223404,61.9,277518,4.3
26279,December 2018,Indiana,5230353,3406055,65.1,3284190,62.8,121865,3.6
26280,December 2018,Iowa,2474687,1691947,68.4,1651316,66.7,40631,2.4
26281,December 2018,Kansas,2231227,1489906,66.8,1440934,64.6,48972,3.3
26282,December 2018,Kentucky,3501185,2074067,59.2,1983080,56.6,90987,4.4
26283,December 2018,Louisiana,3599271,2112783,58.7,2008433,55.8,104350,4.9
26284,December 2018,Maine,1110217,703363,63.4,679346,61.2,24017,3.4
26285,December 2018,Maryland,4803137,3226938,67.2,3101719,64.6,125219,3.9
26286,December 2018,Massachusetts,5643511,3842000,68.1,3715785,65.8,126215,3.3
26287,December 2018,Michigan,7999056,4898032,61.2,4702352,58.8,195680,4.0
26288,December 2018,Minnesota,4431586,3093361,69.8,3006678,67.8,86683,2.8
26289,December 2018,Mississippi,2295838,1281089,55.8,1220968,53.2,60121,4.7
26290,December 2018,Missouri,4818015,3066573,63.6,2971331,61.7,95242,3.1
26291,December 2018,Montana,847481,526793,62.2,507368,59.9,19425,3.7
26292,December 2018,Nebraska,1483289,1024189,69.0,995717,67.1,28472,2.8
26293,December 2018,Nevada,2426359,1524835,62.8,1457378,60.1,67457,4.4
26294,December 2018,New Hampshire,1113753,763896,68.6,745177,66.9,18719,2.5
26295,December 2018,New Jersey,7210484,4501043,62.4,4322946,60.0,178097,4.0
26296,December 2018,New Mexico,1630665,949047,58.2,904196,55.4,44851,4.7
26297,December 2018,New York,15987817,9781522,61.2,9403010,58.8,378512,3.9
26298,December 2018,North Carolina,8197123,4996890,61.0,4818454,58.8,178436,3.6
26299,December 2018,North Dakota,578623,402143,69.5,391316,67.6,10827,2.7
26300,December 2018,Ohio,9245138,5766953,62.4,5502123,59.5,264830,4.6
26301,December 2018,Oklahoma,3014647,1849452,61.3,1790379,59.4,59073,3.2
26302,December 2018,Oregon,3406262,2116656,62.1,2030751,59.6,85905,4.1
26303,December 2018,Pennsylvania,10298901,6461982,62.7,6188362,60.1,273620,4.2
26304,December 2018,Rhode Island,867150,561039,64.7,539377,62.2,21662,3.9
26305,December 2018,South Carolina,4037986,2319627,57.4,2242540,55.5,77087,3.3
26306,December 2018,South Dakota,669228,459958,68.7,446433,66.7,13525,2.9
26307,December 2018,Tennessee,5367921,3259991,60.7,3143855,58.6,116136,3.6
26308,December 2018,Texas,21785997,13902459,63.8,13387366,61.4,515093,3.7
26309,December 2018,Utah,2325146,1579468,67.9,1529522,65.8,49946,3.2
26310,December 2018,Vermont,517343,344405,66.6,335223,64.8,9182,2.7
26311,December 2018,Virginia,6687293,4359242,65.2,4236062,63.3,123180,2.8
26312,December 2018,Washington,5988337,3812295,63.7,3646568,60.9,165727,4.3
26313,December 2018,West Virginia,1449598,781846,53.9,741742,51.2,40104,5.1
26314,December 2018,Wisconsin,4631259,3149038,68.0,3055654,66.0,93384,3.0
26315,December 2018,Wyoming,443114,286749,64.7,275130,62.1,11619,4.1
